RELEASE_ID,FILE_NAME,SIZE,LOC_ADDED,LOC_ADDED_AVG,LOC_ADDED_MAX,LOC_REMOVED,LOC_REMOVED_AVG,LOC_REMOVED_MAX,LOC_TOUCHED,LOC_TOUCHED_AVG,LOC_TOUCHED_MAX,CHURN,CHURN_AVG,CHURN_MAX,NUMBER_OF_REVISIONS,NUMBER_OF_DEFECT_FIXES,NUMBER_OF_AUTHORS,IS_BUGGY
8,src/contrib/bookkeeper/benchmark/org/apache/bookkeeper/benchmark/MySqlClient.java,137,1,1.0,1,1,1.0,1,2,2.0,2,0,0.0,0,1,0,1,NO
8,src/contrib/bookkeeper/benchmark/org/apache/bookkeeper/benchmark/TestClient.java,252,2,2.0,2,2,2.0,2,4,4.0,4,0,0.0,0,1,0,1,NO
8,src/contrib/bookkeeper/src/java/org/apache/bookkeeper/bookie/Bookie.java,532,267,133.5,267,97,48.5,97,364,182.0,364,170,85.0,170,2,0,2,NO
8,src/contrib/bookkeeper/src/java/org/apache/bookkeeper/bookie/BookieException.java,81,0,0.0,0,0,0.0,0,0,0.0,0,0,0.0,0,0,0,0,NO
8,src/contrib/bookkeeper/src/java/org/apache/bookkeeper/bookie/BufferedChannel.java,157,157,157.0,157,0,0.0,0,157,157.0,157,157,157.0,157,1,0,1,NO
8,src/contrib/bookkeeper/src/java/org/apache/bookkeeper/bookie/EntryLogger.java,264,264,264.0,264,0,0.0,0,264,264.0,264,264,264.0,264,1,0,1,NO
8,src/contrib/bookkeeper/src/java/org/apache/bookkeeper/bookie/FileInfo.java,113,113,113.0,113,0,0.0,0,113,113.0,113,113,113.0,113,1,0,1,NO
8,src/contrib/bookkeeper/src/java/org/apache/bookkeeper/bookie/LedgerCache.java,454,454,454.0,454,0,0.0,0,454,454.0,454,454,454.0,454,1,0,1,NO
8,src/contrib/bookkeeper/src/java/org/apache/bookkeeper/bookie/LedgerDescriptor.java,133,47,47.0,47,79,79.0,79,126,126.0,126,32,32.0,32,1,0,1,NO
8,src/contrib/bookkeeper/src/java/org/apache/bookkeeper/bookie/LedgerEntryPage.java,151,151,151.0,151,0,0.0,0,151,151.0,151,151,151.0,151,1,0,1,NO
8,src/contrib/bookkeeper/src/java/org/apache/bookkeeper/bookie/MarkerFileChannel.java,147,147,147.0,147,0,0.0,0,147,147.0,147,147,147.0,147,1,0,1,NO
8,src/contrib/bookkeeper/src/java/org/apache/bookkeeper/client/AsyncCallback.java,101,93,93.0,93,73,73.0,73,166,166.0,166,20,20.0,20,1,0,1,NO
8,src/contrib/bookkeeper/src/java/org/apache/bookkeeper/client/BKException.java,227,107,107.0,107,43,43.0,43,150,150.0,150,64,64.0,64,1,0,1,NO
8,src/contrib/bookkeeper/src/java/org/apache/bookkeeper/client/BookKeeper.java,352,299,299.0,299,563,563.0,563,862,862.0,862,264,264.0,264,1,0,1,NO
8,src/contrib/bookkeeper/src/java/org/apache/bookkeeper/client/BookieWatcher.java,204,204,204.0,204,0,0.0,0,204,204.0,204,204,204.0,204,1,0,1,NO
8,src/contrib/bookkeeper/src/java/org/apache/bookkeeper/client/CRC32DigestManager.java,50,50,50.0,50,0,0.0,0,50,50.0,50,50,50.0,50,1,0,1,NO
8,src/contrib/bookkeeper/src/java/org/apache/bookkeeper/client/DigestManager.java,162,162,162.0,162,0,0.0,0,162,162.0,162,162,162.0,162,1,0,1,NO
8,src/contrib/bookkeeper/src/java/org/apache/bookkeeper/client/DistributionSchedule.java,61,61,61.0,61,0,0.0,0,61,61.0,61,61,61.0,61,1,0,1,NO
8,src/contrib/bookkeeper/src/java/org/apache/bookkeeper/client/LedgerCreateOp.java,163,163,163.0,163,0,0.0,0,163,163.0,163,163,163.0,163,1,0,1,NO
8,src/contrib/bookkeeper/src/java/org/apache/bookkeeper/client/LedgerEntry.java,78,46,46.0,46,26,26.0,26,72,72.0,72,20,20.0,20,1,0,1,NO
8,src/contrib/bookkeeper/src/java/org/apache/bookkeeper/client/LedgerHandle.java,448,401,401.0,401,797,797.0,797,1198,1198.0,1198,396,396.0,396,1,0,1,NO
8,src/contrib/bookkeeper/src/java/org/apache/bookkeeper/client/LedgerMetadata.java,179,179,179.0,179,0,0.0,0,179,179.0,179,179,179.0,179,1,0,1,NO
8,src/contrib/bookkeeper/src/java/org/apache/bookkeeper/client/LedgerOpenOp.java,136,136,136.0,136,0,0.0,0,136,136.0,136,136,136.0,136,1,0,1,NO
8,src/contrib/bookkeeper/src/java/org/apache/bookkeeper/client/LedgerRecoveryOp.java,167,167,167.0,167,0,0.0,0,167,167.0,167,167,167.0,167,1,0,1,NO
8,src/contrib/bookkeeper/src/java/org/apache/bookkeeper/client/MacDigestManager.java,67,67,67.0,67,0,0.0,0,67,67.0,67,67,67.0,67,1,0,1,NO
8,src/contrib/bookkeeper/src/java/org/apache/bookkeeper/client/PendingAddOp.java,137,137,137.0,137,0,0.0,0,137,137.0,137,137,137.0,137,1,0,1,NO
8,src/contrib/bookkeeper/src/java/org/apache/bookkeeper/client/PendingReadOp.java,145,145,145.0,145,0,0.0,0,145,145.0,145,145,145.0,145,1,0,1,NO
8,src/contrib/bookkeeper/src/java/org/apache/bookkeeper/client/RoundRobinDistributionSchedule.java,87,87,87.0,87,0,0.0,0,87,87.0,87,87,87.0,87,1,0,1,NO
8,src/contrib/bookkeeper/src/java/org/apache/bookkeeper/client/SyncCounter.java,85,85,85.0,85,0,0.0,0,85,85.0,85,85,85.0,85,1,0,1,NO
8,src/contrib/bookkeeper/src/java/org/apache/bookkeeper/proto/BookieClient.java,178,86,86.0,86,349,349.0,349,435,435.0,435,263,263.0,263,1,0,1,NO
8,src/contrib/bookkeeper/src/java/org/apache/bookkeeper/proto/BookieProtocol.java,75,19,19.0,19,20,20.0,20,39,39.0,39,1,1.0,1,1,0,1,NO
8,src/contrib/bookkeeper/src/java/org/apache/bookkeeper/proto/BookieServer.java,208,63,31.5,63,54,27.0,54,117,58.5,117,9,4.5,9,2,0,2,NO
8,src/contrib/bookkeeper/src/java/org/apache/bookkeeper/proto/BookkeeperInternalCallbacks.java,57,57,57.0,57,0,0.0,0,57,57.0,57,57,57.0,57,1,0,1,NO
8,src/contrib/bookkeeper/src/java/org/apache/bookkeeper/proto/NIOServerFactory.java,517,28,28.0,28,38,38.0,38,66,66.0,66,10,10.0,10,1,0,1,NO
8,src/contrib/bookkeeper/src/java/org/apache/bookkeeper/proto/PerChannelBookieClient.java,570,570,570.0,570,0,0.0,0,570,570.0,570,570,570.0,570,1,0,1,NO
8,src/contrib/bookkeeper/src/java/org/apache/bookkeeper/proto/ServerStats.java,148,51,51.0,51,36,36.0,36,87,87.0,87,15,15.0,15,1,0,1,NO
8,src/contrib/bookkeeper/src/java/org/apache/bookkeeper/streaming/LedgerInputStream.java,173,37,18.5,37,28,14.0,28,65,32.5,65,9,4.5,9,2,1,1,NO
8,src/contrib/bookkeeper/src/java/org/apache/bookkeeper/streaming/LedgerOutputStream.java,147,32,32.0,32,33,33.0,33,65,65.0,65,1,1.0,1,1,0,1,NO
8,src/contrib/bookkeeper/src/java/org/apache/bookkeeper/util/LocalBookKeeper.java,208,62,15.5,62,18,4.5,18,80,20.0,80,58,14.5,58,4,2,2,NO
8,src/contrib/bookkeeper/src/java/org/apache/bookkeeper/util/Main.java,54,6,6.0,6,7,7.0,7,13,13.0,13,1,1.0,1,1,0,1,NO
8,src/contrib/bookkeeper/src/java/org/apache/bookkeeper/util/MathUtils.java,38,38,38.0,38,0,0.0,0,38,38.0,38,38,38.0,38,1,0,1,NO
8,src/contrib/bookkeeper/src/java/org/apache/bookkeeper/util/OrderedSafeExecutor.java,98,98,98.0,98,0,0.0,0,98,98.0,98,98,98.0,98,1,0,1,NO
8,src/contrib/bookkeeper/src/java/org/apache/bookkeeper/util/SafeRunnable.java,38,38,38.0,38,0,0.0,0,38,38.0,38,38,38.0,38,1,0,1,NO
8,src/contrib/bookkeeper/src/java/org/apache/bookkeeper/util/StringUtils.java,94,94,94.0,94,0,0.0,0,94,94.0,94,94,94.0,94,1,0,1,NO
8,src/contrib/fatjar/src/java/org/apache/zookeeper/util/FatJarMain.java,126,0,0.0,0,0,0.0,0,0,0.0,0,0,0.0,0,0,0,0,NO
8,src/contrib/rest/src/java/org/apache/zookeeper/server/jersey/RestMain.java,78,0,0.0,0,0,0.0,0,0,0.0,0,0,0.0,0,0,0,0,NO
8,src/contrib/rest/src/java/org/apache/zookeeper/server/jersey/ZooKeeperService.java,110,0,0.0,0,0,0.0,0,0,0.0,0,0,0.0,0,0,0,0,NO
8,src/contrib/rest/src/java/org/apache/zookeeper/server/jersey/jaxb/ZChildren.java,80,0,0.0,0,0,0.0,0,0,0.0,0,0,0.0,0,0,0,0,NO
8,src/contrib/rest/src/java/org/apache/zookeeper/server/jersey/jaxb/ZChildrenJSON.java,76,0,0.0,0,0,0.0,0,0,0.0,0,0,0.0,0,0,0,0,NO
8,src/contrib/rest/src/java/org/apache/zookeeper/server/jersey/jaxb/ZError.java,41,0,0.0,0,0,0.0,0,0,0.0,0,0,0.0,0,0,0,0,NO
8,src/contrib/rest/src/java/org/apache/zookeeper/server/jersey/jaxb/ZPath.java,63,0,0.0,0,0,0.0,0,0,0.0,0,0,0.0,0,0,0,0,NO
8,src/contrib/rest/src/java/org/apache/zookeeper/server/jersey/jaxb/ZStat.java,106,0,0.0,0,0,0.0,0,0,0.0,0,0,0.0,0,0,0,0,NO
8,src/contrib/rest/src/java/org/apache/zookeeper/server/jersey/resources/JAXBContextResolver.java,72,0,0.0,0,0,0.0,0,0,0.0,0,0,0.0,0,0,0,0,NO
8,src/contrib/rest/src/java/org/apache/zookeeper/server/jersey/resources/KeeperExceptionMapper.java,86,0,0.0,0,0,0.0,0,0,0.0,0,0,0.0,0,0,0,0,NO
8,src/contrib/rest/src/java/org/apache/zookeeper/server/jersey/resources/RuntimeExceptionMapper.java,48,0,0.0,0,0,0.0,0,0,0.0,0,0,0.0,0,0,0,0,YES
8,src/contrib/rest/src/java/org/apache/zookeeper/server/jersey/resources/ZErrorWriter.java,63,0,0.0,0,0,0.0,0,0,0.0,0,0,0.0,0,0,0,0,NO
8,src/contrib/rest/src/java/org/apache/zookeeper/server/jersey/resources/ZNodeResource.java,375,0,0.0,0,0,0.0,0,0,0.0,0,0,0.0,0,0,0,0,YES
8,src/contrib/zooinspector/src/java/org/apache/zookeeper/inspector/ZooInspector.java,66,66,66.0,66,0,0.0,0,66,66.0,66,66,66.0,66,1,0,1,NO
8,src/contrib/zooinspector/src/java/org/apache/zookeeper/inspector/encryption/BasicDataEncryptionManager.java,50,50,50.0,50,0,0.0,0,50,50.0,50,50,50.0,50,1,0,1,NO
8,src/contrib/zooinspector/src/java/org/apache/zookeeper/inspector/encryption/DataEncryptionManager.java,39,39,39.0,39,0,0.0,0,39,39.0,39,39,39.0,39,1,0,1,NO
8,src/contrib/zooinspector/src/java/org/apache/zookeeper/inspector/gui/NodeViewersChangeListener.java,37,37,37.0,37,0,0.0,0,37,37.0,37,37,37.0,37,1,0,1,NO
8,src/contrib/zooinspector/src/java/org/apache/zookeeper/inspector/gui/ZooInspectorAboutDialog.java,80,80,80.0,80,0,0.0,0,80,80.0,80,80,80.0,80,1,0,1,NO
8,src/contrib/zooinspector/src/java/org/apache/zookeeper/inspector/gui/ZooInspectorConnectionPropertiesDialog.java,321,321,321.0,321,0,0.0,0,321,321.0,321,321,321.0,321,1,0,1,NO
8,src/contrib/zooinspector/src/java/org/apache/zookeeper/inspector/gui/ZooInspectorIconResources.java,118,118,118.0,118,0,0.0,0,118,118.0,118,118,118.0,118,1,0,1,NO
8,src/contrib/zooinspector/src/java/org/apache/zookeeper/inspector/gui/ZooInspectorNodeViewersDialog.java,605,605,605.0,605,0,0.0,0,605,605.0,605,605,605.0,605,1,0,1,NO
8,src/contrib/zooinspector/src/java/org/apache/zookeeper/inspector/gui/ZooInspectorNodeViewersPanel.java,140,140,140.0,140,0,0.0,0,140,140.0,140,140,140.0,140,1,0,1,NO
8,src/contrib/zooinspector/src/java/org/apache/zookeeper/inspector/gui/ZooInspectorPanel.java,361,361,361.0,361,0,0.0,0,361,361.0,361,361,361.0,361,1,0,1,NO
8,src/contrib/zooinspector/src/java/org/apache/zookeeper/inspector/gui/ZooInspectorTreeViewer.java,362,362,362.0,362,0,0.0,0,362,362.0,362,362,362.0,362,1,0,1,NO
8,src/contrib/zooinspector/src/java/org/apache/zookeeper/inspector/gui/nodeviewer/NodeViewerACL.java,187,187,187.0,187,0,0.0,0,187,187.0,187,187,187.0,187,1,0,1,NO
8,src/contrib/zooinspector/src/java/org/apache/zookeeper/inspector/gui/nodeviewer/NodeViewerData.java,146,146,146.0,146,0,0.0,0,146,146.0,146,146,146.0,146,1,0,1,NO
8,src/contrib/zooinspector/src/java/org/apache/zookeeper/inspector/gui/nodeviewer/NodeViewerMetaData.java,186,186,186.0,186,0,0.0,0,186,186.0,186,186,186.0,186,1,0,1,NO
8,src/contrib/zooinspector/src/java/org/apache/zookeeper/inspector/gui/nodeviewer/ZooInspectorNodeViewer.java,138,138,138.0,138,0,0.0,0,138,138.0,138,138,138.0,138,1,0,1,NO
8,src/contrib/zooinspector/src/java/org/apache/zookeeper/inspector/logger/LoggerFactory.java,38,38,38.0,38,0,0.0,0,38,38.0,38,38,38.0,38,1,0,1,NO
8,src/contrib/zooinspector/src/java/org/apache/zookeeper/inspector/manager/NodeListener.java,37,37,37.0,37,0,0.0,0,37,37.0,37,37,37.0,37,1,0,1,NO
8,src/contrib/zooinspector/src/java/org/apache/zookeeper/inspector/manager/Pair.java,120,120,120.0,120,0,0.0,0,120,120.0,120,120,120.0,120,1,0,1,NO
8,src/contrib/zooinspector/src/java/org/apache/zookeeper/inspector/manager/ZooInspectorManager.java,139,139,139.0,139,0,0.0,0,139,139.0,139,139,139.0,139,1,0,1,NO
8,src/contrib/zooinspector/src/java/org/apache/zookeeper/inspector/manager/ZooInspectorManagerImpl.java,852,852,852.0,852,0,0.0,0,852,852.0,852,852,852.0,852,1,0,1,NO
8,src/contrib/zooinspector/src/java/org/apache/zookeeper/inspector/manager/ZooInspectorNodeManager.java,33,33,33.0,33,0,0.0,0,33,33.0,33,33,33.0,33,1,0,1,NO
8,src/contrib/zooinspector/src/java/org/apache/zookeeper/inspector/manager/ZooInspectorNodeTreeManager.java,43,43,43.0,43,0,0.0,0,43,43.0,43,43,43.0,43,1,0,1,NO
8,src/contrib/zooinspector/src/java/org/apache/zookeeper/inspector/manager/ZooInspectorReadOnlyManager.java,99,99,99.0,99,0,0.0,0,99,99.0,99,99,99.0,99,1,0,1,NO
8,src/contrib/zooinspector/src/java/org/apache/zookeeper/retry/ZooKeeperRetry.java,288,288,288.0,288,0,0.0,0,288,288.0,288,288,288.0,288,1,0,1,NO
8,src/java/main/org/apache/jute/BinaryInputArchive.java,131,0,0.0,0,0,0.0,0,0,0.0,0,0,0.0,0,0,0,0,NO
8,src/java/main/org/apache/jute/BinaryOutputArchive.java,146,0,0.0,0,0,0.0,0,0,0.0,0,0,0.0,0,0,0,0,NO
8,src/java/main/org/apache/jute/CsvInputArchive.java,208,1,1.0,1,1,1.0,1,2,2.0,2,0,0.0,0,1,0,1,NO
8,src/java/main/org/apache/jute/CsvOutputArchive.java,150,0,0.0,0,0,0.0,0,0,0.0,0,0,0.0,0,0,0,0,NO
8,src/java/main/org/apache/jute/Index.java,38,0,0.0,0,0,0.0,0,0,0.0,0,0,0.0,0,0,0,0,NO
8,src/java/main/org/apache/jute/InputArchive.java,43,0,0.0,0,0,0.0,0,0,0.0,0,0,0.0,0,0,0,0,NO
8,src/java/main/org/apache/jute/OutputArchive.java,47,0,0.0,0,0,0.0,0,0,0.0,0,0,0.0,0,0,0,0,NO
8,src/java/main/org/apache/jute/Record.java,32,0,0.0,0,0,0.0,0,0,0.0,0,0,0.0,0,0,0,0,NO
8,src/java/main/org/apache/jute/RecordReader.java,93,0,0.0,0,0,0.0,0,0,0.0,0,0,0.0,0,0,0,0,NO
8,src/java/main/org/apache/jute/RecordWriter.java,113,0,0.0,0,0,0.0,0,0,0.0,0,0,0.0,0,0,0,0,NO
8,src/java/main/org/apache/jute/Utils.java,282,6,6.0,6,6,6.0,6,12,12.0,12,0,0.0,0,1,0,1,NO
8,src/java/main/org/apache/jute/XmlInputArchive.java,251,0,0.0,0,0,0.0,0,0,0.0,0,0,0.0,0,0,0,0,NO
8,src/java/main/org/apache/jute/XmlOutputArchive.java,251,1,1.0,1,1,1.0,1,2,2.0,2,0,0.0,0,1,0,1,NO
8,src/java/main/org/apache/jute/compiler/CGenerator.java,130,46,46.0,46,7,7.0,7,53,53.0,53,39,39.0,39,1,0,1,NO
8,src/java/main/org/apache/jute/compiler/CppGenerator.java,125,46,46.0,46,7,7.0,7,53,53.0,53,39,39.0,39,1,0,1,NO
8,src/java/main/org/apache/jute/compiler/JBoolean.java,42,0,0.0,0,0,0.0,0,0,0.0,0,0,0.0,0,0,0,0,NO
8,src/java/main/org/apache/jute/compiler/JBuffer.java,106,3,3.0,3,3,3.0,3,6,6.0,6,0,0.0,0,1,0,1,NO
8,src/java/main/org/apache/jute/compiler/JByte.java,34,0,0.0,0,0,0.0,0,0,0.0,0,0,0.0,0,0,0,0,NO
8,src/java/main/org/apache/jute/compiler/JCompType.java,53,0,0.0,0,0,0.0,0,0,0.0,0,0,0.0,0,0,0,0,NO
8,src/java/main/org/apache/jute/compiler/JDouble.java,40,0,0.0,0,0,0.0,0,0,0.0,0,0,0.0,0,0,0,0,NO
8,src/java/main/org/apache/jute/compiler/JField.java,98,0,0.0,0,0,0.0,0,0,0.0,0,0,0.0,0,0,0,0,NO
8,src/java/main/org/apache/jute/compiler/JFile.java,80,0,0.0,0,0,0.0,0,0,0.0,0,0,0.0,0,0,0,0,NO
8,src/java/main/org/apache/jute/compiler/JFloat.java,39,0,0.0,0,0,0.0,0,0,0.0,0,0,0.0,0,0,0,0,NO
8,src/java/main/org/apache/jute/compiler/JInt.java,34,0,0.0,0,0,0.0,0,0,0.0,0,0,0.0,0,0,0,0,NO
8,src/java/main/org/apache/jute/compiler/JLong.java,38,0,0.0,0,0,0.0,0,0,0.0,0,0,0.0,0,0,0,0,NO
8,src/java/main/org/apache/jute/compiler/JMap.java,103,2,2.0,2,2,2.0,2,4,4.0,4,0,0.0,0,1,0,1,NO
8,src/java/main/org/apache/jute/compiler/JRecord.java,536,187,93.5,187,169,84.5,169,356,178.0,356,18,9.0,18,2,0,1,YES
8,src/java/main/org/apache/jute/compiler/JString.java,46,0,0.0,0,0,0.0,0,0,0.0,0,0,0.0,0,0,0,0,NO
8,src/java/main/org/apache/jute/compiler/JType.java,141,0,0.0,0,0,0.0,0,0,0.0,0,0,0.0,0,0,0,0,NO
8,src/java/main/org/apache/jute/compiler/JVector.java,106,2,2.0,2,2,2.0,2,4,4.0,4,0,0.0,0,1,0,1,NO
8,src/java/main/org/apache/jute/compiler/JavaGenerator.java,57,0,0.0,0,0,0.0,0,0,0.0,0,0,0.0,0,0,0,0,NO
8,src/java/main/org/apache/jute/compiler/generated/ParseException.java,210,0,0.0,0,0,0.0,0,0,0.0,0,0,0.0,0,0,0,0,NO
8,src/java/main/org/apache/jute/compiler/generated/Rcc.java,525,0,0.0,0,0,0.0,0,0,0.0,0,0,0.0,0,0,0,0,NO
8,src/java/main/org/apache/jute/compiler/generated/RccConstants.java,88,0,0.0,0,0,0.0,0,0,0.0,0,0,0.0,0,0,0,0,NO
8,src/java/main/org/apache/jute/compiler/generated/RccTokenManager.java,833,0,0.0,0,0,0.0,0,0,0.0,0,0,0.0,0,0,0,0,NO
8,src/java/main/org/apache/jute/compiler/generated/SimpleCharStream.java,457,0,0.0,0,0,0.0,0,0,0.0,0,0,0.0,0,0,0,0,NO
8,src/java/main/org/apache/jute/compiler/generated/Token.java,99,0,0.0,0,0,0.0,0,0,0.0,0,0,0.0,0,0,0,0,NO
8,src/java/main/org/apache/jute/compiler/generated/TokenMgrError.java,151,0,0.0,0,0,0.0,0,0,0.0,0,0,0.0,0,0,0,0,NO
8,src/java/main/org/apache/zookeeper/AsyncCallback.java,57,0,0.0,0,0,0.0,0,0,0.0,0,0,0.0,0,0,0,0,NO
8,src/java/main/org/apache/zookeeper/ClientCnxn.java,1320,93,18.6,93,27,5.4,27,120,24.0,120,66,13.2,66,5,2,3,YES
8,src/java/main/org/apache/zookeeper/ClientWatchManager.java,39,0,0.0,0,0,0.0,0,0,0.0,0,0,0.0,0,0,0,0,NO
8,src/java/main/org/apache/zookeeper/CreateMode.java,89,0,0.0,0,0,0.0,0,0,0.0,0,0,0.0,0,0,0,0,NO
8,src/java/main/org/apache/zookeeper/Environment.java,100,0,0.0,0,0,0.0,0,0,0.0,0,0,0.0,0,0,0,0,NO
8,src/java/main/org/apache/zookeeper/JLineZNodeCompletor.java,84,0,0.0,0,0,0.0,0,0,0.0,0,0,0.0,0,0,0,0,NO
8,src/java/main/org/apache/zookeeper/KeeperException.java,662,0,0.0,0,0,0.0,0,0,0.0,0,0,0.0,0,0,0,0,NO
8,src/java/main/org/apache/zookeeper/Quotas.java,68,0,0.0,0,0,0.0,0,0,0.0,0,0,0.0,0,0,0,0,NO
8,src/java/main/org/apache/zookeeper/ServerAdminClient.java,312,0,0.0,0,0,0.0,0,0,0.0,0,0,0.0,0,0,0,0,NO
8,src/java/main/org/apache/zookeeper/StatsTrack.java,101,0,0.0,0,0,0.0,0,0,0.0,0,0,0.0,0,0,0,0,NO
8,src/java/main/org/apache/zookeeper/Version.java,78,0,0.0,0,0,0.0,0,0,0.0,0,0,0.0,0,0,0,0,NO
8,src/java/main/org/apache/zookeeper/WatchedEvent.java,79,2,2.0,2,4,4.0,4,6,6.0,6,2,2.0,2,1,1,1,NO
8,src/java/main/org/apache/zookeeper/Watcher.java,125,0,0.0,0,0,0.0,0,0,0.0,0,0,0.0,0,0,0,0,NO
8,src/java/main/org/apache/zookeeper/ZooDefs.java,113,3,3.0,3,4,4.0,4,7,7.0,7,1,1.0,1,1,0,1,NO
8,src/java/main/org/apache/zookeeper/ZooKeeper.java,1546,68,22.666666,68,3,1.0,3,71,23.666666,71,65,21.666666,65,3,1,2,YES
8,src/java/main/org/apache/zookeeper/ZooKeeperMain.java,833,7,3.5,7,6,3.0,6,13,6.5,13,1,0.5,1,2,1,2,NO
8,src/java/main/org/apache/zookeeper/common/PathTrie.java,283,2,2.0,2,2,2.0,2,4,4.0,4,0,0.0,0,1,0,1,NO
8,src/java/main/org/apache/zookeeper/common/PathUtils.java,103,0,0.0,0,0,0.0,0,0,0.0,0,0,0.0,0,0,0,0,NO
8,src/java/main/org/apache/zookeeper/jmx/CommonNames.java,29,0,0.0,0,0,0.0,0,0,0.0,0,0,0.0,0,0,0,0,NO
8,src/java/main/org/apache/zookeeper/jmx/MBeanRegistry.java,194,0,0.0,0,0,0.0,0,0,0.0,0,0,0.0,0,0,0,0,YES
8,src/java/main/org/apache/zookeeper/jmx/ManagedUtil.java,72,0,0.0,0,0,0.0,0,0,0.0,0,0,0.0,0,0,0,0,NO
8,src/java/main/org/apache/zookeeper/jmx/ZKMBeanInfo.java,36,0,0.0,0,0,0.0,0,0,0.0,0,0,0.0,0,0,0,0,NO
8,src/java/main/org/apache/zookeeper/server/ByteBufferInputStream.java,72,0,0.0,0,0,0.0,0,0,0.0,0,0,0.0,0,0,0,0,NO
8,src/java/main/org/apache/zookeeper/server/ConnectionBean.java,173,25,12.5,25,11,5.5,11,36,18.0,36,14,7.0,14,2,2,1,NO
8,src/java/main/org/apache/zookeeper/server/ConnectionMXBean.java,98,0,0.0,0,0,0.0,0,0,0.0,0,0,0.0,0,0,0,0,NO
8,src/java/main/org/apache/zookeeper/server/DataNode.java,170,0,0.0,0,0,0.0,0,0,0.0,0,0,0.0,0,0,0,0,NO
8,src/java/main/org/apache/zookeeper/server/DataTree.java,1185,29,14.5,29,8,4.0,8,37,18.5,37,21,10.5,21,2,0,2,NO
8,src/java/main/org/apache/zookeeper/server/DataTreeBean.java,70,0,0.0,0,0,0.0,0,0,0.0,0,0,0.0,0,0,0,0,NO
8,src/java/main/org/apache/zookeeper/server/DataTreeMXBean.java,47,0,0.0,0,0,0.0,0,0,0.0,0,0,0.0,0,0,0,0,NO
8,src/java/main/org/apache/zookeeper/server/FinalRequestProcessor.java,381,30,7.5,30,17,4.25,17,47,11.75,47,13,3.25,13,4,2,3,NO
8,src/java/main/org/apache/zookeeper/server/LogFormatter.java,107,44,44.0,44,9,9.0,9,53,53.0,53,35,35.0,35,1,1,1,NO
8,src/java/main/org/apache/zookeeper/server/NIOServerCnxn.java,1668,573,81.85714,573,267,38.142857,267,840,120.0,840,306,43.714287,306,7,2,3,YES
8,src/java/main/org/apache/zookeeper/server/ObserverBean.java,45,0,0.0,0,0,0.0,0,0,0.0,0,0,0.0,0,0,0,0,NO
8,src/java/main/org/apache/zookeeper/server/PrepRequestProcessor.java,512,9,3.0,9,9,3.0,9,18,6.0,18,0,0.0,0,3,1,2,YES
8,src/java/main/org/apache/zookeeper/server/PurgeTxnLog.java,132,0,0.0,0,0,0.0,0,0,0.0,0,0,0.0,0,0,0,0,NO
8,src/java/main/org/apache/zookeeper/server/Request.java,232,1,1.0,1,1,1.0,1,2,2.0,2,0,0.0,0,1,0,1,NO
8,src/java/main/org/apache/zookeeper/server/RequestProcessor.java,37,0,0.0,0,0,0.0,0,0,0.0,0,0,0.0,0,0,0,0,NO
8,src/java/main/org/apache/zookeeper/server/ServerCnxn.java,108,0,0.0,0,29,29.0,29,29,29.0,29,29,29.0,29,1,0,1,NO
8,src/java/main/org/apache/zookeeper/server/ServerConfig.java,111,22,11.0,22,5,2.5,5,27,13.5,27,17,8.5,17,2,0,2,NO
8,src/java/main/org/apache/zookeeper/server/ServerStats.java,132,0,0.0,0,0,0.0,0,0,0.0,0,0,0.0,0,0,0,0,NO
8,src/java/main/org/apache/zookeeper/server/SessionTracker.java,74,8,8.0,8,0,0.0,0,8,8.0,8,8,8.0,8,1,0,1,NO
8,src/java/main/org/apache/zookeeper/server/SessionTrackerImpl.java,257,37,18.5,37,24,12.0,24,61,30.5,61,13,6.5,13,2,0,2,YES
8,src/java/main/org/apache/zookeeper/server/SyncRequestProcessor.java,183,15,3.75,15,10,2.5,10,25,6.25,25,15,3.75,15,4,1,2,YES
8,src/java/main/org/apache/zookeeper/server/TraceFormatter.java,121,0,0.0,0,0,0.0,0,0,0.0,0,0,0.0,0,0,0,0,NO
8,src/java/main/org/apache/zookeeper/server/WatchManager.java,166,57,57.0,57,4,4.0,4,61,61.0,61,53,53.0,53,1,0,1,NO
8,src/java/main/org/apache/zookeeper/server/ZKDatabase.java,461,466,155.33333,466,5,1.6666666,5,471,157.0,471,461,153.66667,461,3,1,1,NO
8,src/java/main/org/apache/zookeeper/server/ZooKeeperServer.java,702,132,44.0,132,133,44.333332,133,265,88.333336,265,109,36.333332,109,3,1,1,YES
8,src/java/main/org/apache/zookeeper/server/ZooKeeperServerBean.java,143,29,29.0,29,0,0.0,0,29,29.0,29,29,29.0,29,1,0,1,NO
8,src/java/main/org/apache/zookeeper/server/ZooKeeperServerMXBean.java,106,26,26.0,26,2,2.0,2,28,28.0,28,24,24.0,24,1,0,1,NO
8,src/java/main/org/apache/zookeeper/server/ZooKeeperServerMain.java,127,6,3.0,6,3,1.5,3,9,4.5,9,3,1.5,3,2,0,2,NO
8,src/java/main/org/apache/zookeeper/server/ZooTrace.java,92,0,0.0,0,0,0.0,0,0,0.0,0,0,0.0,0,0,0,0,NO
8,src/java/main/org/apache/zookeeper/server/auth/AuthenticationProvider.java,82,0,0.0,0,0,0.0,0,0,0.0,0,0,0.0,0,0,0,0,NO
8,src/java/main/org/apache/zookeeper/server/auth/DigestAuthenticationProvider.java,138,1,1.0,1,1,1.0,1,2,2.0,2,0,0.0,0,1,0,1,NO
8,src/java/main/org/apache/zookeeper/server/auth/IPAuthenticationProvider.java,117,0,0.0,0,0,0.0,0,0,0.0,0,0,0.0,0,0,0,0,NO
8,src/java/main/org/apache/zookeeper/server/auth/ProviderRegistry.java,76,0,0.0,0,0,0.0,0,0,0.0,0,0,0.0,0,0,0,0,NO
8,src/java/main/org/apache/zookeeper/server/persistence/FileSnap.java,249,27,13.5,27,14,7.0,14,41,20.5,41,13,6.5,13,2,1,1,NO
8,src/java/main/org/apache/zookeeper/server/persistence/FileTxnLog.java,604,55,13.75,55,4,1.0,4,59,14.75,59,51,12.75,51,4,1,3,NO
8,src/java/main/org/apache/zookeeper/server/persistence/FileTxnSnapLog.java,296,9,4.5,9,1,0.5,1,10,5.0,10,8,4.0,8,2,0,2,NO
8,src/java/main/org/apache/zookeeper/server/persistence/SnapShot.java,66,6,6.0,6,0,0.0,0,6,6.0,6,6,6.0,6,1,0,1,NO
8,src/java/main/org/apache/zookeeper/server/persistence/TxnLog.java,120,4,4.0,4,0,0.0,0,4,4.0,4,4,4.0,4,1,0,1,NO
8,src/java/main/org/apache/zookeeper/server/persistence/Util.java,325,0,0.0,0,0,0.0,0,0,0.0,0,0,0.0,0,0,0,0,NO
8,src/java/main/org/apache/zookeeper/server/quorum/AckRequestProcessor.java,53,0,0.0,0,0,0.0,0,0,0.0,0,0,0.0,0,0,0,0,NO
8,src/java/main/org/apache/zookeeper/server/quorum/AuthFastLeaderElection.java,968,11,11.0,11,0,0.0,0,11,11.0,11,11,11.0,11,1,0,1,YES
8,src/java/main/org/apache/zookeeper/server/quorum/CommitProcessor.java,189,0,0.0,0,0,0.0,0,0,0.0,0,0,0.0,0,0,0,0,YES
8,src/java/main/org/apache/zookeeper/server/quorum/Election.java,27,1,1.0,1,0,0.0,0,1,1.0,1,1,1.0,1,1,0,1,NO
8,src/java/main/org/apache/zookeeper/server/quorum/FastLeaderElection.java,837,207,103.5,207,114,57.0,114,321,160.5,321,93,46.5,93,2,1,2,YES
8,src/java/main/org/apache/zookeeper/server/quorum/Follower.java,169,2,1.0,2,2,1.0,2,4,2.0,4,0,0.0,0,2,1,2,YES
8,src/java/main/org/apache/zookeeper/server/quorum/FollowerBean.java,50,0,0.0,0,0,0.0,0,0,0.0,0,0,0.0,0,0,0,0,NO
8,src/java/main/org/apache/zookeeper/server/quorum/FollowerMXBean.java,41,0,0.0,0,0,0.0,0,0,0.0,0,0,0.0,0,0,0,0,NO
8,src/java/main/org/apache/zookeeper/server/quorum/FollowerRequestProcessor.java,109,0,0.0,0,0,0.0,0,0,0.0,0,0,0.0,0,0,0,0,YES
8,src/java/main/org/apache/zookeeper/server/quorum/FollowerZooKeeperServer.java,162,7,3.5,7,5,2.5,5,12,6.0,12,2,1.0,2,2,1,1,NO
8,src/java/main/org/apache/zookeeper/server/quorum/Leader.java,718,7,2.3333333,7,8,2.6666667,8,15,5.0,15,1,0.33333334,1,3,2,2,YES
8,src/java/main/org/apache/zookeeper/server/quorum/LeaderBean.java,53,1,1.0,1,1,1.0,1,2,2.0,2,0,0.0,0,1,0,1,NO
8,src/java/main/org/apache/zookeeper/server/quorum/LeaderElection.java,274,56,18.666666,56,35,11.666667,35,91,30.333334,91,21,7.0,21,3,2,3,YES
8,src/java/main/org/apache/zookeeper/server/quorum/LeaderElectionBean.java,42,0,0.0,0,0,0.0,0,0,0.0,0,0,0.0,0,0,0,0,NO
8,src/java/main/org/apache/zookeeper/server/quorum/LeaderElectionMXBean.java,31,0,0.0,0,0,0.0,0,0,0.0,0,0,0.0,0,0,0,0,NO
8,src/java/main/org/apache/zookeeper/server/quorum/LeaderMXBean.java,36,0,0.0,0,0,0.0,0,0,0.0,0,0,0.0,0,0,0,0,NO
8,src/java/main/org/apache/zookeeper/server/quorum/LeaderZooKeeperServer.java,176,19,9.5,19,12,6.0,12,31,15.5,31,7,3.5,7,2,1,1,NO
8,src/java/main/org/apache/zookeeper/server/quorum/Learner.java,375,5,5.0,5,5,5.0,5,10,10.0,10,0,0.0,0,1,1,1,YES
8,src/java/main/org/apache/zookeeper/server/quorum/LearnerHandler.java,506,25,6.25,25,13,3.25,13,38,9.5,38,12,3.0,12,4,2,3,YES
8,src/java/main/org/apache/zookeeper/server/quorum/LearnerSessionTracker.java,92,7,7.0,7,4,4.0,4,11,11.0,11,3,3.0,3,1,0,1,NO
8,src/java/main/org/apache/zookeeper/server/quorum/LearnerSyncRequest.java,34,0,0.0,0,0,0.0,0,0,0.0,0,0,0.0,0,0,0,0,NO
8,src/java/main/org/apache/zookeeper/server/quorum/LearnerZooKeeperServer.java,142,13,6.5,13,20,10.0,20,33,16.5,33,7,3.5,7,2,1,1,NO
8,src/java/main/org/apache/zookeeper/server/quorum/LocalPeerBean.java,85,17,17.0,17,0,0.0,0,17,17.0,17,17,17.0,17,1,0,1,NO
8,src/java/main/org/apache/zookeeper/server/quorum/LocalPeerMXBean.java,77,13,13.0,13,0,0.0,0,13,13.0,13,13,13.0,13,1,0,1,NO
8,src/java/main/org/apache/zookeeper/server/quorum/Observer.java,146,2,1.0,2,2,1.0,2,4,2.0,4,0,0.0,0,2,1,2,NO
8,src/java/main/org/apache/zookeeper/server/quorum/ObserverMXBean.java,37,0,0.0,0,0,0.0,0,0,0.0,0,0,0.0,0,0,0,0,NO
8,src/java/main/org/apache/zookeeper/server/quorum/ObserverRequestProcessor.java,123,0,0.0,0,0,0.0,0,0,0.0,0,0,0.0,0,0,0,0,YES
8,src/java/main/org/apache/zookeeper/server/quorum/ObserverZooKeeperServer.java,116,7,3.5,7,5,2.5,5,12,6.0,12,2,1.0,2,2,1,1,NO
8,src/java/main/org/apache/zookeeper/server/quorum/ProposalRequestProcessor.java,82,0,0.0,0,0,0.0,0,0,0.0,0,0,0.0,0,0,0,0,NO
8,src/java/main/org/apache/zookeeper/server/quorum/QuorumBean.java,44,0,0.0,0,0,0.0,0,0,0.0,0,0,0.0,0,0,0,0,NO
8,src/java/main/org/apache/zookeeper/server/quorum/QuorumCnxManager.java,668,42,14.0,42,26,8.666667,26,68,22.666666,68,18,6.0,18,3,1,3,YES
8,src/java/main/org/apache/zookeeper/server/quorum/QuorumMXBean.java,34,0,0.0,0,0,0.0,0,0,0.0,0,0,0.0,0,0,0,0,NO
8,src/java/main/org/apache/zookeeper/server/quorum/QuorumPeer.java,947,124,13.777778,124,50,5.5555553,50,174,19.333334,174,76,8.444445,76,9,3,4,YES
8,src/java/main/org/apache/zookeeper/server/quorum/QuorumPeerConfig.java,344,73,24.333334,73,50,16.666666,50,123,41.0,123,29,9.666667,29,3,0,2,YES
8,src/java/main/org/apache/zookeeper/server/quorum/QuorumPeerMain.java,150,8,2.0,8,7,1.75,7,15,3.75,15,9,2.25,9,4,2,3,YES
8,src/java/main/org/apache/zookeeper/server/quorum/QuorumStats.java,68,0,0.0,0,0,0.0,0,0,0.0,0,0,0.0,0,0,0,0,NO
8,src/java/main/org/apache/zookeeper/server/quorum/QuorumZooKeeperServer.java,62,62,62.0,62,0,0.0,0,62,62.0,62,62,62.0,62,1,0,1,YES
8,src/java/main/org/apache/zookeeper/server/quorum/RemotePeerBean.java,45,0,0.0,0,0,0.0,0,0,0.0,0,0,0.0,0,0,0,0,NO
8,src/java/main/org/apache/zookeeper/server/quorum/RemotePeerMXBean.java,33,0,0.0,0,0,0.0,0,0,0.0,0,0,0.0,0,0,0,0,NO
8,src/java/main/org/apache/zookeeper/server/quorum/SendAckRequestProcessor.java,79,0,0.0,0,0,0.0,0,0,0.0,0,0,0.0,0,0,0,0,NO
8,src/java/main/org/apache/zookeeper/server/quorum/ServerBean.java,38,0,0.0,0,0,0.0,0,0,0.0,0,0,0.0,0,0,0,0,NO
8,src/java/main/org/apache/zookeeper/server/quorum/ServerMXBean.java,33,0,0.0,0,0,0.0,0,0,0.0,0,0,0.0,0,0,0,0,NO
8,src/java/main/org/apache/zookeeper/server/quorum/Vote.java,69,0,0.0,0,0,0.0,0,0,0.0,0,0,0.0,0,0,0,0,YES
8,src/java/main/org/apache/zookeeper/server/quorum/flexible/QuorumHierarchical.java,272,0,0.0,0,0,0.0,0,0,0.0,0,0,0.0,0,0,0,0,NO
8,src/java/main/org/apache/zookeeper/server/quorum/flexible/QuorumMaj.java,57,0,0.0,0,0,0.0,0,0,0.0,0,0,0.0,0,0,0,0,NO
8,src/java/main/org/apache/zookeeper/server/quorum/flexible/QuorumVerifier.java,33,0,0.0,0,0,0.0,0,0,0.0,0,0,0.0,0,0,0,0,NO
8,src/java/main/org/apache/zookeeper/server/upgrade/DataNodeV1.java,129,0,0.0,0,0,0.0,0,0,0.0,0,0,0.0,0,0,0,0,NO
8,src/java/main/org/apache/zookeeper/server/upgrade/DataTreeV1.java,583,1,1.0,1,1,1.0,1,2,2.0,2,0,0.0,0,1,0,1,NO
8,src/java/main/org/apache/zookeeper/server/upgrade/UpgradeMain.java,180,0,0.0,0,0,0.0,0,0,0.0,0,0,0.0,0,0,0,0,NO
8,src/java/main/org/apache/zookeeper/server/upgrade/UpgradeSnapShot.java,33,0,0.0,0,0,0.0,0,0,0.0,0,0,0.0,0,0,0,0,NO
8,src/java/main/org/apache/zookeeper/server/upgrade/UpgradeSnapShotV1.java,333,0,0.0,0,0,0.0,0,0,0.0,0,0,0.0,0,0,0,0,NO
8,src/java/main/org/apache/zookeeper/server/util/Profiler.java,40,0,0.0,0,0,0.0,0,0,0.0,0,0,0.0,0,0,0,0,NO
8,src/java/main/org/apache/zookeeper/server/util/SerializeUtils.java,107,0,0.0,0,0,0.0,0,0,0.0,0,0,0.0,0,0,0,0,NO
8,src/java/main/org/apache/zookeeper/version/util/VerGen.java,146,18,18.0,18,0,0.0,0,18,18.0,18,18,18.0,18,1,0,1,NO
8,src/recipes/lock/src/java/org/apache/zookeeper/recipes/lock/LockListener.java,38,0,0.0,0,0,0.0,0,0,0.0,0,0,0.0,0,0,0,0,NO
8,src/recipes/lock/src/java/org/apache/zookeeper/recipes/lock/ProtocolSupport.java,192,0,0.0,0,0,0.0,0,0,0.0,0,0,0.0,0,0,0,0,NO
8,src/recipes/lock/src/java/org/apache/zookeeper/recipes/lock/WriteLock.java,294,0,0.0,0,0,0.0,0,0,0.0,0,0,0.0,0,0,0,0,NO
8,src/recipes/lock/src/java/org/apache/zookeeper/recipes/lock/ZNodeName.java,109,0,0.0,0,0,0.0,0,0,0.0,0,0,0.0,0,0,0,0,NO
8,src/recipes/lock/src/java/org/apache/zookeeper/recipes/lock/ZooKeeperOperation.java,38,0,0.0,0,0,0.0,0,0,0.0,0,0,0.0,0,0,0,0,NO
8,src/recipes/queue/src/java/org/apache/zookeeper/recipes/queue/DistributedQueue.java,312,0,0.0,0,0,0.0,0,0,0.0,0,0,0.0,0,0,0,0,NO
