RELEASE_ID,FILE_NAME,SIZE,LOC_ADDED,LOC_ADDED_AVG,LOC_ADDED_MAX,LOC_REMOVED,LOC_REMOVED_AVG,LOC_REMOVED_MAX,LOC_TOUCHED,LOC_TOUCHED_AVG,LOC_TOUCHED_MAX,CHURN,CHURN_AVG,CHURN_MAX,NUMBER_OF_REVISIONS,NUMBER_OF_DEFECT_FIXES,NUMBER_OF_AUTHORS,IS_BUGGY
4,bookkeeper-benchmark/src/main/java/org/apache/bookkeeper/benchmark/BenchBookie.java,215,0,0.0,0,0,0.0,0,0,0.0,0,0,0.0,0,0,0,0,NO
4,bookkeeper-benchmark/src/main/java/org/apache/bookkeeper/benchmark/BenchReadThroughputLatency.java,273,4,4.0,4,2,2.0,2,6,6.0,6,2,2.0,2,1,1,1,YES
4,bookkeeper-benchmark/src/main/java/org/apache/bookkeeper/benchmark/BenchThroughputLatency.java,460,5,5.0,5,3,3.0,3,8,8.0,8,2,2.0,2,1,1,1,YES
4,bookkeeper-benchmark/src/main/java/org/apache/bookkeeper/benchmark/MySqlClient.java,138,5,5.0,5,4,4.0,4,9,9.0,9,1,1.0,1,1,1,1,NO
4,bookkeeper-benchmark/src/main/java/org/apache/bookkeeper/benchmark/TestClient.java,358,2,2.0,2,1,1.0,1,3,3.0,3,1,1.0,1,1,1,1,NO
4,bookkeeper-server/src/main/java/org/apache/bookkeeper/bookie/Bookie.java,1248,9,4.5,9,3,1.5,3,12,6.0,12,6,3.0,6,2,2,2,YES
4,bookkeeper-server/src/main/java/org/apache/bookkeeper/bookie/BookieBean.java,51,0,0.0,0,0,0.0,0,0,0.0,0,0,0.0,0,0,0,0,NO
4,bookkeeper-server/src/main/java/org/apache/bookkeeper/bookie/BookieException.java,157,4,4.0,4,1,1.0,1,5,5.0,5,3,3.0,3,1,1,1,NO
4,bookkeeper-server/src/main/java/org/apache/bookkeeper/bookie/BookieMXBean.java,31,0,0.0,0,0,0.0,0,0,0.0,0,0,0.0,0,0,0,0,NO
4,bookkeeper-server/src/main/java/org/apache/bookkeeper/bookie/BookieShell.java,981,54,54.0,54,1,1.0,1,55,55.0,55,53,53.0,53,1,0,1,YES
4,bookkeeper-server/src/main/java/org/apache/bookkeeper/bookie/BufferedChannel.java,180,0,0.0,0,0,0.0,0,0,0.0,0,0,0.0,0,0,0,0,NO
4,bookkeeper-server/src/main/java/org/apache/bookkeeper/bookie/Cookie.java,262,8,8.0,8,6,6.0,6,14,14.0,14,2,2.0,2,1,1,1,NO
4,bookkeeper-server/src/main/java/org/apache/bookkeeper/bookie/EntryLogger.java,553,5,5.0,5,3,3.0,3,8,8.0,8,2,2.0,2,1,1,1,YES
4,bookkeeper-server/src/main/java/org/apache/bookkeeper/bookie/ExitCode.java,40,0,0.0,0,0,0.0,0,0,0.0,0,0,0.0,0,0,0,0,NO
4,bookkeeper-server/src/main/java/org/apache/bookkeeper/bookie/FileInfo.java,369,9,4.5,9,1,0.5,1,10,5.0,10,8,4.0,8,2,2,2,NO
4,bookkeeper-server/src/main/java/org/apache/bookkeeper/bookie/FileSystemUpgrade.java,390,3,3.0,3,1,1.0,1,4,4.0,4,2,2.0,2,1,1,1,NO
4,bookkeeper-server/src/main/java/org/apache/bookkeeper/bookie/GarbageCollector.java,51,0,0.0,0,0,0.0,0,0,0.0,0,0,0.0,0,0,0,0,NO
4,bookkeeper-server/src/main/java/org/apache/bookkeeper/bookie/GarbageCollectorThread.java,577,0,0.0,0,0,0.0,0,0,0.0,0,0,0.0,0,0,0,0,YES
4,bookkeeper-server/src/main/java/org/apache/bookkeeper/bookie/HandleFactory.java,32,0,0.0,0,0,0.0,0,0,0.0,0,0,0.0,0,0,0,0,NO
4,bookkeeper-server/src/main/java/org/apache/bookkeeper/bookie/HandleFactoryImpl.java,66,0,0.0,0,0,0.0,0,0,0.0,0,0,0.0,0,0,0,0,NO
4,bookkeeper-server/src/main/java/org/apache/bookkeeper/bookie/InterleavedLedgerStorage.java,188,1,1.0,1,1,1.0,1,2,2.0,2,0,0.0,0,1,1,1,YES
4,bookkeeper-server/src/main/java/org/apache/bookkeeper/bookie/Journal.java,582,0,0.0,0,0,0.0,0,0,0.0,0,0,0.0,0,0,0,0,YES
4,bookkeeper-server/src/main/java/org/apache/bookkeeper/bookie/JournalChannel.java,160,3,3.0,3,1,1.0,1,4,4.0,4,2,2.0,2,1,1,1,YES
4,bookkeeper-server/src/main/java/org/apache/bookkeeper/bookie/LedgerCache.java,50,0,0.0,0,0,0.0,0,0,0.0,0,0,0.0,0,0,0,0,NO
4,bookkeeper-server/src/main/java/org/apache/bookkeeper/bookie/LedgerCacheBean.java,27,0,0.0,0,0,0.0,0,0,0.0,0,0,0.0,0,0,0,0,NO
4,bookkeeper-server/src/main/java/org/apache/bookkeeper/bookie/LedgerCacheImpl.java,923,15,5.0,15,20,6.6666665,20,35,11.666667,35,19,6.3333335,19,3,2,2,YES
4,bookkeeper-server/src/main/java/org/apache/bookkeeper/bookie/LedgerCacheMXBean.java,60,0,0.0,0,0,0.0,0,0,0.0,0,0,0.0,0,0,0,0,NO
4,bookkeeper-server/src/main/java/org/apache/bookkeeper/bookie/LedgerDescriptor.java,62,0,0.0,0,0,0.0,0,0,0.0,0,0,0.0,0,0,0,0,NO
4,bookkeeper-server/src/main/java/org/apache/bookkeeper/bookie/LedgerDescriptorImpl.java,87,0,0.0,0,0,0.0,0,0,0.0,0,0,0.0,0,0,0,0,NO
4,bookkeeper-server/src/main/java/org/apache/bookkeeper/bookie/LedgerDescriptorReadOnlyImpl.java,52,0,0.0,0,0,0.0,0,0,0.0,0,0,0.0,0,0,0,0,NO
4,bookkeeper-server/src/main/java/org/apache/bookkeeper/bookie/LedgerDirsManager.java,268,0,0.0,0,0,0.0,0,0,0.0,0,0,0.0,0,0,0,0,YES
4,bookkeeper-server/src/main/java/org/apache/bookkeeper/bookie/LedgerEntryPage.java,163,0,0.0,0,0,0.0,0,0,0.0,0,0,0.0,0,0,0,0,NO
4,bookkeeper-server/src/main/java/org/apache/bookkeeper/bookie/LedgerStorage.java,109,0,0.0,0,0,0.0,0,0,0.0,0,0,0.0,0,0,0,0,NO
4,bookkeeper-server/src/main/java/org/apache/bookkeeper/bookie/MarkerFileChannel.java,147,0,0.0,0,0,0.0,0,0,0.0,0,0,0.0,0,0,0,0,NO
4,bookkeeper-server/src/main/java/org/apache/bookkeeper/bookie/ReadOnlyEntryLogger.java,58,0,0.0,0,0,0.0,0,0,0.0,0,0,0.0,0,0,0,0,NO
4,bookkeeper-server/src/main/java/org/apache/bookkeeper/bookie/ReadOnlyFileInfo.java,44,0,0.0,0,0,0.0,0,0,0.0,0,0,0.0,0,0,0,0,NO
4,bookkeeper-server/src/main/java/org/apache/bookkeeper/bookie/ScanAndCompareGarbageCollector.java,106,0,0.0,0,0,0.0,0,0,0.0,0,0,0.0,0,0,0,0,YES
4,bookkeeper-server/src/main/java/org/apache/bookkeeper/client/AsyncCallback.java,139,0,0.0,0,0,0.0,0,0,0.0,0,0,0.0,0,0,0,0,NO
4,bookkeeper-server/src/main/java/org/apache/bookkeeper/client/BKException.java,326,0,0.0,0,0,0.0,0,0,0.0,0,0,0.0,0,0,0,0,YES
4,bookkeeper-server/src/main/java/org/apache/bookkeeper/client/BookKeeper.java,648,0,0.0,0,0,0.0,0,0,0.0,0,0,0.0,0,0,0,0,YES
4,bookkeeper-server/src/main/java/org/apache/bookkeeper/client/BookKeeperAdmin.java,792,17,8.5,17,3,1.5,3,20,10.0,20,14,7.0,14,2,1,1,YES
4,bookkeeper-server/src/main/java/org/apache/bookkeeper/client/BookieWatcher.java,319,6,3.0,6,1,0.5,1,7,3.5,7,5,2.5,5,2,1,2,YES
4,bookkeeper-server/src/main/java/org/apache/bookkeeper/client/CRC32DigestManager.java,55,0,0.0,0,0,0.0,0,0,0.0,0,0,0.0,0,0,0,0,NO
4,bookkeeper-server/src/main/java/org/apache/bookkeeper/client/DigestManager.java,191,0,0.0,0,0,0.0,0,0,0.0,0,0,0.0,0,0,0,0,NO
4,bookkeeper-server/src/main/java/org/apache/bookkeeper/client/DistributionSchedule.java,90,0,0.0,0,0,0.0,0,0,0.0,0,0,0.0,0,0,0,0,NO
4,bookkeeper-server/src/main/java/org/apache/bookkeeper/client/LedgerChecker.java,273,0,0.0,0,0,0.0,0,0,0.0,0,0,0.0,0,0,0,0,YES
4,bookkeeper-server/src/main/java/org/apache/bookkeeper/client/LedgerCreateOp.java,137,0,0.0,0,0,0.0,0,0,0.0,0,0,0.0,0,0,0,0,NO
4,bookkeeper-server/src/main/java/org/apache/bookkeeper/client/LedgerDeleteOp.java,79,0,0.0,0,0,0.0,0,0,0.0,0,0,0.0,0,0,0,0,NO
4,bookkeeper-server/src/main/java/org/apache/bookkeeper/client/LedgerEntry.java,82,0,0.0,0,0,0.0,0,0,0.0,0,0,0.0,0,0,0,0,NO
4,bookkeeper-server/src/main/java/org/apache/bookkeeper/client/LedgerFragment.java,147,0,0.0,0,0,0.0,0,0,0.0,0,0,0.0,0,0,0,0,NO
4,bookkeeper-server/src/main/java/org/apache/bookkeeper/client/LedgerFragmentReplicator.java,422,0,0.0,0,0,0.0,0,0,0.0,0,0,0.0,0,0,0,0,YES
4,bookkeeper-server/src/main/java/org/apache/bookkeeper/client/LedgerHandle.java,979,5,5.0,5,4,4.0,4,9,9.0,9,1,1.0,1,1,1,1,YES
4,bookkeeper-server/src/main/java/org/apache/bookkeeper/client/LedgerMetadata.java,495,45,22.5,45,17,8.5,17,62,31.0,62,28,14.0,28,2,1,2,YES
4,bookkeeper-server/src/main/java/org/apache/bookkeeper/client/LedgerOpenOp.java,189,0,0.0,0,0,0.0,0,0,0.0,0,0,0.0,0,0,0,0,YES
4,bookkeeper-server/src/main/java/org/apache/bookkeeper/client/LedgerRecoveryOp.java,167,36,36.0,36,22,22.0,22,58,58.0,58,14,14.0,14,1,0,1,YES
4,bookkeeper-server/src/main/java/org/apache/bookkeeper/client/MacDigestManager.java,86,3,3.0,3,1,1.0,1,4,4.0,4,2,2.0,2,1,1,1,NO
4,bookkeeper-server/src/main/java/org/apache/bookkeeper/client/PendingAddOp.java,182,0,0.0,0,0,0.0,0,0,0.0,0,0,0.0,0,0,0,0,YES
4,bookkeeper-server/src/main/java/org/apache/bookkeeper/client/PendingReadOp.java,361,21,21.0,21,18,18.0,18,39,39.0,39,3,3.0,3,1,0,1,YES
4,bookkeeper-server/src/main/java/org/apache/bookkeeper/client/ReadLastConfirmedOp.java,126,0,0.0,0,0,0.0,0,0,0.0,0,0,0.0,0,0,0,0,YES
4,bookkeeper-server/src/main/java/org/apache/bookkeeper/client/ReadOnlyLedgerHandle.java,106,0,0.0,0,0,0.0,0,0,0.0,0,0,0.0,0,0,0,0,NO
4,bookkeeper-server/src/main/java/org/apache/bookkeeper/client/RoundRobinDistributionSchedule.java,109,0,0.0,0,0,0.0,0,0,0.0,0,0,0.0,0,0,0,0,NO
4,bookkeeper-server/src/main/java/org/apache/bookkeeper/client/SyncCounter.java,85,0,0.0,0,0,0.0,0,0,0.0,0,0,0.0,0,0,0,0,NO
4,bookkeeper-server/src/main/java/org/apache/bookkeeper/conf/AbstractConfiguration.java,236,0,0.0,0,0,0.0,0,0,0.0,0,0,0.0,0,0,0,0,NO
4,bookkeeper-server/src/main/java/org/apache/bookkeeper/conf/ClientConfiguration.java,315,4,2.0,4,3,1.5,3,7,3.5,7,1,0.5,1,2,2,2,YES
4,bookkeeper-server/src/main/java/org/apache/bookkeeper/conf/ServerConfiguration.java,695,11,2.75,11,10,2.5,10,21,5.25,21,5,1.25,5,4,4,3,YES
4,bookkeeper-server/src/main/java/org/apache/bookkeeper/jmx/BKMBeanInfo.java,27,0,0.0,0,0,0.0,0,0,0.0,0,0,0.0,0,0,0,0,NO
4,bookkeeper-server/src/main/java/org/apache/bookkeeper/jmx/BKMBeanRegistry.java,89,0,0.0,0,0,0.0,0,0,0.0,0,0,0.0,0,0,0,0,NO
4,bookkeeper-server/src/main/java/org/apache/bookkeeper/meta/AbstractZkLedgerManager.java,301,1,1.0,1,1,1.0,1,2,2.0,2,0,0.0,0,1,1,1,YES
4,bookkeeper-server/src/main/java/org/apache/bookkeeper/meta/FlatLedgerManager.java,153,0,0.0,0,0,0.0,0,0,0.0,0,0,0.0,0,0,0,0,YES
4,bookkeeper-server/src/main/java/org/apache/bookkeeper/meta/FlatLedgerManagerFactory.java,92,0,0.0,0,0,0.0,0,0,0.0,0,0,0.0,0,0,0,0,NO
4,bookkeeper-server/src/main/java/org/apache/bookkeeper/meta/HierarchicalLedgerManager.java,466,1,1.0,1,1,1.0,1,2,2.0,2,0,0.0,0,1,1,1,YES
4,bookkeeper-server/src/main/java/org/apache/bookkeeper/meta/HierarchicalLedgerManagerFactory.java,93,0,0.0,0,0,0.0,0,0,0.0,0,0,0.0,0,0,0,0,NO
4,bookkeeper-server/src/main/java/org/apache/bookkeeper/meta/LedgerLayout.java,244,0,0.0,0,0,0.0,0,0,0.0,0,0,0.0,0,0,0,0,NO
4,bookkeeper-server/src/main/java/org/apache/bookkeeper/meta/LedgerManager.java,192,0,0.0,0,0,0.0,0,0,0.0,0,0,0.0,0,0,0,0,YES
4,bookkeeper-server/src/main/java/org/apache/bookkeeper/meta/LedgerManagerFactory.java,252,6,6.0,6,4,4.0,4,10,10.0,10,2,2.0,2,1,1,1,NO
4,bookkeeper-server/src/main/java/org/apache/bookkeeper/meta/LedgerUnderreplicationManager.java,109,0,0.0,0,0,0.0,0,0,0.0,0,0,0.0,0,0,0,0,NO
4,bookkeeper-server/src/main/java/org/apache/bookkeeper/meta/MSLedgerManagerFactory.java,601,0,0.0,0,0,0.0,0,0,0.0,0,0,0.0,0,0,0,0,YES
4,bookkeeper-server/src/main/java/org/apache/bookkeeper/meta/ZkLedgerUnderreplicationManager.java,565,1,1.0,1,1,1.0,1,2,2.0,2,0,0.0,0,1,1,1,YES
4,bookkeeper-server/src/main/java/org/apache/bookkeeper/meta/ZkVersion.java,69,0,0.0,0,0,0.0,0,0,0.0,0,0,0.0,0,0,0,0,NO
4,bookkeeper-server/src/main/java/org/apache/bookkeeper/metastore/InMemoryMetaStore.java,77,0,0.0,0,0,0.0,0,0,0.0,0,0,0.0,0,0,0,0,NO
4,bookkeeper-server/src/main/java/org/apache/bookkeeper/metastore/InMemoryMetastoreCursor.java,94,0,0.0,0,0,0.0,0,0,0.0,0,0,0.0,0,0,0,0,YES
4,bookkeeper-server/src/main/java/org/apache/bookkeeper/metastore/InMemoryMetastoreTable.java,337,0,0.0,0,0,0.0,0,0,0.0,0,0,0.0,0,0,0,0,NO
4,bookkeeper-server/src/main/java/org/apache/bookkeeper/metastore/MSException.java,214,0,0.0,0,0,0.0,0,0,0.0,0,0,0.0,0,0,0,0,NO
4,bookkeeper-server/src/main/java/org/apache/bookkeeper/metastore/MetaStore.java,79,0,0.0,0,0,0.0,0,0,0.0,0,0,0.0,0,0,0,0,NO
4,bookkeeper-server/src/main/java/org/apache/bookkeeper/metastore/MetastoreCallback.java,25,0,0.0,0,0,0.0,0,0,0.0,0,0,0.0,0,0,0,0,NO
4,bookkeeper-server/src/main/java/org/apache/bookkeeper/metastore/MetastoreCursor.java,84,0,0.0,0,0,0.0,0,0,0.0,0,0,0.0,0,0,0,0,NO
4,bookkeeper-server/src/main/java/org/apache/bookkeeper/metastore/MetastoreException.java,34,0,0.0,0,0,0.0,0,0,0.0,0,0,0.0,0,0,0,0,NO
4,bookkeeper-server/src/main/java/org/apache/bookkeeper/metastore/MetastoreFactory.java,33,0,0.0,0,0,0.0,0,0,0.0,0,0,0.0,0,0,0,0,NO
4,bookkeeper-server/src/main/java/org/apache/bookkeeper/metastore/MetastoreScannableTable.java,104,0,0.0,0,0,0.0,0,0,0.0,0,0,0.0,0,0,0,0,NO
4,bookkeeper-server/src/main/java/org/apache/bookkeeper/metastore/MetastoreTable.java,172,0,0.0,0,0,0.0,0,0,0.0,0,0,0.0,0,0,0,0,NO
4,bookkeeper-server/src/main/java/org/apache/bookkeeper/metastore/MetastoreTableItem.java,70,0,0.0,0,0,0.0,0,0,0.0,0,0,0.0,0,0,0,0,NO
4,bookkeeper-server/src/main/java/org/apache/bookkeeper/metastore/MetastoreUtils.java,140,0,0.0,0,0,0.0,0,0,0.0,0,0,0.0,0,0,0,0,NO
4,bookkeeper-server/src/main/java/org/apache/bookkeeper/metastore/Value.java,156,3,3.0,3,1,1.0,1,4,4.0,4,2,2.0,2,1,1,1,NO
4,bookkeeper-server/src/main/java/org/apache/bookkeeper/proto/BKStats.java,248,0,0.0,0,0,0.0,0,0,0.0,0,0,0.0,0,0,0,0,NO
4,bookkeeper-server/src/main/java/org/apache/bookkeeper/proto/BookieClient.java,277,3,3.0,3,1,1.0,1,4,4.0,4,2,2.0,2,1,1,1,YES
4,bookkeeper-server/src/main/java/org/apache/bookkeeper/proto/BookieNettyServer.java,189,191,95.5,191,2,1.0,2,193,96.5,193,189,94.5,189,2,0,2,NO
4,bookkeeper-server/src/main/java/org/apache/bookkeeper/proto/BookieProtoEncoding.java,194,203,101.5,203,9,4.5,9,212,106.0,212,194,97.0,194,2,0,2,NO
4,bookkeeper-server/src/main/java/org/apache/bookkeeper/proto/BookieProtocol.java,346,187,93.5,187,17,8.5,17,204,102.0,204,170,85.0,170,2,0,2,NO
4,bookkeeper-server/src/main/java/org/apache/bookkeeper/proto/BookieRequestHandler.java,304,306,153.0,306,2,1.0,2,308,154.0,308,304,152.0,304,2,0,2,NO
4,bookkeeper-server/src/main/java/org/apache/bookkeeper/proto/BookieServer.java,356,15,7.5,15,283,141.5,283,298,149.0,298,278,139.0,278,2,1,2,YES
4,bookkeeper-server/src/main/java/org/apache/bookkeeper/proto/BookieServerBean.java,84,2,1.0,2,9,4.5,9,11,5.5,11,7,3.5,7,2,1,2,NO
4,bookkeeper-server/src/main/java/org/apache/bookkeeper/proto/BookieServerMXBean.java,53,0,0.0,0,5,5.0,5,5,5.0,5,5,5.0,5,1,1,1,NO
4,bookkeeper-server/src/main/java/org/apache/bookkeeper/proto/BookkeeperInternalCallbacks.java,132,0,0.0,0,0,0.0,0,0,0.0,0,0,0.0,0,0,0,0,NO
4,bookkeeper-server/src/main/java/org/apache/bookkeeper/proto/DataFormats.java,4088,0,0.0,0,0,0.0,0,0,0.0,0,0,0.0,0,0,0,0,NO
4,bookkeeper-server/src/main/java/org/apache/bookkeeper/proto/PerChannelBookieClient.java,691,80,26.666666,80,116,38.666668,116,196,65.333336,196,36,12.0,36,3,2,2,YES
4,bookkeeper-server/src/main/java/org/apache/bookkeeper/proto/ResponseBuilder.java,47,52,26.0,52,5,2.5,5,57,28.5,57,47,23.5,47,2,0,2,NO
4,bookkeeper-server/src/main/java/org/apache/bookkeeper/proto/ServerStats.java,101,0,0.0,0,49,49.0,49,49,49.0,49,49,49.0,49,1,1,1,NO
4,bookkeeper-server/src/main/java/org/apache/bookkeeper/replication/Auditor.java,510,8,4.0,8,1,0.5,1,9,4.5,9,7,3.5,7,2,2,1,YES
4,bookkeeper-server/src/main/java/org/apache/bookkeeper/replication/AuditorElector.java,328,3,3.0,3,0,0.0,0,3,3.0,3,3,3.0,3,1,1,1,YES
4,bookkeeper-server/src/main/java/org/apache/bookkeeper/replication/AutoRecoveryMain.java,273,0,0.0,0,0,0.0,0,0,0.0,0,0,0.0,0,0,0,0,YES
4,bookkeeper-server/src/main/java/org/apache/bookkeeper/replication/BookieLedgerIndexer.java,136,0,0.0,0,0,0.0,0,0,0.0,0,0,0.0,0,0,0,0,NO
4,bookkeeper-server/src/main/java/org/apache/bookkeeper/replication/ReplicationEnableCb.java,56,0,0.0,0,0,0.0,0,0,0.0,0,0,0.0,0,0,0,0,NO
4,bookkeeper-server/src/main/java/org/apache/bookkeeper/replication/ReplicationException.java,74,0,0.0,0,0,0.0,0,0,0.0,0,0,0.0,0,0,0,0,NO
4,bookkeeper-server/src/main/java/org/apache/bookkeeper/replication/ReplicationWorker.java,359,2,2.0,2,0,0.0,0,2,2.0,2,2,2.0,2,1,1,1,YES
4,bookkeeper-server/src/main/java/org/apache/bookkeeper/streaming/LedgerInputStream.java,174,0,0.0,0,0,0.0,0,0,0.0,0,0,0.0,0,0,0,0,NO
4,bookkeeper-server/src/main/java/org/apache/bookkeeper/streaming/LedgerOutputStream.java,148,0,0.0,0,0,0.0,0,0,0.0,0,0,0.0,0,0,0,0,NO
4,bookkeeper-server/src/main/java/org/apache/bookkeeper/tools/BookKeeperTools.java,92,0,0.0,0,0,0.0,0,0,0.0,0,0,0.0,0,0,0,0,NO
4,bookkeeper-server/src/main/java/org/apache/bookkeeper/util/BookKeeperConstants.java,45,0,0.0,0,0,0.0,0,0,0.0,0,0,0.0,0,0,0,0,NO
4,bookkeeper-server/src/main/java/org/apache/bookkeeper/util/DiskChecker.java,168,0,0.0,0,0,0.0,0,0,0.0,0,0,0.0,0,0,0,0,NO
4,bookkeeper-server/src/main/java/org/apache/bookkeeper/util/EntryFormatter.java,77,0,0.0,0,0,0.0,0,0,0.0,0,0,0.0,0,0,0,0,NO
4,bookkeeper-server/src/main/java/org/apache/bookkeeper/util/HardLink.java,666,9,9.0,9,7,7.0,7,16,16.0,16,2,2.0,2,1,1,1,NO
4,bookkeeper-server/src/main/java/org/apache/bookkeeper/util/IOUtils.java,88,0,0.0,0,0,0.0,0,0,0.0,0,0,0.0,0,0,0,0,NO
4,bookkeeper-server/src/main/java/org/apache/bookkeeper/util/LocalBookKeeper.java,262,4,4.0,4,2,2.0,2,6,6.0,6,2,2.0,2,1,1,1,NO
4,bookkeeper-server/src/main/java/org/apache/bookkeeper/util/Main.java,54,0,0.0,0,0,0.0,0,0,0.0,0,0,0.0,0,0,0,0,NO
4,bookkeeper-server/src/main/java/org/apache/bookkeeper/util/MathUtils.java,48,0,0.0,0,0,0.0,0,0,0.0,0,0,0.0,0,0,0,0,YES
4,bookkeeper-server/src/main/java/org/apache/bookkeeper/util/OrderedSafeExecutor.java,140,0,0.0,0,0,0.0,0,0,0.0,0,0,0.0,0,0,0,0,YES
4,bookkeeper-server/src/main/java/org/apache/bookkeeper/util/ReflectionUtils.java,152,0,0.0,0,0,0.0,0,0,0.0,0,0,0.0,0,0,0,0,NO
4,bookkeeper-server/src/main/java/org/apache/bookkeeper/util/SafeRunnable.java,39,0,0.0,0,0,0.0,0,0,0.0,0,0,0.0,0,0,0,0,NO
4,bookkeeper-server/src/main/java/org/apache/bookkeeper/util/SnapshotMap.java,131,0,0.0,0,0,0.0,0,0,0.0,0,0,0.0,0,0,0,0,NO
4,bookkeeper-server/src/main/java/org/apache/bookkeeper/util/StringEntryFormatter.java,47,0,0.0,0,0,0.0,0,0,0.0,0,0,0.0,0,0,0,0,NO
4,bookkeeper-server/src/main/java/org/apache/bookkeeper/util/StringUtils.java,129,0,0.0,0,0,0.0,0,0,0.0,0,0,0.0,0,0,0,0,NO
4,bookkeeper-server/src/main/java/org/apache/bookkeeper/util/Tool.java,43,0,0.0,0,0,0.0,0,0,0.0,0,0,0.0,0,0,0,0,NO
4,bookkeeper-server/src/main/java/org/apache/bookkeeper/util/ZkUtils.java,243,0,0.0,0,0,0.0,0,0,0.0,0,0,0.0,0,0,0,0,YES
4,bookkeeper-server/src/main/java/org/apache/bookkeeper/versioning/Version.java,62,0,0.0,0,0,0.0,0,0,0.0,0,0,0.0,0,0,0,0,NO
4,bookkeeper-server/src/main/java/org/apache/bookkeeper/versioning/Versioned.java,45,0,0.0,0,0,0.0,0,0,0.0,0,0,0.0,0,0,0,0,NO
4,bookkeeper-server/src/main/java/org/apache/bookkeeper/zookeeper/ZooKeeperWatcherBase.java,97,3,3.0,3,0,0.0,0,3,3.0,3,3,3.0,3,1,1,1,NO
4,hedwig-client-jms/src/main/java/org/apache/hedwig/jms/ConnectionImpl.java,476,476,476.0,476,0,0.0,0,476,476.0,476,476,476.0,476,1,0,1,NO
4,hedwig-client-jms/src/main/java/org/apache/hedwig/jms/ConnectionMetaDataImpl.java,77,77,77.0,77,0,0.0,0,77,77.0,77,77,77.0,77,1,0,1,NO
4,hedwig-client-jms/src/main/java/org/apache/hedwig/jms/DebugUtil.java,69,69,69.0,69,0,0.0,0,69,69.0,69,69,69.0,69,1,0,1,NO
4,hedwig-client-jms/src/main/java/org/apache/hedwig/jms/LRUCacheMap.java,104,104,104.0,104,0,0.0,0,104,104.0,104,104,104.0,104,1,0,1,NO
4,hedwig-client-jms/src/main/java/org/apache/hedwig/jms/LRUCacheSet.java,115,115,115.0,115,0,0.0,0,115,115.0,115,115,115.0,115,1,0,1,NO
4,hedwig-client-jms/src/main/java/org/apache/hedwig/jms/MessagingSessionFacade.java,421,421,421.0,421,0,0.0,0,421,421.0,421,421,421.0,421,1,0,1,NO
4,hedwig-client-jms/src/main/java/org/apache/hedwig/jms/Mutable.java,61,61,61.0,61,0,0.0,0,61,61.0,61,61,61.0,61,1,0,1,NO
4,hedwig-client-jms/src/main/java/org/apache/hedwig/jms/SessionImpl.java,2009,2021,1010.5,2021,12,6.0,12,2033,1016.5,2033,2009,1004.5,2009,2,1,2,NO
4,hedwig-client-jms/src/main/java/org/apache/hedwig/jms/StateManager.java,179,179,179.0,179,0,0.0,0,179,179.0,179,179,179.0,179,1,0,1,NO
4,hedwig-client-jms/src/main/java/org/apache/hedwig/jms/jndi/HedwigInitialContext.java,106,106,106.0,106,0,0.0,0,106,106.0,106,106,106.0,106,1,0,1,NO
4,hedwig-client-jms/src/main/java/org/apache/hedwig/jms/jndi/HedwigInitialContextFactory.java,33,33,33.0,33,0,0.0,0,33,33.0,33,33,33.0,33,1,0,1,NO
4,hedwig-client-jms/src/main/java/org/apache/hedwig/jms/message/BytesMessageImpl.java,657,657,657.0,657,0,0.0,0,657,657.0,657,657,657.0,657,1,0,1,NO
4,hedwig-client-jms/src/main/java/org/apache/hedwig/jms/message/MapMessageImpl.java,295,295,295.0,295,0,0.0,0,295,295.0,295,295,295.0,295,1,0,1,NO
4,hedwig-client-jms/src/main/java/org/apache/hedwig/jms/message/MessageImpl.java,872,872,872.0,872,0,0.0,0,872,872.0,872,872,872.0,872,1,0,1,NO
4,hedwig-client-jms/src/main/java/org/apache/hedwig/jms/message/MessageUtil.java,444,444,444.0,444,0,0.0,0,444,444.0,444,444,444.0,444,1,0,1,NO
4,hedwig-client-jms/src/main/java/org/apache/hedwig/jms/message/ObjectMessageImpl.java,168,168,168.0,168,0,0.0,0,168,168.0,168,168,168.0,168,1,0,1,NO
4,hedwig-client-jms/src/main/java/org/apache/hedwig/jms/message/StreamMessageImpl.java,752,752,752.0,752,0,0.0,0,752,752.0,752,752,752.0,752,1,0,1,NO
4,hedwig-client-jms/src/main/java/org/apache/hedwig/jms/message/TextMessageImpl.java,135,135,135.0,135,0,0.0,0,135,135.0,135,135,135.0,135,1,0,1,NO
4,hedwig-client-jms/src/main/java/org/apache/hedwig/jms/message/header/JmsHeader.java,1126,1126,1126.0,1126,0,0.0,0,1126,1126.0,1126,1126,1126.0,1126,1,0,1,NO
4,hedwig-client-jms/src/main/java/org/apache/hedwig/jms/message/header/MetadataProcessor.java,163,163,163.0,163,0,0.0,0,163,163.0,163,163,163.0,163,1,0,1,NO
4,hedwig-client-jms/src/main/java/org/apache/hedwig/jms/selector/BinaryArithmeticFunction.java,184,184,184.0,184,0,0.0,0,184,184.0,184,184,184.0,184,1,0,1,NO
4,hedwig-client-jms/src/main/java/org/apache/hedwig/jms/selector/BinaryExprFunction.java,51,51,51.0,51,0,0.0,0,51,51.0,51,51,51.0,51,1,0,1,NO
4,hedwig-client-jms/src/main/java/org/apache/hedwig/jms/selector/ExprFunction.java,25,25,25.0,25,0,0.0,0,25,25.0,25,25,25.0,25,1,0,1,NO
4,hedwig-client-jms/src/main/java/org/apache/hedwig/jms/selector/InterpretSelectorParserVisitor.java,180,180,180.0,180,0,0.0,0,180,180.0,180,180,180.0,180,1,0,1,NO
4,hedwig-client-jms/src/main/java/org/apache/hedwig/jms/selector/LogicalComparisonFunction.java,64,64,64.0,64,0,0.0,0,64,64.0,64,64,64.0,64,1,0,1,NO
4,hedwig-client-jms/src/main/java/org/apache/hedwig/jms/selector/MyNode.java,101,101,101.0,101,0,0.0,0,101,101.0,101,101,101.0,101,1,0,1,NO
4,hedwig-client-jms/src/main/java/org/apache/hedwig/jms/selector/PropertyExprFunction.java,512,512,512.0,512,0,0.0,0,512,512.0,512,512,512.0,512,1,0,1,NO
4,hedwig-client-jms/src/main/java/org/apache/hedwig/jms/selector/SelectorConstant.java,187,187,187.0,187,0,0.0,0,187,187.0,187,187,187.0,187,1,0,1,NO
4,hedwig-client-jms/src/main/java/org/apache/hedwig/jms/selector/SelectorEvalState.java,56,56,56.0,56,0,0.0,0,56,56.0,56,56,56.0,56,1,0,1,NO
4,hedwig-client-jms/src/main/java/org/apache/hedwig/jms/selector/SelectorEvaluationException.java,39,39,39.0,39,0,0.0,0,39,39.0,39,39,39.0,39,1,0,1,NO
4,hedwig-client-jms/src/main/java/org/apache/hedwig/jms/selector/TreeDumperSelectorParserVisitor.java,261,261,261.0,261,0,0.0,0,261,261.0,261,261,261.0,261,1,0,1,NO
4,hedwig-client-jms/src/main/java/org/apache/hedwig/jms/selector/UnaryArithmeticFunction.java,73,73,73.0,73,0,0.0,0,73,73.0,73,73,73.0,73,1,0,1,NO
4,hedwig-client-jms/src/main/java/org/apache/hedwig/jms/selector/UnaryExprFunction.java,65,65,65.0,65,0,0.0,0,65,65.0,65,65,65.0,65,1,0,1,NO
4,hedwig-client-jms/src/main/java/org/apache/hedwig/jms/selector/ValueComparisonFunction.java,329,329,329.0,329,0,0.0,0,329,329.0,329,329,329.0,329,1,0,1,NO
4,hedwig-client-jms/src/main/java/org/apache/hedwig/jms/spi/HedwigConnectionFactoryImpl.java,64,64,64.0,64,0,0.0,0,64,64.0,64,64,64.0,64,1,0,1,NO
4,hedwig-client-jms/src/main/java/org/apache/hedwig/jms/spi/HedwigConnectionImpl.java,164,164,164.0,164,0,0.0,0,164,164.0,164,164,164.0,164,1,0,1,NO
4,hedwig-client-jms/src/main/java/org/apache/hedwig/jms/spi/HedwigMessagingSessionFacade.java,624,626,313.0,626,2,1.0,2,628,314.0,628,624,312.0,624,2,1,2,NO
4,hedwig-client-jms/src/main/java/org/apache/hedwig/jms/spi/MessageConsumerImpl.java,74,74,74.0,74,0,0.0,0,74,74.0,74,74,74.0,74,1,0,1,NO
4,hedwig-client-jms/src/main/java/org/apache/hedwig/jms/spi/MessageProducerImpl.java,117,117,117.0,117,0,0.0,0,117,117.0,117,117,117.0,117,1,0,1,NO
4,hedwig-client-jms/src/main/java/org/apache/hedwig/jms/spi/QueueSessionImpl.java,84,84,84.0,84,0,0.0,0,84,84.0,84,84,84.0,84,1,0,1,NO
4,hedwig-client-jms/src/main/java/org/apache/hedwig/jms/spi/TopicPublisherImpl.java,226,227,113.5,227,1,0.5,1,228,114.0,228,226,113.0,226,2,1,2,NO
4,hedwig-client-jms/src/main/java/org/apache/hedwig/jms/spi/TopicSessionImpl.java,76,76,76.0,76,0,0.0,0,76,76.0,76,76,76.0,76,1,0,1,NO
4,hedwig-client-jms/src/main/java/org/apache/hedwig/jms/spi/TopicSubscriberImpl.java,323,323,323.0,323,0,0.0,0,323,323.0,323,323,323.0,323,1,0,1,NO
4,hedwig-client/src/main/java/org/apache/hedwig/client/HedwigClient.java,72,0,0.0,0,0,0.0,0,0,0.0,0,0,0.0,0,0,0,0,NO
4,hedwig-client/src/main/java/org/apache/hedwig/client/api/Client.java,42,0,0.0,0,0,0.0,0,0,0.0,0,0,0.0,0,0,0,0,NO
4,hedwig-client/src/main/java/org/apache/hedwig/client/api/MessageHandler.java,48,0,0.0,0,0,0.0,0,0,0.0,0,0,0.0,0,0,0,0,NO
4,hedwig-client/src/main/java/org/apache/hedwig/client/api/Publisher.java,89,0,0.0,0,0,0.0,0,0,0.0,0,0,0.0,0,0,0,0,NO
4,hedwig-client/src/main/java/org/apache/hedwig/client/api/Subscriber.java,380,0,0.0,0,0,0.0,0,0,0.0,0,0,0.0,0,0,0,0,NO
4,hedwig-client/src/main/java/org/apache/hedwig/client/benchmark/BenchmarkPublisher.java,141,4,4.0,4,1,1.0,1,5,5.0,5,3,3.0,3,1,1,1,NO
4,hedwig-client/src/main/java/org/apache/hedwig/client/benchmark/BenchmarkSubscriber.java,148,8,8.0,8,2,2.0,2,10,10.0,10,6,6.0,6,1,1,1,NO
4,hedwig-client/src/main/java/org/apache/hedwig/client/benchmark/BenchmarkUtils.java,191,0,0.0,0,0,0.0,0,0,0.0,0,0,0.0,0,0,0,0,NO
4,hedwig-client/src/main/java/org/apache/hedwig/client/benchmark/BenchmarkWorker.java,46,0,0.0,0,0,0.0,0,0,0.0,0,0,0.0,0,0,0,0,NO
4,hedwig-client/src/main/java/org/apache/hedwig/client/benchmark/HedwigBenchmark.java,165,0,0.0,0,0,0.0,0,0,0.0,0,0,0.0,0,0,0,0,NO
4,hedwig-client/src/main/java/org/apache/hedwig/client/conf/ClientConfiguration.java,171,0,0.0,0,0,0.0,0,0,0.0,0,0,0.0,0,0,0,0,NO
4,hedwig-client/src/main/java/org/apache/hedwig/client/data/MessageConsumeData.java,56,0,0.0,0,0,0.0,0,0,0.0,0,0,0.0,0,0,0,0,NO
4,hedwig-client/src/main/java/org/apache/hedwig/client/data/PubSubData.java,179,0,0.0,0,0,0.0,0,0,0.0,0,0,0.0,0,0,0,0,NO
4,hedwig-client/src/main/java/org/apache/hedwig/client/data/TopicSubscriber.java,74,0,0.0,0,0,0.0,0,0,0.0,0,0,0.0,0,0,0,0,NO
4,hedwig-client/src/main/java/org/apache/hedwig/client/exceptions/AlreadyStartDeliveryException.java,36,0,0.0,0,0,0.0,0,0,0.0,0,0,0.0,0,0,0,0,NO
4,hedwig-client/src/main/java/org/apache/hedwig/client/exceptions/InvalidSubscriberIdException.java,37,0,0.0,0,0,0.0,0,0,0.0,0,0,0.0,0,0,0,0,NO
4,hedwig-client/src/main/java/org/apache/hedwig/client/exceptions/NoResponseHandlerException.java,34,0,0.0,0,0,0.0,0,0,0.0,0,0,0.0,0,0,0,0,NO
4,hedwig-client/src/main/java/org/apache/hedwig/client/exceptions/ResubscribeException.java,34,0,0.0,0,0,0.0,0,0,0.0,0,0,0.0,0,0,0,0,NO
4,hedwig-client/src/main/java/org/apache/hedwig/client/exceptions/ServerRedirectLoopException.java,38,0,0.0,0,0,0.0,0,0,0.0,0,0,0.0,0,0,0,0,NO
4,hedwig-client/src/main/java/org/apache/hedwig/client/exceptions/TooManyServerRedirectsException.java,39,0,0.0,0,0,0.0,0,0,0.0,0,0,0.0,0,0,0,0,NO
4,hedwig-client/src/main/java/org/apache/hedwig/client/handlers/AbstractResponseHandler.java,156,0,0.0,0,0,0.0,0,0,0.0,0,0,0.0,0,0,0,0,NO
4,hedwig-client/src/main/java/org/apache/hedwig/client/handlers/CloseSubscriptionResponseHandler.java,84,0,0.0,0,0,0.0,0,0,0.0,0,0,0.0,0,0,0,0,NO
4,hedwig-client/src/main/java/org/apache/hedwig/client/handlers/MessageConsumeCallback.java,117,0,0.0,0,0,0.0,0,0,0.0,0,0,0.0,0,0,0,0,NO
4,hedwig-client/src/main/java/org/apache/hedwig/client/handlers/PubSubCallback.java,94,0,0.0,0,0,0.0,0,0,0.0,0,0,0.0,0,0,0,0,NO
4,hedwig-client/src/main/java/org/apache/hedwig/client/handlers/PublishResponseHandler.java,71,0,0.0,0,0,0.0,0,0,0.0,0,0,0.0,0,0,0,0,NO
4,hedwig-client/src/main/java/org/apache/hedwig/client/handlers/SubscribeResponseHandler.java,183,0,0.0,0,0,0.0,0,0,0.0,0,0,0.0,0,0,0,0,NO
4,hedwig-client/src/main/java/org/apache/hedwig/client/handlers/UnsubscribeResponseHandler.java,85,0,0.0,0,0,0.0,0,0,0.0,0,0,0.0,0,0,0,0,NO
4,hedwig-client/src/main/java/org/apache/hedwig/client/netty/CleanupChannelMap.java,183,0,0.0,0,0,0.0,0,0,0.0,0,0,0.0,0,0,0,0,NO
4,hedwig-client/src/main/java/org/apache/hedwig/client/netty/FilterableMessageHandler.java,70,0,0.0,0,0,0.0,0,0,0.0,0,0,0.0,0,0,0,0,NO
4,hedwig-client/src/main/java/org/apache/hedwig/client/netty/HChannel.java,54,0,0.0,0,0,0.0,0,0,0.0,0,0,0.0,0,0,0,0,NO
4,hedwig-client/src/main/java/org/apache/hedwig/client/netty/HChannelManager.java,160,0,0.0,0,0,0.0,0,0,0.0,0,0,0.0,0,0,0,0,NO
4,hedwig-client/src/main/java/org/apache/hedwig/client/netty/HedwigClientImpl.java,125,0,0.0,0,0,0.0,0,0,0.0,0,0,0.0,0,0,0,0,NO
4,hedwig-client/src/main/java/org/apache/hedwig/client/netty/HedwigPublisher.java,151,0,0.0,0,0,0.0,0,0,0.0,0,0,0.0,0,0,0,0,NO
4,hedwig-client/src/main/java/org/apache/hedwig/client/netty/HedwigSubscriber.java,422,1,1.0,1,0,0.0,0,1,1.0,1,1,1.0,1,1,1,1,NO
4,hedwig-client/src/main/java/org/apache/hedwig/client/netty/NetUtils.java,221,2,2.0,2,0,0.0,0,2,2.0,2,2,2.0,2,1,1,1,NO
4,hedwig-client/src/main/java/org/apache/hedwig/client/netty/SubscriptionEventEmitter.java,50,0,0.0,0,0,0.0,0,0,0.0,0,0,0.0,0,0,0,0,NO
4,hedwig-client/src/main/java/org/apache/hedwig/client/netty/VoidCallbackAdapter.java,42,0,0.0,0,0,0.0,0,0,0.0,0,0,0.0,0,0,0,0,NO
4,hedwig-client/src/main/java/org/apache/hedwig/client/netty/impl/AbstractHChannelManager.java,624,0,0.0,0,0,0.0,0,0,0.0,0,0,0.0,0,0,0,0,NO
4,hedwig-client/src/main/java/org/apache/hedwig/client/netty/impl/AbstractSubscribeResponseHandler.java,377,0,0.0,0,0,0.0,0,0,0.0,0,0,0.0,0,0,0,0,NO
4,hedwig-client/src/main/java/org/apache/hedwig/client/netty/impl/ActiveSubscriber.java,383,0,0.0,0,0,0.0,0,0,0.0,0,0,0.0,0,0,0,0,NO
4,hedwig-client/src/main/java/org/apache/hedwig/client/netty/impl/ClientChannelPipelineFactory.java,72,0,0.0,0,0,0.0,0,0,0.0,0,0,0.0,0,0,0,0,NO
4,hedwig-client/src/main/java/org/apache/hedwig/client/netty/impl/DefaultServerChannel.java,92,0,0.0,0,0,0.0,0,0,0.0,0,0,0.0,0,0,0,0,NO
4,hedwig-client/src/main/java/org/apache/hedwig/client/netty/impl/HChannelHandler.java,282,1,1.0,1,3,3.0,3,4,4.0,4,2,2.0,2,1,1,1,NO
4,hedwig-client/src/main/java/org/apache/hedwig/client/netty/impl/HChannelImpl.java,371,0,0.0,0,0,0.0,0,0,0.0,0,0,0.0,0,0,0,0,NO
4,hedwig-client/src/main/java/org/apache/hedwig/client/netty/impl/NonSubscriptionChannelPipelineFactory.java,47,0,0.0,0,0,0.0,0,0,0.0,0,0,0.0,0,0,0,0,NO
4,hedwig-client/src/main/java/org/apache/hedwig/client/netty/impl/ResubscribeCallback.java,108,0,0.0,0,0,0.0,0,0,0.0,0,0,0.0,0,0,0,0,NO
4,hedwig-client/src/main/java/org/apache/hedwig/client/netty/impl/WriteCallback.java,111,0,0.0,0,0,0.0,0,0,0.0,0,0,0.0,0,0,0,0,NO
4,hedwig-client/src/main/java/org/apache/hedwig/client/netty/impl/multiplex/MultiplexHChannelManager.java,319,0,0.0,0,0,0.0,0,0,0.0,0,0,0.0,0,0,0,0,NO
4,hedwig-client/src/main/java/org/apache/hedwig/client/netty/impl/multiplex/MultiplexSubscribeResponseHandler.java,129,0,0.0,0,0,0.0,0,0,0.0,0,0,0.0,0,0,0,0,NO
4,hedwig-client/src/main/java/org/apache/hedwig/client/netty/impl/multiplex/MultiplexSubscriptionChannelPipelineFactory.java,49,0,0.0,0,0,0.0,0,0,0.0,0,0,0.0,0,0,0,0,NO
4,hedwig-client/src/main/java/org/apache/hedwig/client/netty/impl/simple/SimpleHChannelManager.java,358,0,0.0,0,0,0.0,0,0,0.0,0,0,0.0,0,0,0,0,NO
4,hedwig-client/src/main/java/org/apache/hedwig/client/netty/impl/simple/SimpleSubscribeResponseHandler.java,277,0,0.0,0,0,0.0,0,0,0.0,0,0,0.0,0,0,0,0,NO
4,hedwig-client/src/main/java/org/apache/hedwig/client/netty/impl/simple/SimpleSubscriptionChannelPipelineFactory.java,49,0,0.0,0,0,0.0,0,0,0.0,0,0,0.0,0,0,0,0,NO
4,hedwig-client/src/main/java/org/apache/hedwig/client/netty/package-info.java,89,0,0.0,0,0,0.0,0,0,0.0,0,0,0.0,0,0,0,0,NO
4,hedwig-client/src/main/java/org/apache/hedwig/client/ssl/SslClientContextFactory.java,41,0,0.0,0,0,0.0,0,0,0.0,0,0,0.0,0,0,0,0,NO
4,hedwig-client/src/main/java/org/apache/hedwig/client/ssl/SslContextFactory.java,66,0,0.0,0,0,0.0,0,0,0.0,0,0,0.0,0,0,0,0,NO
4,hedwig-client/src/main/java/org/apache/hedwig/conf/AbstractConfiguration.java,63,0,0.0,0,0,0.0,0,0,0.0,0,0,0.0,0,0,0,0,NO
4,hedwig-client/src/main/java/org/apache/hedwig/filter/ClientMessageFilter.java,24,0,0.0,0,0,0.0,0,0,0.0,0,0,0.0,0,0,0,0,NO
4,hedwig-client/src/main/java/org/apache/hedwig/filter/MessageFilterBase.java,50,0,0.0,0,0,0.0,0,0,0.0,0,0,0.0,0,0,0,0,NO
4,hedwig-client/src/main/java/org/apache/hedwig/filter/PipelineFilter.java,72,0,0.0,0,0,0.0,0,0,0.0,0,0,0.0,0,0,0,0,NO
4,hedwig-client/src/main/java/org/apache/hedwig/filter/ServerMessageFilter.java,47,0,0.0,0,0,0.0,0,0,0.0,0,0,0.0,0,0,0,0,NO
4,hedwig-client/src/main/java/org/apache/hedwig/util/Callback.java,47,0,0.0,0,0,0.0,0,0,0.0,0,0,0.0,0,0,0,0,NO
4,hedwig-client/src/main/java/org/apache/hedwig/util/CallbackUtils.java,183,0,0.0,0,0,0.0,0,0,0.0,0,0,0.0,0,0,0,0,NO
4,hedwig-client/src/main/java/org/apache/hedwig/util/ConcurrencyUtils.java,49,0,0.0,0,0,0.0,0,0,0.0,0,0,0.0,0,0,0,0,NO
4,hedwig-client/src/main/java/org/apache/hedwig/util/Either.java,50,0,0.0,0,0,0.0,0,0,0.0,0,0,0.0,0,0,0,0,NO
4,hedwig-client/src/main/java/org/apache/hedwig/util/FileUtils.java,98,0,0.0,0,0,0.0,0,0,0.0,0,0,0.0,0,0,0,0,NO
4,hedwig-client/src/main/java/org/apache/hedwig/util/HedwigSocketAddress.java,143,0,0.0,0,0,0.0,0,0,0.0,0,0,0.0,0,0,0,0,NO
4,hedwig-client/src/main/java/org/apache/hedwig/util/Option.java,43,0,0.0,0,0,0.0,0,0,0.0,0,0,0.0,0,0,0,0,NO
4,hedwig-client/src/main/java/org/apache/hedwig/util/Pair.java,42,0,0.0,0,0,0.0,0,0,0.0,0,0,0.0,0,0,0,0,NO
4,hedwig-client/src/main/java/org/apache/hedwig/util/PathUtils.java,56,0,0.0,0,0,0.0,0,0,0.0,0,0,0.0,0,0,0,0,NO
4,hedwig-client/src/main/java/org/apache/hedwig/util/SubscriptionListener.java,44,0,0.0,0,0,0.0,0,0,0.0,0,0,0.0,0,0,0,0,NO
4,hedwig-client/src/main/java/org/apache/hedwig/util/VarArgs.java,26,0,0.0,0,0,0.0,0,0,0.0,0,0,0.0,0,0,0,0,NO
4,hedwig-protocol/src/main/java/org/apache/hedwig/exceptions/PubSubException.java,254,0,0.0,0,0,0.0,0,0,0.0,0,0,0.0,0,0,0,0,NO
4,hedwig-protocol/src/main/java/org/apache/hedwig/protocol/PubSubProtocol.java,16883,0,0.0,0,0,0.0,0,0,0.0,0,0,0.0,0,0,0,0,NO
4,hedwig-protocol/src/main/java/org/apache/hedwig/protoextensions/MapUtils.java,74,0,0.0,0,0,0.0,0,0,0.0,0,0,0.0,0,0,0,0,NO
4,hedwig-protocol/src/main/java/org/apache/hedwig/protoextensions/MessageIdUtils.java,153,0,0.0,0,0,0.0,0,0,0.0,0,0,0.0,0,0,0,0,NO
4,hedwig-protocol/src/main/java/org/apache/hedwig/protoextensions/PubSubResponseUtils.java,68,0,0.0,0,0,0.0,0,0,0.0,0,0,0.0,0,0,0,0,NO
4,hedwig-protocol/src/main/java/org/apache/hedwig/protoextensions/SubscriptionStateUtils.java,100,0,0.0,0,0,0.0,0,0,0.0,0,0,0.0,0,0,0,0,NO
4,hedwig-server/src/main/java/org/apache/hedwig/admin/HedwigAdmin.java,550,3,3.0,3,2,2.0,2,5,5.0,5,1,1.0,1,1,1,1,NO
4,hedwig-server/src/main/java/org/apache/hedwig/admin/console/HedwigCommands.java,437,0,0.0,0,0,0.0,0,0,0.0,0,0,0.0,0,0,0,0,NO
4,hedwig-server/src/main/java/org/apache/hedwig/admin/console/HedwigConsole.java,1038,8,4.0,8,3,1.5,3,11,5.5,11,5,2.5,5,2,2,2,NO
4,hedwig-server/src/main/java/org/apache/hedwig/admin/console/JLineHedwigCompletor.java,104,9,9.0,9,6,6.0,6,15,15.0,15,3,3.0,3,1,1,1,NO
4,hedwig-server/src/main/java/org/apache/hedwig/admin/console/ReadTopic.java,332,2,2.0,2,1,1.0,1,3,3.0,3,1,1.0,1,1,1,1,NO
4,hedwig-server/src/main/java/org/apache/hedwig/data/MessageFormatter.java,123,0,0.0,0,0,0.0,0,0,0.0,0,0,0.0,0,0,0,0,NO
4,hedwig-server/src/main/java/org/apache/hedwig/server/benchmark/AbstractBenchmark.java,106,0,0.0,0,0,0.0,0,0,0.0,0,0,0.0,0,0,0,0,NO
4,hedwig-server/src/main/java/org/apache/hedwig/server/benchmark/BookieBenchmark.java,106,0,0.0,0,0,0.0,0,0,0.0,0,0,0.0,0,0,0,0,NO
4,hedwig-server/src/main/java/org/apache/hedwig/server/benchmark/BookkeeperBenchmark.java,94,2,2.0,2,1,1.0,1,3,3.0,3,1,1.0,1,1,1,1,NO
4,hedwig-server/src/main/java/org/apache/hedwig/server/benchmark/FakeBookie.java,101,2,2.0,2,2,2.0,2,4,4.0,4,0,0.0,0,1,1,1,NO
4,hedwig-server/src/main/java/org/apache/hedwig/server/common/ByteStringInterner.java,38,0,0.0,0,0,0.0,0,0,0.0,0,0,0.0,0,0,0,0,NO
4,hedwig-server/src/main/java/org/apache/hedwig/server/common/ServerConfiguration.java,628,45,15.0,45,1,0.33333334,1,46,15.333333,46,44,14.666667,44,3,1,2,YES
4,hedwig-server/src/main/java/org/apache/hedwig/server/common/TerminateJVMExceptionHandler.java,32,0,0.0,0,0,0.0,0,0,0.0,0,0,0.0,0,0,0,0,NO
4,hedwig-server/src/main/java/org/apache/hedwig/server/common/TopicOpQueuer.java,111,0,0.0,0,0,0.0,0,0,0.0,0,0,0.0,0,0,0,0,NO
4,hedwig-server/src/main/java/org/apache/hedwig/server/common/UnexpectedError.java,35,0,0.0,0,0,0.0,0,0,0.0,0,0,0.0,0,0,0,0,NO
4,hedwig-server/src/main/java/org/apache/hedwig/server/delivery/ChannelEndPoint.java,90,0,0.0,0,0,0.0,0,0,0.0,0,0,0.0,0,0,0,0,NO
4,hedwig-server/src/main/java/org/apache/hedwig/server/delivery/DeliveryCallback.java,27,0,0.0,0,0,0.0,0,0,0.0,0,0,0.0,0,0,0,0,NO
4,hedwig-server/src/main/java/org/apache/hedwig/server/delivery/DeliveryEndPoint.java,28,0,0.0,0,0,0.0,0,0,0.0,0,0,0.0,0,0,0,0,NO
4,hedwig-server/src/main/java/org/apache/hedwig/server/delivery/DeliveryManager.java,92,0,0.0,0,0,0.0,0,0,0.0,0,0,0.0,0,0,0,0,NO
4,hedwig-server/src/main/java/org/apache/hedwig/server/delivery/FIFODeliveryManager.java,956,211,70.333336,211,140,46.666668,140,351,117.0,351,73,24.333334,73,3,1,1,YES
4,hedwig-server/src/main/java/org/apache/hedwig/server/handlers/BaseHandler.java,67,0,0.0,0,0,0.0,0,0,0.0,0,0,0.0,0,0,0,0,NO
4,hedwig-server/src/main/java/org/apache/hedwig/server/handlers/ChannelDisconnectListener.java,29,0,0.0,0,0,0.0,0,0,0.0,0,0,0.0,0,0,0,0,NO
4,hedwig-server/src/main/java/org/apache/hedwig/server/handlers/CloseSubscriptionHandler.java,105,0,0.0,0,0,0.0,0,0,0.0,0,0,0.0,0,0,0,0,NO
4,hedwig-server/src/main/java/org/apache/hedwig/server/handlers/ConsumeHandler.java,72,0,0.0,0,0,0.0,0,0,0.0,0,0,0.0,0,0,0,0,NO
4,hedwig-server/src/main/java/org/apache/hedwig/server/handlers/Handler.java,37,0,0.0,0,0,0.0,0,0,0.0,0,0,0.0,0,0,0,0,NO
4,hedwig-server/src/main/java/org/apache/hedwig/server/handlers/NettyHandlerBean.java,47,0,0.0,0,0,0.0,0,0,0.0,0,0,0.0,0,0,0,0,NO
4,hedwig-server/src/main/java/org/apache/hedwig/server/handlers/NettyHandlerMXBean.java,31,0,0.0,0,0,0.0,0,0,0.0,0,0,0.0,0,0,0,0,NO
4,hedwig-server/src/main/java/org/apache/hedwig/server/handlers/PublishHandler.java,90,0,0.0,0,0,0.0,0,0,0.0,0,0,0.0,0,0,0,0,NO
4,hedwig-server/src/main/java/org/apache/hedwig/server/handlers/SubscribeHandler.java,223,0,0.0,0,0,0.0,0,0,0.0,0,0,0.0,0,0,0,0,NO
4,hedwig-server/src/main/java/org/apache/hedwig/server/handlers/SubscriptionChannelManager.java,214,0,0.0,0,0,0.0,0,0,0.0,0,0,0.0,0,0,0,0,NO
4,hedwig-server/src/main/java/org/apache/hedwig/server/handlers/UnsubscribeHandler.java,107,0,0.0,0,0,0.0,0,0,0.0,0,0,0.0,0,0,0,0,NO
4,hedwig-server/src/main/java/org/apache/hedwig/server/jmx/HedwigJMXService.java,37,0,0.0,0,0,0.0,0,0,0.0,0,0,0.0,0,0,0,0,NO
4,hedwig-server/src/main/java/org/apache/hedwig/server/jmx/HedwigMBeanInfo.java,27,0,0.0,0,0,0.0,0,0,0.0,0,0,0.0,0,0,0,0,NO
4,hedwig-server/src/main/java/org/apache/hedwig/server/jmx/HedwigMBeanRegistry.java,48,0,0.0,0,0,0.0,0,0,0.0,0,0,0.0,0,0,0,0,NO
4,hedwig-server/src/main/java/org/apache/hedwig/server/meta/FactoryLayout.java,167,3,3.0,3,2,2.0,2,5,5.0,5,1,1.0,1,1,1,1,NO
4,hedwig-server/src/main/java/org/apache/hedwig/server/meta/MetadataManagerFactory.java,213,0,0.0,0,0,0.0,0,0,0.0,0,0,0.0,0,0,0,0,NO
4,hedwig-server/src/main/java/org/apache/hedwig/server/meta/MsMetadataManagerFactory.java,867,6,6.0,6,5,5.0,5,11,11.0,11,1,1.0,1,1,1,1,NO
4,hedwig-server/src/main/java/org/apache/hedwig/server/meta/SubscriptionDataManager.java,159,0,0.0,0,0,0.0,0,0,0.0,0,0,0.0,0,0,0,0,NO
4,hedwig-server/src/main/java/org/apache/hedwig/server/meta/TopicOwnershipManager.java,100,0,0.0,0,0,0.0,0,0,0.0,0,0,0.0,0,0,0,0,NO
4,hedwig-server/src/main/java/org/apache/hedwig/server/meta/TopicPersistenceManager.java,96,0,0.0,0,0,0.0,0,0,0.0,0,0,0.0,0,0,0,0,NO
4,hedwig-server/src/main/java/org/apache/hedwig/server/meta/ZkMetadataManagerFactory.java,842,10,5.0,10,9,4.5,9,19,9.5,19,1,0.5,1,2,2,2,NO
4,hedwig-server/src/main/java/org/apache/hedwig/server/netty/PubSubServer.java,525,1,1.0,1,1,1.0,1,2,2.0,2,0,0.0,0,1,0,1,NO
4,hedwig-server/src/main/java/org/apache/hedwig/server/netty/PubSubServerBean.java,83,0,0.0,0,0,0.0,0,0,0.0,0,0,0.0,0,0,0,0,NO
4,hedwig-server/src/main/java/org/apache/hedwig/server/netty/PubSubServerMXBean.java,63,0,0.0,0,0,0.0,0,0,0.0,0,0,0.0,0,0,0,0,NO
4,hedwig-server/src/main/java/org/apache/hedwig/server/netty/PubSubServerPipelineFactory.java,76,0,0.0,0,0,0.0,0,0,0.0,0,0,0.0,0,0,0,0,NO
4,hedwig-server/src/main/java/org/apache/hedwig/server/netty/ServerStats.java,202,0,0.0,0,0,0.0,0,0,0.0,0,0,0.0,0,0,0,0,NO
4,hedwig-server/src/main/java/org/apache/hedwig/server/netty/UmbrellaHandler.java,155,3,3.0,3,3,3.0,3,6,6.0,6,0,0.0,0,1,1,1,NO
4,hedwig-server/src/main/java/org/apache/hedwig/server/persistence/BookkeeperPersistenceManager.java,1263,2,2.0,2,1,1.0,1,3,3.0,3,1,1.0,1,1,1,1,NO
4,hedwig-server/src/main/java/org/apache/hedwig/server/persistence/CacheKey.java,74,0,0.0,0,0,0.0,0,0,0.0,0,0,0.0,0,0,0,0,NO
4,hedwig-server/src/main/java/org/apache/hedwig/server/persistence/CacheValue.java,101,0,0.0,0,0,0.0,0,0,0.0,0,0,0.0,0,0,0,0,NO
4,hedwig-server/src/main/java/org/apache/hedwig/server/persistence/CancelScanRequest.java,27,0,0.0,0,0,0.0,0,0,0.0,0,0,0.0,0,0,0,0,NO
4,hedwig-server/src/main/java/org/apache/hedwig/server/persistence/Factory.java,22,0,0.0,0,0,0.0,0,0,0.0,0,0,0.0,0,0,0,0,NO
4,hedwig-server/src/main/java/org/apache/hedwig/server/persistence/LocalDBPersistenceManager.java,491,3,3.0,3,1,1.0,1,4,4.0,4,2,2.0,2,1,1,1,NO
4,hedwig-server/src/main/java/org/apache/hedwig/server/persistence/MapMethods.java,62,0,0.0,0,0,0.0,0,0,0.0,0,0,0.0,0,0,0,0,NO
4,hedwig-server/src/main/java/org/apache/hedwig/server/persistence/PersistRequest.java,59,0,0.0,0,0,0.0,0,0,0.0,0,0,0.0,0,0,0,0,NO
4,hedwig-server/src/main/java/org/apache/hedwig/server/persistence/PersistenceManager.java,99,0,0.0,0,0,0.0,0,0,0.0,0,0,0.0,0,0,0,0,NO
4,hedwig-server/src/main/java/org/apache/hedwig/server/persistence/PersistenceManagerWithRangeScan.java,27,0,0.0,0,0,0.0,0,0,0.0,0,0,0.0,0,0,0,0,NO
4,hedwig-server/src/main/java/org/apache/hedwig/server/persistence/RangeScanRequest.java,77,0,0.0,0,0,0.0,0,0,0.0,0,0,0.0,0,0,0,0,NO
4,hedwig-server/src/main/java/org/apache/hedwig/server/persistence/ReadAheadCache.java,846,0,0.0,0,0,0.0,0,0,0.0,0,0,0.0,0,0,0,0,YES
4,hedwig-server/src/main/java/org/apache/hedwig/server/persistence/ReadAheadCacheBean.java,64,0,0.0,0,0,0.0,0,0,0.0,0,0,0.0,0,0,0,0,NO
4,hedwig-server/src/main/java/org/apache/hedwig/server/persistence/ReadAheadCacheMXBean.java,45,0,0.0,0,0,0.0,0,0,0.0,0,0,0.0,0,0,0,0,NO
4,hedwig-server/src/main/java/org/apache/hedwig/server/persistence/ScanCallback.java,63,0,0.0,0,0,0.0,0,0,0.0,0,0,0.0,0,0,0,0,NO
4,hedwig-server/src/main/java/org/apache/hedwig/server/persistence/ScanCallbackWithContext.java,54,0,0.0,0,0,0.0,0,0,0.0,0,0,0.0,0,0,0,0,NO
4,hedwig-server/src/main/java/org/apache/hedwig/server/persistence/ScanRequest.java,64,0,0.0,0,0,0.0,0,0,0.0,0,0,0.0,0,0,0,0,NO
4,hedwig-server/src/main/java/org/apache/hedwig/server/proxy/ChannelTracker.java,132,0,0.0,0,0,0.0,0,0,0.0,0,0,0.0,0,0,0,0,NO
4,hedwig-server/src/main/java/org/apache/hedwig/server/proxy/HedwigProxy.java,177,0,0.0,0,0,0.0,0,0,0.0,0,0,0.0,0,0,0,0,NO
4,hedwig-server/src/main/java/org/apache/hedwig/server/proxy/ProxyCloseSubscriptionHandler.java,70,0,0.0,0,0,0.0,0,0,0.0,0,0,0.0,0,0,0,0,NO
4,hedwig-server/src/main/java/org/apache/hedwig/server/proxy/ProxyConfiguration.java,36,0,0.0,0,0,0.0,0,0,0.0,0,0,0.0,0,0,0,0,NO
4,hedwig-server/src/main/java/org/apache/hedwig/server/proxy/ProxyConsumeHandler.java,58,0,0.0,0,0,0.0,0,0,0.0,0,0,0.0,0,0,0,0,NO
4,hedwig-server/src/main/java/org/apache/hedwig/server/proxy/ProxyPublishHander.java,62,0,0.0,0,0,0.0,0,0,0.0,0,0,0.0,0,0,0,0,NO
4,hedwig-server/src/main/java/org/apache/hedwig/server/proxy/ProxyStartDeliveryHandler.java,132,0,0.0,0,0,0.0,0,0,0.0,0,0,0.0,0,0,0,0,NO
4,hedwig-server/src/main/java/org/apache/hedwig/server/proxy/ProxyStopDeliveryHandler.java,74,0,0.0,0,0,0.0,0,0,0.0,0,0,0.0,0,0,0,0,NO
4,hedwig-server/src/main/java/org/apache/hedwig/server/proxy/ProxySubscribeHandler.java,86,5,5.0,5,2,2.0,2,7,7.0,7,3,3.0,3,1,1,1,NO
4,hedwig-server/src/main/java/org/apache/hedwig/server/proxy/ProxyUnsubscribeHandler.java,74,0,0.0,0,0,0.0,0,0,0.0,0,0,0.0,0,0,0,0,NO
4,hedwig-server/src/main/java/org/apache/hedwig/server/regions/HedwigHubClient.java,48,0,0.0,0,0,0.0,0,0,0.0,0,0,0.0,0,0,0,0,NO
4,hedwig-server/src/main/java/org/apache/hedwig/server/regions/HedwigHubClientFactory.java,74,0,0.0,0,0,0.0,0,0,0.0,0,0,0.0,0,0,0,0,NO
4,hedwig-server/src/main/java/org/apache/hedwig/server/regions/HedwigHubSubscriber.java,86,0,0.0,0,0,0.0,0,0,0.0,0,0,0.0,0,0,0,0,NO
4,hedwig-server/src/main/java/org/apache/hedwig/server/regions/RegionManager.java,355,0,0.0,0,0,0.0,0,0,0.0,0,0,0.0,0,0,0,0,NO
4,hedwig-server/src/main/java/org/apache/hedwig/server/ssl/SslServerContextFactory.java,53,0,0.0,0,0,0.0,0,0,0.0,0,0,0.0,0,0,0,0,NO
4,hedwig-server/src/main/java/org/apache/hedwig/server/subscriptions/AbstractSubscriptionManager.java,804,8,8.0,8,2,2.0,2,10,10.0,10,6,6.0,6,1,1,1,NO
4,hedwig-server/src/main/java/org/apache/hedwig/server/subscriptions/AllToAllTopologyFilter.java,75,0,0.0,0,0,0.0,0,0,0.0,0,0,0.0,0,0,0,0,NO
4,hedwig-server/src/main/java/org/apache/hedwig/server/subscriptions/InMemorySubscriptionManager.java,125,0,0.0,0,0,0.0,0,0,0.0,0,0,0.0,0,0,0,0,NO
4,hedwig-server/src/main/java/org/apache/hedwig/server/subscriptions/InMemorySubscriptionState.java,200,0,0.0,0,0,0.0,0,0,0.0,0,0,0.0,0,0,0,0,NO
4,hedwig-server/src/main/java/org/apache/hedwig/server/subscriptions/MMSubscriptionManager.java,134,0,0.0,0,0,0.0,0,0,0.0,0,0,0.0,0,0,0,0,NO
4,hedwig-server/src/main/java/org/apache/hedwig/server/subscriptions/SubscriptionEventListener.java,57,0,0.0,0,0,0.0,0,0,0.0,0,0,0.0,0,0,0,0,NO
4,hedwig-server/src/main/java/org/apache/hedwig/server/subscriptions/SubscriptionManager.java,123,0,0.0,0,0,0.0,0,0,0.0,0,0,0.0,0,0,0,0,NO
4,hedwig-server/src/main/java/org/apache/hedwig/server/topics/AbstractTopicManager.java,266,87,87.0,87,25,25.0,25,112,112.0,112,62,62.0,62,1,0,1,YES
4,hedwig-server/src/main/java/org/apache/hedwig/server/topics/HubInfo.java,162,0,0.0,0,0,0.0,0,0,0.0,0,0,0.0,0,0,0,0,NO
4,hedwig-server/src/main/java/org/apache/hedwig/server/topics/HubLoad.java,130,0,0.0,0,0,0.0,0,0,0.0,0,0,0.0,0,0,0,0,YES
4,hedwig-server/src/main/java/org/apache/hedwig/server/topics/HubServerManager.java,108,0,0.0,0,0,0.0,0,0,0.0,0,0,0.0,0,0,0,0,YES
4,hedwig-server/src/main/java/org/apache/hedwig/server/topics/MMTopicManager.java,354,2,2.0,2,1,1.0,1,3,3.0,3,1,1.0,1,1,0,1,YES
4,hedwig-server/src/main/java/org/apache/hedwig/server/topics/TopicManager.java,88,8,8.0,8,0,0.0,0,8,8.0,8,8,8.0,8,1,0,1,YES
4,hedwig-server/src/main/java/org/apache/hedwig/server/topics/TopicOwnershipChangeListener.java,28,0,0.0,0,0,0.0,0,0,0.0,0,0,0.0,0,0,0,0,NO
4,hedwig-server/src/main/java/org/apache/hedwig/server/topics/TrivialOwnAllTopicManager.java,58,2,2.0,2,1,1.0,1,3,3.0,3,1,1.0,1,1,0,1,NO
4,hedwig-server/src/main/java/org/apache/hedwig/server/topics/ZkHubServerManager.java,308,5,5.0,5,3,3.0,3,8,8.0,8,2,2.0,2,1,1,1,YES
4,hedwig-server/src/main/java/org/apache/hedwig/server/topics/ZkTopicManager.java,343,8,4.0,8,5,2.5,5,13,6.5,13,3,1.5,3,2,1,2,YES
4,hedwig-server/src/main/java/org/apache/hedwig/zookeeper/SafeAsynBKCallback.java,103,0,0.0,0,0,0.0,0,0,0.0,0,0,0.0,0,0,0,0,NO
4,hedwig-server/src/main/java/org/apache/hedwig/zookeeper/SafeAsyncCallback.java,35,0,0.0,0,0,0.0,0,0,0.0,0,0,0.0,0,0,0,0,NO
4,hedwig-server/src/main/java/org/apache/hedwig/zookeeper/SafeAsyncZKCallback.java,98,0,0.0,0,0,0.0,0,0,0.0,0,0,0.0,0,0,0,0,NO
4,hedwig-server/src/main/java/org/apache/hedwig/zookeeper/ZkUtils.java,117,1,1.0,1,1,1.0,1,2,2.0,2,0,0.0,0,1,1,1,NO
