RELEASE_ID,FILE_NAME,SIZE,LOC_ADDED,LOC_ADDED_AVG,LOC_ADDED_MAX,LOC_REMOVED,LOC_REMOVED_AVG,LOC_REMOVED_MAX,LOC_TOUCHED,LOC_TOUCHED_AVG,LOC_TOUCHED_MAX,CHURN,CHURN_AVG,CHURN_MAX,NUMBER_OF_REVISIONS,NUMBER_OF_DEFECT_FIXES,NUMBER_OF_AUTHORS,IS_BUGGY
6,bookkeeper-benchmark/src/main/java/org/apache/bookkeeper/benchmark/BenchBookie.java,215,1,1.0,1,1,1.0,1,2,2.0,2,0,0.0,0,1,0,1,NO
6,bookkeeper-benchmark/src/main/java/org/apache/bookkeeper/benchmark/BenchReadThroughputLatency.java,274,2,1.0,2,1,0.5,1,3,1.5,3,1,0.5,1,2,1,2,NO
6,bookkeeper-benchmark/src/main/java/org/apache/bookkeeper/benchmark/BenchThroughputLatency.java,461,2,1.0,2,1,0.5,1,3,1.5,3,1,0.5,1,2,1,2,YES
6,bookkeeper-benchmark/src/main/java/org/apache/bookkeeper/benchmark/MySqlClient.java,138,1,1.0,1,1,1.0,1,2,2.0,2,0,0.0,0,1,0,1,NO
6,bookkeeper-benchmark/src/main/java/org/apache/bookkeeper/benchmark/TestClient.java,358,0,0.0,0,0,0.0,0,0,0.0,0,0,0.0,0,0,0,0,NO
6,bookkeeper-server/src/main/java/org/apache/bookkeeper/bookie/Bookie.java,1248,211,26.375,211,117,14.625,117,328,41.0,328,166,20.75,166,8,1,2,YES
6,bookkeeper-server/src/main/java/org/apache/bookkeeper/bookie/BookieBean.java,51,0,0.0,0,0,0.0,0,0,0.0,0,0,0.0,0,0,0,0,NO
6,bookkeeper-server/src/main/java/org/apache/bookkeeper/bookie/BookieCriticalThread.java,45,45,45.0,45,0,0.0,0,45,45.0,45,45,45.0,45,1,0,1,NO
6,bookkeeper-server/src/main/java/org/apache/bookkeeper/bookie/BookieException.java,157,0,0.0,0,0,0.0,0,0,0.0,0,0,0.0,0,0,0,0,NO
6,bookkeeper-server/src/main/java/org/apache/bookkeeper/bookie/BookieMXBean.java,31,0,0.0,0,0,0.0,0,0,0.0,0,0,0.0,0,0,0,0,NO
6,bookkeeper-server/src/main/java/org/apache/bookkeeper/bookie/BookieShell.java,1008,3,1.0,3,4,1.3333334,4,7,2.3333333,7,1,0.33333334,1,3,0,2,YES
6,bookkeeper-server/src/main/java/org/apache/bookkeeper/bookie/BookieThread.java,55,66,33.0,66,11,5.5,11,77,38.5,77,55,27.5,55,2,0,1,NO
6,bookkeeper-server/src/main/java/org/apache/bookkeeper/bookie/BufferedChannel.java,204,101,33.666668,101,90,30.0,90,191,63.666668,191,27,9.0,27,3,0,2,NO
6,bookkeeper-server/src/main/java/org/apache/bookkeeper/bookie/BufferedChannelBase.java,55,55,55.0,55,0,0.0,0,55,55.0,55,55,55.0,55,1,0,1,NO
6,bookkeeper-server/src/main/java/org/apache/bookkeeper/bookie/BufferedReadChannel.java,103,103,103.0,103,0,0.0,0,103,103.0,103,103,103.0,103,1,0,1,NO
6,bookkeeper-server/src/main/java/org/apache/bookkeeper/bookie/CheckpointSource.java,83,1,1.0,1,1,1.0,1,2,2.0,2,0,0.0,0,1,1,1,NO
6,bookkeeper-server/src/main/java/org/apache/bookkeeper/bookie/Cookie.java,262,1,1.0,1,1,1.0,1,2,2.0,2,0,0.0,0,1,0,1,NO
6,bookkeeper-server/src/main/java/org/apache/bookkeeper/bookie/EntryKey.java,83,83,83.0,83,0,0.0,0,83,83.0,83,83,83.0,83,1,0,1,NO
6,bookkeeper-server/src/main/java/org/apache/bookkeeper/bookie/EntryLogger.java,867,313,78.25,313,84,21.0,84,397,99.25,397,229,57.25,229,4,1,2,YES
6,bookkeeper-server/src/main/java/org/apache/bookkeeper/bookie/ExitCode.java,40,0,0.0,0,0,0.0,0,0,0.0,0,0,0.0,0,0,0,0,NO
6,bookkeeper-server/src/main/java/org/apache/bookkeeper/bookie/FileInfo.java,387,69,23.0,69,56,18.666666,56,125,41.666668,125,13,4.3333335,13,3,0,2,YES
6,bookkeeper-server/src/main/java/org/apache/bookkeeper/bookie/FileSystemUpgrade.java,390,1,1.0,1,1,1.0,1,2,2.0,2,0,0.0,0,1,0,1,NO
6,bookkeeper-server/src/main/java/org/apache/bookkeeper/bookie/GarbageCollector.java,51,0,0.0,0,0,0.0,0,0,0.0,0,0,0.0,0,0,0,0,NO
6,bookkeeper-server/src/main/java/org/apache/bookkeeper/bookie/GarbageCollectorThread.java,637,147,29.4,147,89,17.8,89,236,47.2,236,58,11.6,58,5,2,2,YES
6,bookkeeper-server/src/main/java/org/apache/bookkeeper/bookie/HandleFactory.java,32,0,0.0,0,0,0.0,0,0,0.0,0,0,0.0,0,0,0,0,NO
6,bookkeeper-server/src/main/java/org/apache/bookkeeper/bookie/HandleFactoryImpl.java,68,18,18.0,18,16,16.0,16,34,34.0,34,2,2.0,2,1,0,1,YES
6,bookkeeper-server/src/main/java/org/apache/bookkeeper/bookie/IndexInMemPageMgr.java,547,754,377.0,754,207,103.5,207,961,480.5,961,547,273.5,547,2,0,2,YES
6,bookkeeper-server/src/main/java/org/apache/bookkeeper/bookie/IndexPersistenceMgr.java,566,668,167.0,668,102,25.5,102,770,192.5,770,566,141.5,566,4,0,2,NO
6,bookkeeper-server/src/main/java/org/apache/bookkeeper/bookie/InterleavedLedgerStorage.java,314,62,12.4,62,8,1.6,8,70,14.0,70,54,10.8,54,5,1,2,YES
6,bookkeeper-server/src/main/java/org/apache/bookkeeper/bookie/Journal.java,839,280,70.0,280,37,9.25,37,317,79.25,317,243,60.75,243,4,0,2,YES
6,bookkeeper-server/src/main/java/org/apache/bookkeeper/bookie/JournalChannel.java,211,24,12.0,24,11,5.5,11,35,17.5,35,13,6.5,13,2,0,2,NO
6,bookkeeper-server/src/main/java/org/apache/bookkeeper/bookie/LEPStateChangeCallback.java,31,31,31.0,31,0,0.0,0,31,31.0,31,31,31.0,31,1,0,1,NO
6,bookkeeper-server/src/main/java/org/apache/bookkeeper/bookie/LedgerCache.java,50,0,0.0,0,0,0.0,0,0,0.0,0,0,0.0,0,0,0,0,NO
6,bookkeeper-server/src/main/java/org/apache/bookkeeper/bookie/LedgerCacheBean.java,27,0,0.0,0,0,0.0,0,0,0.0,0,0,0.0,0,0,0,0,NO
6,bookkeeper-server/src/main/java/org/apache/bookkeeper/bookie/LedgerCacheImpl.java,175,39,19.5,39,790,395.0,790,829,414.5,829,751,375.5,751,2,0,2,NO
6,bookkeeper-server/src/main/java/org/apache/bookkeeper/bookie/LedgerCacheMXBean.java,50,0,0.0,0,10,10.0,10,10,10.0,10,10,10.0,10,1,0,1,NO
6,bookkeeper-server/src/main/java/org/apache/bookkeeper/bookie/LedgerDescriptor.java,62,0,0.0,0,0,0.0,0,0,0.0,0,0,0.0,0,0,0,0,NO
6,bookkeeper-server/src/main/java/org/apache/bookkeeper/bookie/LedgerDescriptorImpl.java,87,1,1.0,1,1,1.0,1,2,2.0,2,0,0.0,0,1,0,1,NO
6,bookkeeper-server/src/main/java/org/apache/bookkeeper/bookie/LedgerDescriptorReadOnlyImpl.java,52,0,0.0,0,0,0.0,0,0,0.0,0,0,0.0,0,0,0,0,NO
6,bookkeeper-server/src/main/java/org/apache/bookkeeper/bookie/LedgerDirsManager.java,373,123,24.6,123,47,9.4,47,170,34.0,170,76,15.2,76,5,0,2,NO
6,bookkeeper-server/src/main/java/org/apache/bookkeeper/bookie/LedgerEntryPage.java,224,108,108.0,108,47,47.0,47,155,155.0,155,61,61.0,61,1,0,1,NO
6,bookkeeper-server/src/main/java/org/apache/bookkeeper/bookie/LedgerStorage.java,118,0,0.0,0,0,0.0,0,0,0.0,0,0,0.0,0,0,0,0,YES
6,bookkeeper-server/src/main/java/org/apache/bookkeeper/bookie/LogMark.java,83,0,0.0,0,0,0.0,0,0,0.0,0,0,0.0,0,0,0,0,NO
6,bookkeeper-server/src/main/java/org/apache/bookkeeper/bookie/MarkerFileChannel.java,147,0,0.0,0,0,0.0,0,0,0.0,0,0,0.0,0,0,0,0,NO
6,bookkeeper-server/src/main/java/org/apache/bookkeeper/bookie/ReadOnlyEntryLogger.java,58,1,1.0,1,1,1.0,1,2,2.0,2,0,0.0,0,1,0,1,NO
6,bookkeeper-server/src/main/java/org/apache/bookkeeper/bookie/ReadOnlyFileInfo.java,44,0,0.0,0,0,0.0,0,0,0.0,0,0,0.0,0,0,0,0,NO
6,bookkeeper-server/src/main/java/org/apache/bookkeeper/bookie/ScanAndCompareGarbageCollector.java,106,0,0.0,0,0,0.0,0,0,0.0,0,0,0.0,0,0,0,0,NO
6,bookkeeper-server/src/main/java/org/apache/bookkeeper/bookie/SyncThread.java,189,7,3.5,7,10,5.0,10,17,8.5,17,3,1.5,3,2,0,2,NO
6,bookkeeper-server/src/main/java/org/apache/bookkeeper/client/AsyncCallback.java,151,0,0.0,0,0,0.0,0,0,0.0,0,0,0.0,0,0,0,0,NO
6,bookkeeper-server/src/main/java/org/apache/bookkeeper/client/BKException.java,352,0,0.0,0,0,0.0,0,0,0.0,0,0,0.0,0,0,0,0,YES
6,bookkeeper-server/src/main/java/org/apache/bookkeeper/client/BookKeeper.java,849,100,100.0,100,3,3.0,3,103,103.0,103,97,97.0,97,1,0,1,YES
6,bookkeeper-server/src/main/java/org/apache/bookkeeper/client/BookKeeperAdmin.java,877,1,1.0,1,1,1.0,1,2,2.0,2,0,0.0,0,1,0,1,YES
6,bookkeeper-server/src/main/java/org/apache/bookkeeper/client/BookKeeperClientStats.java,41,41,41.0,41,0,0.0,0,41,41.0,41,41,41.0,41,1,0,1,NO
6,bookkeeper-server/src/main/java/org/apache/bookkeeper/client/BookieWatcher.java,319,0,0.0,0,0,0.0,0,0,0.0,0,0,0.0,0,0,0,0,YES
6,bookkeeper-server/src/main/java/org/apache/bookkeeper/client/BookiesListener.java,27,0,0.0,0,0,0.0,0,0,0.0,0,0,0.0,0,0,0,0,NO
6,bookkeeper-server/src/main/java/org/apache/bookkeeper/client/CRC32DigestManager.java,55,0,0.0,0,0,0.0,0,0,0.0,0,0,0.0,0,0,0,0,NO
6,bookkeeper-server/src/main/java/org/apache/bookkeeper/client/DefaultEnsemblePlacementPolicy.java,94,0,0.0,0,0,0.0,0,0,0.0,0,0,0.0,0,0,0,0,NO
6,bookkeeper-server/src/main/java/org/apache/bookkeeper/client/DigestManager.java,191,0,0.0,0,0,0.0,0,0,0.0,0,0,0.0,0,0,0,0,NO
6,bookkeeper-server/src/main/java/org/apache/bookkeeper/client/DistributionSchedule.java,90,0,0.0,0,0,0.0,0,0,0.0,0,0,0.0,0,0,0,0,NO
6,bookkeeper-server/src/main/java/org/apache/bookkeeper/client/EnsemblePlacementPolicy.java,90,0,0.0,0,0,0.0,0,0,0.0,0,0,0.0,0,0,0,0,NO
6,bookkeeper-server/src/main/java/org/apache/bookkeeper/client/LedgerChecker.java,271,1,1.0,1,1,1.0,1,2,2.0,2,0,0.0,0,1,0,1,YES
6,bookkeeper-server/src/main/java/org/apache/bookkeeper/client/LedgerCreateOp.java,152,21,21.0,21,7,7.0,7,28,28.0,28,14,14.0,14,1,0,1,NO
6,bookkeeper-server/src/main/java/org/apache/bookkeeper/client/LedgerDeleteOp.java,90,11,11.0,11,0,0.0,0,11,11.0,11,11,11.0,11,1,0,1,YES
6,bookkeeper-server/src/main/java/org/apache/bookkeeper/client/LedgerEntry.java,82,1,1.0,1,1,1.0,1,2,2.0,2,0,0.0,0,1,0,1,NO
6,bookkeeper-server/src/main/java/org/apache/bookkeeper/client/LedgerFragment.java,147,0,0.0,0,0,0.0,0,0,0.0,0,0,0.0,0,0,0,0,NO
6,bookkeeper-server/src/main/java/org/apache/bookkeeper/client/LedgerFragmentReplicator.java,422,1,1.0,1,1,1.0,1,2,2.0,2,0,0.0,0,1,0,1,YES
6,bookkeeper-server/src/main/java/org/apache/bookkeeper/client/LedgerHandle.java,1059,55,18.333334,55,22,7.3333335,22,77,25.666666,77,33,11.0,33,3,2,2,YES
6,bookkeeper-server/src/main/java/org/apache/bookkeeper/client/LedgerMetadata.java,530,0,0.0,0,0,0.0,0,0,0.0,0,0,0.0,0,0,0,0,YES
6,bookkeeper-server/src/main/java/org/apache/bookkeeper/client/LedgerOpenOp.java,205,38,19.0,38,22,11.0,22,60,30.0,60,16,8.0,16,2,1,2,YES
6,bookkeeper-server/src/main/java/org/apache/bookkeeper/client/LedgerRecoveryOp.java,190,51,51.0,51,28,28.0,28,79,79.0,79,23,23.0,23,1,1,1,NO
6,bookkeeper-server/src/main/java/org/apache/bookkeeper/client/MacDigestManager.java,86,1,1.0,1,1,1.0,1,2,2.0,2,0,0.0,0,1,0,1,NO
6,bookkeeper-server/src/main/java/org/apache/bookkeeper/client/PendingAddOp.java,207,16,5.3333335,16,4,1.3333334,4,20,6.6666665,20,12,4.0,12,3,1,2,YES
6,bookkeeper-server/src/main/java/org/apache/bookkeeper/client/PendingReadOp.java,397,32,16.0,32,9,4.5,9,41,20.5,41,23,11.5,23,2,0,2,YES
6,bookkeeper-server/src/main/java/org/apache/bookkeeper/client/RackawareEnsemblePlacementPolicy.java,573,0,0.0,0,0,0.0,0,0,0.0,0,0,0.0,0,0,0,0,NO
6,bookkeeper-server/src/main/java/org/apache/bookkeeper/client/ReadLastConfirmedOp.java,126,0,0.0,0,0,0.0,0,0,0.0,0,0,0.0,0,0,0,0,YES
6,bookkeeper-server/src/main/java/org/apache/bookkeeper/client/ReadOnlyLedgerHandle.java,167,72,72.0,72,11,11.0,11,83,83.0,83,61,61.0,61,1,1,1,NO
6,bookkeeper-server/src/main/java/org/apache/bookkeeper/client/RoundRobinDistributionSchedule.java,109,0,0.0,0,0,0.0,0,0,0.0,0,0,0.0,0,0,0,0,YES
6,bookkeeper-server/src/main/java/org/apache/bookkeeper/client/SyncCounter.java,85,0,0.0,0,0,0.0,0,0,0.0,0,0,0.0,0,0,0,0,NO
6,bookkeeper-server/src/main/java/org/apache/bookkeeper/conf/AbstractConfiguration.java,237,0,0.0,0,0,0.0,0,0,0.0,0,0,0.0,0,0,0,0,NO
6,bookkeeper-server/src/main/java/org/apache/bookkeeper/conf/ClientConfiguration.java,424,80,80.0,80,1,1.0,1,81,81.0,81,79,79.0,79,1,1,1,YES
6,bookkeeper-server/src/main/java/org/apache/bookkeeper/conf/Configurable.java,47,0,0.0,0,0,0.0,0,0,0.0,0,0,0.0,0,0,0,0,NO
6,bookkeeper-server/src/main/java/org/apache/bookkeeper/conf/ServerConfiguration.java,1118,378,63.0,378,41,6.8333335,41,419,69.833336,419,337,56.166668,337,6,1,2,YES
6,bookkeeper-server/src/main/java/org/apache/bookkeeper/jmx/BKMBeanInfo.java,27,0,0.0,0,0,0.0,0,0,0.0,0,0,0.0,0,0,0,0,NO
6,bookkeeper-server/src/main/java/org/apache/bookkeeper/jmx/BKMBeanRegistry.java,89,0,0.0,0,0,0.0,0,0,0.0,0,0,0.0,0,0,0,0,NO
6,bookkeeper-server/src/main/java/org/apache/bookkeeper/meta/AbstractZkLedgerManager.java,474,177,88.5,177,3,1.5,3,180,90.0,180,174,87.0,174,2,1,1,YES
6,bookkeeper-server/src/main/java/org/apache/bookkeeper/meta/FlatLedgerManager.java,166,0,0.0,0,0,0.0,0,0,0.0,0,0,0.0,0,0,0,0,NO
6,bookkeeper-server/src/main/java/org/apache/bookkeeper/meta/FlatLedgerManagerFactory.java,92,0,0.0,0,0,0.0,0,0,0.0,0,0,0.0,0,0,0,0,NO
6,bookkeeper-server/src/main/java/org/apache/bookkeeper/meta/HierarchicalLedgerManager.java,476,1,1.0,1,22,22.0,22,23,23.0,23,21,21.0,21,1,1,1,NO
6,bookkeeper-server/src/main/java/org/apache/bookkeeper/meta/HierarchicalLedgerManagerFactory.java,93,0,0.0,0,0,0.0,0,0,0.0,0,0,0.0,0,0,0,0,NO
6,bookkeeper-server/src/main/java/org/apache/bookkeeper/meta/LedgerLayout.java,244,0,0.0,0,0,0.0,0,0,0.0,0,0,0.0,0,0,0,0,NO
6,bookkeeper-server/src/main/java/org/apache/bookkeeper/meta/LedgerManager.java,204,21,21.0,21,0,0.0,0,21,21.0,21,21,21.0,21,1,1,1,NO
6,bookkeeper-server/src/main/java/org/apache/bookkeeper/meta/LedgerManagerFactory.java,252,0,0.0,0,0,0.0,0,0,0.0,0,0,0.0,0,0,0,0,NO
6,bookkeeper-server/src/main/java/org/apache/bookkeeper/meta/LedgerUnderreplicationManager.java,109,0,0.0,0,0,0.0,0,0,0.0,0,0,0.0,0,0,0,0,YES
6,bookkeeper-server/src/main/java/org/apache/bookkeeper/meta/MSLedgerManagerFactory.java,618,12,6.0,12,1,0.5,1,13,6.5,13,11,5.5,11,2,1,1,NO
6,bookkeeper-server/src/main/java/org/apache/bookkeeper/meta/ZkLedgerUnderreplicationManager.java,565,0,0.0,0,0,0.0,0,0,0.0,0,0,0.0,0,0,0,0,YES
6,bookkeeper-server/src/main/java/org/apache/bookkeeper/meta/ZkVersion.java,69,0,0.0,0,0,0.0,0,0,0.0,0,0,0.0,0,0,0,0,NO
6,bookkeeper-server/src/main/java/org/apache/bookkeeper/metastore/InMemoryMetaStore.java,77,0,0.0,0,0,0.0,0,0,0.0,0,0,0.0,0,0,0,0,NO
6,bookkeeper-server/src/main/java/org/apache/bookkeeper/metastore/InMemoryMetastoreCursor.java,97,0,0.0,0,0,0.0,0,0,0.0,0,0,0.0,0,0,0,0,NO
6,bookkeeper-server/src/main/java/org/apache/bookkeeper/metastore/InMemoryMetastoreTable.java,343,0,0.0,0,0,0.0,0,0,0.0,0,0,0.0,0,0,0,0,NO
6,bookkeeper-server/src/main/java/org/apache/bookkeeper/metastore/MSException.java,214,0,0.0,0,0,0.0,0,0,0.0,0,0,0.0,0,0,0,0,NO
6,bookkeeper-server/src/main/java/org/apache/bookkeeper/metastore/MetaStore.java,79,0,0.0,0,0,0.0,0,0,0.0,0,0,0.0,0,0,0,0,NO
6,bookkeeper-server/src/main/java/org/apache/bookkeeper/metastore/MetastoreCallback.java,25,0,0.0,0,0,0.0,0,0,0.0,0,0,0.0,0,0,0,0,NO
6,bookkeeper-server/src/main/java/org/apache/bookkeeper/metastore/MetastoreCursor.java,84,0,0.0,0,0,0.0,0,0,0.0,0,0,0.0,0,0,0,0,NO
6,bookkeeper-server/src/main/java/org/apache/bookkeeper/metastore/MetastoreException.java,34,0,0.0,0,0,0.0,0,0,0.0,0,0,0.0,0,0,0,0,NO
6,bookkeeper-server/src/main/java/org/apache/bookkeeper/metastore/MetastoreFactory.java,33,0,0.0,0,0,0.0,0,0,0.0,0,0,0.0,0,0,0,0,NO
6,bookkeeper-server/src/main/java/org/apache/bookkeeper/metastore/MetastoreScannableTable.java,104,0,0.0,0,0,0.0,0,0,0.0,0,0,0.0,0,0,0,0,NO
6,bookkeeper-server/src/main/java/org/apache/bookkeeper/metastore/MetastoreTable.java,172,0,0.0,0,0,0.0,0,0,0.0,0,0,0.0,0,0,0,0,NO
6,bookkeeper-server/src/main/java/org/apache/bookkeeper/metastore/MetastoreTableItem.java,70,0,0.0,0,0,0.0,0,0,0.0,0,0,0.0,0,0,0,0,NO
6,bookkeeper-server/src/main/java/org/apache/bookkeeper/metastore/MetastoreUtils.java,140,0,0.0,0,0,0.0,0,0,0.0,0,0,0.0,0,0,0,0,NO
6,bookkeeper-server/src/main/java/org/apache/bookkeeper/metastore/Value.java,156,0,0.0,0,0,0.0,0,0,0.0,0,0,0.0,0,0,0,0,NO
6,bookkeeper-server/src/main/java/org/apache/bookkeeper/net/AbstractDNSToSwitchMapping.java,142,0,0.0,0,0,0.0,0,0,0.0,0,0,0.0,0,0,0,0,NO
6,bookkeeper-server/src/main/java/org/apache/bookkeeper/net/CachedDNSToSwitchMapping.java,152,0,0.0,0,0,0.0,0,0,0.0,0,0,0.0,0,0,0,0,NO
6,bookkeeper-server/src/main/java/org/apache/bookkeeper/net/CommonConfigurationKeys.java,31,0,0.0,0,0,0.0,0,0,0.0,0,0,0.0,0,0,0,0,NO
6,bookkeeper-server/src/main/java/org/apache/bookkeeper/net/DNSToSwitchMapping.java,60,0,0.0,0,0,0.0,0,0,0.0,0,0,0.0,0,0,0,0,NO
6,bookkeeper-server/src/main/java/org/apache/bookkeeper/net/NetUtils.java,60,0,0.0,0,0,0.0,0,0,0.0,0,0,0.0,0,0,0,0,NO
6,bookkeeper-server/src/main/java/org/apache/bookkeeper/net/NetworkTopology.java,876,0,0.0,0,0,0.0,0,0,0.0,0,0,0.0,0,0,0,0,NO
6,bookkeeper-server/src/main/java/org/apache/bookkeeper/net/Node.java,61,0,0.0,0,0,0.0,0,0,0.0,0,0,0.0,0,0,0,0,NO
6,bookkeeper-server/src/main/java/org/apache/bookkeeper/net/NodeBase.java,185,0,0.0,0,0,0.0,0,0,0.0,0,0,0.0,0,0,0,0,NO
6,bookkeeper-server/src/main/java/org/apache/bookkeeper/net/ScriptBasedMapping.java,264,0,0.0,0,0,0.0,0,0,0.0,0,0,0.0,0,0,0,0,NO
6,bookkeeper-server/src/main/java/org/apache/bookkeeper/processor/RequestProcessor.java,43,43,43.0,43,0,0.0,0,43,43.0,43,43,43.0,43,1,0,1,NO
6,bookkeeper-server/src/main/java/org/apache/bookkeeper/proto/BKStats.java,248,0,0.0,0,0,0.0,0,0,0.0,0,0,0.0,0,0,0,0,NO
6,bookkeeper-server/src/main/java/org/apache/bookkeeper/proto/BookieClient.java,310,44,14.666667,44,20,6.6666665,20,64,21.333334,64,24,8.0,24,3,2,1,YES
6,bookkeeper-server/src/main/java/org/apache/bookkeeper/proto/BookieNettyServer.java,199,32,10.666667,32,18,6.0,18,50,16.666666,50,14,4.6666665,14,3,0,2,YES
6,bookkeeper-server/src/main/java/org/apache/bookkeeper/proto/BookieProtoEncoding.java,194,1,1.0,1,1,1.0,1,2,2.0,2,0,0.0,0,1,0,1,YES
6,bookkeeper-server/src/main/java/org/apache/bookkeeper/proto/BookieProtocol.java,346,0,0.0,0,0,0.0,0,0,0.0,0,0,0.0,0,0,0,0,YES
6,bookkeeper-server/src/main/java/org/apache/bookkeeper/proto/BookieRequestHandler.java,90,7,3.5,7,226,113.0,226,233,116.5,233,219,109.5,219,2,0,2,NO
6,bookkeeper-server/src/main/java/org/apache/bookkeeper/proto/BookieRequestProcessor.java,335,335,335.0,335,0,0.0,0,335,335.0,335,335,335.0,335,1,0,1,YES
6,bookkeeper-server/src/main/java/org/apache/bookkeeper/proto/BookieServer.java,372,12,3.0,12,3,0.75,3,15,3.75,15,9,2.25,9,4,1,3,NO
6,bookkeeper-server/src/main/java/org/apache/bookkeeper/proto/BookieServerBean.java,84,0,0.0,0,0,0.0,0,0,0.0,0,0,0.0,0,0,0,0,NO
6,bookkeeper-server/src/main/java/org/apache/bookkeeper/proto/BookieServerMXBean.java,53,0,0.0,0,0,0.0,0,0,0.0,0,0,0.0,0,0,0,0,NO
6,bookkeeper-server/src/main/java/org/apache/bookkeeper/proto/BookkeeperInternalCallbacks.java,148,16,16.0,16,0,0.0,0,16,16.0,16,16,16.0,16,1,1,1,NO
6,bookkeeper-server/src/main/java/org/apache/bookkeeper/proto/DataFormats.java,4088,0,0.0,0,0,0.0,0,0,0.0,0,0,0.0,0,0,0,0,NO
6,bookkeeper-server/src/main/java/org/apache/bookkeeper/proto/PerChannelBookieClient.java,860,209,52.25,209,70,17.5,70,279,69.75,279,139,34.75,139,4,3,1,YES
6,bookkeeper-server/src/main/java/org/apache/bookkeeper/proto/ResponseBuilder.java,47,0,0.0,0,0,0.0,0,0,0.0,0,0,0.0,0,0,0,0,NO
6,bookkeeper-server/src/main/java/org/apache/bookkeeper/proto/ServerStats.java,101,0,0.0,0,0,0.0,0,0,0.0,0,0,0.0,0,0,0,0,NO
6,bookkeeper-server/src/main/java/org/apache/bookkeeper/replication/Auditor.java,517,0,0.0,0,0,0.0,0,0,0.0,0,0,0.0,0,0,0,0,YES
6,bookkeeper-server/src/main/java/org/apache/bookkeeper/replication/AuditorElector.java,327,0,0.0,0,0,0.0,0,0,0.0,0,0,0.0,0,0,0,0,YES
6,bookkeeper-server/src/main/java/org/apache/bookkeeper/replication/AutoRecoveryMain.java,275,2,2.0,2,1,1.0,1,3,3.0,3,1,1.0,1,1,0,1,YES
6,bookkeeper-server/src/main/java/org/apache/bookkeeper/replication/BookieLedgerIndexer.java,136,1,1.0,1,1,1.0,1,2,2.0,2,0,0.0,0,1,1,1,NO
6,bookkeeper-server/src/main/java/org/apache/bookkeeper/replication/ReplicationEnableCb.java,56,0,0.0,0,0,0.0,0,0,0.0,0,0,0.0,0,0,0,0,NO
6,bookkeeper-server/src/main/java/org/apache/bookkeeper/replication/ReplicationException.java,74,0,0.0,0,0,0.0,0,0,0.0,0,0,0.0,0,0,0,0,YES
6,bookkeeper-server/src/main/java/org/apache/bookkeeper/replication/ReplicationWorker.java,362,4,2.0,4,3,1.5,3,7,3.5,7,1,0.5,1,2,0,2,YES
6,bookkeeper-server/src/main/java/org/apache/bookkeeper/streaming/LedgerInputStream.java,174,1,1.0,1,1,1.0,1,2,2.0,2,0,0.0,0,1,0,1,NO
6,bookkeeper-server/src/main/java/org/apache/bookkeeper/streaming/LedgerOutputStream.java,148,1,1.0,1,1,1.0,1,2,2.0,2,0,0.0,0,1,0,1,NO
6,bookkeeper-server/src/main/java/org/apache/bookkeeper/tools/BookKeeperTools.java,92,1,1.0,1,1,1.0,1,2,2.0,2,0,0.0,0,1,0,1,NO
6,bookkeeper-server/src/main/java/org/apache/bookkeeper/util/BookKeeperConstants.java,45,0,0.0,0,0,0.0,0,0,0.0,0,0,0.0,0,0,0,0,YES
6,bookkeeper-server/src/main/java/org/apache/bookkeeper/util/DaemonThreadFactory.java,39,39,39.0,39,0,0.0,0,39,39.0,39,39,39.0,39,1,0,1,NO
6,bookkeeper-server/src/main/java/org/apache/bookkeeper/util/DiskChecker.java,182,42,42.0,42,28,28.0,28,70,70.0,70,14,14.0,14,1,0,1,NO
6,bookkeeper-server/src/main/java/org/apache/bookkeeper/util/EntryFormatter.java,77,1,1.0,1,1,1.0,1,2,2.0,2,0,0.0,0,1,0,1,NO
6,bookkeeper-server/src/main/java/org/apache/bookkeeper/util/HardLink.java,666,0,0.0,0,0,0.0,0,0,0.0,0,0,0.0,0,0,0,0,NO
6,bookkeeper-server/src/main/java/org/apache/bookkeeper/util/IOUtils.java,88,0,0.0,0,0,0.0,0,0,0.0,0,0,0.0,0,0,0,0,YES
6,bookkeeper-server/src/main/java/org/apache/bookkeeper/util/LocalBookKeeper.java,263,0,0.0,0,0,0.0,0,0,0.0,0,0,0.0,0,0,0,0,YES
6,bookkeeper-server/src/main/java/org/apache/bookkeeper/util/Main.java,54,0,0.0,0,0,0.0,0,0,0.0,0,0,0.0,0,0,0,0,NO
6,bookkeeper-server/src/main/java/org/apache/bookkeeper/util/MathUtils.java,76,25,25.0,25,0,0.0,0,25,25.0,25,25,25.0,25,1,0,1,NO
6,bookkeeper-server/src/main/java/org/apache/bookkeeper/util/NativeIO.java,132,1,1.0,1,1,1.0,1,2,2.0,2,0,0.0,0,1,0,1,NO
6,bookkeeper-server/src/main/java/org/apache/bookkeeper/util/OrderedSafeExecutor.java,160,0,0.0,0,0,0.0,0,0,0.0,0,0,0.0,0,0,0,0,YES
6,bookkeeper-server/src/main/java/org/apache/bookkeeper/util/ReflectionUtils.java,152,0,0.0,0,0,0.0,0,0,0.0,0,0,0.0,0,0,0,0,NO
6,bookkeeper-server/src/main/java/org/apache/bookkeeper/util/SafeRunnable.java,39,0,0.0,0,0,0.0,0,0,0.0,0,0,0.0,0,0,0,0,NO
6,bookkeeper-server/src/main/java/org/apache/bookkeeper/util/Shell.java,677,0,0.0,0,0,0.0,0,0,0.0,0,0,0.0,0,0,0,0,NO
6,bookkeeper-server/src/main/java/org/apache/bookkeeper/util/SnapshotMap.java,131,0,0.0,0,0,0.0,0,0,0.0,0,0,0.0,0,0,0,0,NO
6,bookkeeper-server/src/main/java/org/apache/bookkeeper/util/StringEntryFormatter.java,47,0,0.0,0,0,0.0,0,0,0.0,0,0,0.0,0,0,0,0,NO
6,bookkeeper-server/src/main/java/org/apache/bookkeeper/util/StringUtils.java,129,0,0.0,0,0,0.0,0,0,0.0,0,0,0.0,0,0,0,0,NO
6,bookkeeper-server/src/main/java/org/apache/bookkeeper/util/Tool.java,43,0,0.0,0,0,0.0,0,0,0.0,0,0,0.0,0,0,0,0,NO
6,bookkeeper-server/src/main/java/org/apache/bookkeeper/util/ZeroBuffer.java,73,73,73.0,73,0,0.0,0,73,73.0,73,73,73.0,73,1,0,1,NO
6,bookkeeper-server/src/main/java/org/apache/bookkeeper/util/ZkUtils.java,257,0,0.0,0,0,0.0,0,0,0.0,0,0,0.0,0,0,0,0,NO
6,bookkeeper-server/src/main/java/org/apache/bookkeeper/util/net/DNS.java,356,0,0.0,0,0,0.0,0,0,0.0,0,0,0.0,0,0,0,0,NO
6,bookkeeper-server/src/main/java/org/apache/bookkeeper/versioning/Version.java,62,0,0.0,0,0,0.0,0,0,0.0,0,0,0.0,0,0,0,0,NO
6,bookkeeper-server/src/main/java/org/apache/bookkeeper/versioning/Versioned.java,45,0,0.0,0,0,0.0,0,0,0.0,0,0,0.0,0,0,0,0,NO
6,bookkeeper-server/src/main/java/org/apache/bookkeeper/zookeeper/ZooKeeperWatcherBase.java,97,0,0.0,0,0,0.0,0,0,0.0,0,0,0.0,0,0,0,0,NO
6,bookkeeper-stats-providers/codahale-metrics-provider/src/main/java/org/apache/bookkeeper/stats/CodahaleMetricsProvider.java,131,135,67.5,135,4,2.0,4,139,69.5,139,131,65.5,131,2,1,2,YES
6,bookkeeper-stats-providers/codahale-metrics-provider/src/main/java/org/apache/bookkeeper/stats/CodahaleOpStatsLogger.java,68,68,68.0,68,0,0.0,0,68,68.0,68,68,68.0,68,1,0,1,YES
6,bookkeeper-stats-providers/codahale-metrics-provider/src/main/java/org/apache/bookkeeper/stats/CodahaleStatsLogger.java,99,99,99.0,99,0,0.0,0,99,99.0,99,99,99.0,99,1,0,1,NO
6,bookkeeper-stats-providers/twitter-ostrich-provider/src/main/java/org/apache/bookkeeper/stats/twitter/ostrich/CounterImpl.java,53,53,53.0,53,0,0.0,0,53,53.0,53,53,53.0,53,1,0,1,NO
6,bookkeeper-stats-providers/twitter-ostrich-provider/src/main/java/org/apache/bookkeeper/stats/twitter/ostrich/OpStatsLoggerImpl.java,81,81,81.0,81,0,0.0,0,81,81.0,81,81,81.0,81,1,0,1,NO
6,bookkeeper-stats-providers/twitter-ostrich-provider/src/main/java/org/apache/bookkeeper/stats/twitter/ostrich/OstrichProvider.java,78,78,78.0,78,0,0.0,0,78,78.0,78,78,78.0,78,1,0,1,YES
6,bookkeeper-stats-providers/twitter-ostrich-provider/src/main/java/org/apache/bookkeeper/stats/twitter/ostrich/OstrichStatsLoggerImpl.java,69,69,69.0,69,0,0.0,0,69,69.0,69,69,69.0,69,1,0,1,NO
6,bookkeeper-stats-providers/twitter-science-provider/src/main/java/org/apache/bookkeeper/stats/twitter/science/CounterImpl.java,69,69,69.0,69,0,0.0,0,69,69.0,69,69,69.0,69,1,0,1,NO
6,bookkeeper-stats-providers/twitter-science-provider/src/main/java/org/apache/bookkeeper/stats/twitter/science/HTTPStatsExporter.java,77,77,77.0,77,0,0.0,0,77,77.0,77,77,77.0,77,1,0,1,NO
6,bookkeeper-stats-providers/twitter-science-provider/src/main/java/org/apache/bookkeeper/stats/twitter/science/OpStatsLoggerImpl.java,72,72,72.0,72,0,0.0,0,72,72.0,72,72,72.0,72,1,0,1,NO
6,bookkeeper-stats-providers/twitter-science-provider/src/main/java/org/apache/bookkeeper/stats/twitter/science/TwitterStatsLoggerImpl.java,72,72,72.0,72,0,0.0,0,72,72.0,72,72,72.0,72,1,0,1,NO
6,bookkeeper-stats-providers/twitter-science-provider/src/main/java/org/apache/bookkeeper/stats/twitter/science/TwitterStatsProvider.java,63,63,63.0,63,0,0.0,0,63,63.0,63,63,63.0,63,1,0,1,NO
6,bookkeeper-stats/src/main/java/org/apache/bookkeeper/stats/Counter.java,50,50,50.0,50,0,0.0,0,50,50.0,50,50,50.0,50,1,0,1,NO
6,bookkeeper-stats/src/main/java/org/apache/bookkeeper/stats/Gauge.java,28,28,28.0,28,0,0.0,0,28,28.0,28,28,28.0,28,1,0,1,NO
6,bookkeeper-stats/src/main/java/org/apache/bookkeeper/stats/NullStatsLogger.java,96,96,96.0,96,0,0.0,0,96,96.0,96,96,96.0,96,1,0,1,NO
6,bookkeeper-stats/src/main/java/org/apache/bookkeeper/stats/NullStatsProvider.java,40,40,40.0,40,0,0.0,0,40,40.0,40,40,40.0,40,1,0,1,NO
6,bookkeeper-stats/src/main/java/org/apache/bookkeeper/stats/OpStatsData.java,76,76,76.0,76,0,0.0,0,76,76.0,76,76,76.0,76,1,0,1,NO
6,bookkeeper-stats/src/main/java/org/apache/bookkeeper/stats/OpStatsLogger.java,49,49,49.0,49,0,0.0,0,49,49.0,49,49,49.0,49,1,0,1,NO
6,bookkeeper-stats/src/main/java/org/apache/bookkeeper/stats/Stats.java,63,63,63.0,63,0,0.0,0,63,63.0,63,63,63.0,63,1,0,1,NO
6,bookkeeper-stats/src/main/java/org/apache/bookkeeper/stats/StatsLogger.java,55,55,55.0,55,0,0.0,0,55,55.0,55,55,55.0,55,1,0,1,NO
6,bookkeeper-stats/src/main/java/org/apache/bookkeeper/stats/StatsProvider.java,45,45,45.0,45,0,0.0,0,45,45.0,45,45,45.0,45,1,0,1,NO
6,hedwig-client-jms/src/main/java/org/apache/hedwig/jms/ConnectionImpl.java,476,0,0.0,0,0,0.0,0,0,0.0,0,0,0.0,0,0,0,0,NO
6,hedwig-client-jms/src/main/java/org/apache/hedwig/jms/ConnectionMetaDataImpl.java,77,0,0.0,0,0,0.0,0,0,0.0,0,0,0.0,0,0,0,0,NO
6,hedwig-client-jms/src/main/java/org/apache/hedwig/jms/DebugUtil.java,69,0,0.0,0,0,0.0,0,0,0.0,0,0,0.0,0,0,0,0,NO
6,hedwig-client-jms/src/main/java/org/apache/hedwig/jms/LRUCacheMap.java,104,0,0.0,0,0,0.0,0,0,0.0,0,0,0.0,0,0,0,0,NO
6,hedwig-client-jms/src/main/java/org/apache/hedwig/jms/LRUCacheSet.java,115,0,0.0,0,0,0.0,0,0,0.0,0,0,0.0,0,0,0,0,NO
6,hedwig-client-jms/src/main/java/org/apache/hedwig/jms/MessagingSessionFacade.java,421,0,0.0,0,0,0.0,0,0,0.0,0,0,0.0,0,0,0,0,NO
6,hedwig-client-jms/src/main/java/org/apache/hedwig/jms/Mutable.java,61,0,0.0,0,0,0.0,0,0,0.0,0,0,0.0,0,0,0,0,NO
6,hedwig-client-jms/src/main/java/org/apache/hedwig/jms/SessionImpl.java,2009,0,0.0,0,0,0.0,0,0,0.0,0,0,0.0,0,0,0,0,NO
6,hedwig-client-jms/src/main/java/org/apache/hedwig/jms/StateManager.java,179,0,0.0,0,0,0.0,0,0,0.0,0,0,0.0,0,0,0,0,NO
6,hedwig-client-jms/src/main/java/org/apache/hedwig/jms/jndi/HedwigInitialContext.java,106,0,0.0,0,0,0.0,0,0,0.0,0,0,0.0,0,0,0,0,NO
6,hedwig-client-jms/src/main/java/org/apache/hedwig/jms/jndi/HedwigInitialContextFactory.java,33,0,0.0,0,0,0.0,0,0,0.0,0,0,0.0,0,0,0,0,NO
6,hedwig-client-jms/src/main/java/org/apache/hedwig/jms/message/BytesMessageImpl.java,657,0,0.0,0,0,0.0,0,0,0.0,0,0,0.0,0,0,0,0,NO
6,hedwig-client-jms/src/main/java/org/apache/hedwig/jms/message/MapMessageImpl.java,295,0,0.0,0,0,0.0,0,0,0.0,0,0,0.0,0,0,0,0,NO
6,hedwig-client-jms/src/main/java/org/apache/hedwig/jms/message/MessageImpl.java,872,0,0.0,0,0,0.0,0,0,0.0,0,0,0.0,0,0,0,0,NO
6,hedwig-client-jms/src/main/java/org/apache/hedwig/jms/message/MessageUtil.java,444,0,0.0,0,0,0.0,0,0,0.0,0,0,0.0,0,0,0,0,NO
6,hedwig-client-jms/src/main/java/org/apache/hedwig/jms/message/ObjectMessageImpl.java,168,0,0.0,0,0,0.0,0,0,0.0,0,0,0.0,0,0,0,0,NO
6,hedwig-client-jms/src/main/java/org/apache/hedwig/jms/message/StreamMessageImpl.java,752,0,0.0,0,0,0.0,0,0,0.0,0,0,0.0,0,0,0,0,NO
6,hedwig-client-jms/src/main/java/org/apache/hedwig/jms/message/TextMessageImpl.java,135,0,0.0,0,0,0.0,0,0,0.0,0,0,0.0,0,0,0,0,NO
6,hedwig-client-jms/src/main/java/org/apache/hedwig/jms/message/header/JmsHeader.java,1126,0,0.0,0,0,0.0,0,0,0.0,0,0,0.0,0,0,0,0,NO
6,hedwig-client-jms/src/main/java/org/apache/hedwig/jms/message/header/MetadataProcessor.java,163,0,0.0,0,0,0.0,0,0,0.0,0,0,0.0,0,0,0,0,NO
6,hedwig-client-jms/src/main/java/org/apache/hedwig/jms/selector/BinaryArithmeticFunction.java,184,0,0.0,0,0,0.0,0,0,0.0,0,0,0.0,0,0,0,0,NO
6,hedwig-client-jms/src/main/java/org/apache/hedwig/jms/selector/BinaryExprFunction.java,51,0,0.0,0,0,0.0,0,0,0.0,0,0,0.0,0,0,0,0,NO
6,hedwig-client-jms/src/main/java/org/apache/hedwig/jms/selector/ExprFunction.java,25,0,0.0,0,0,0.0,0,0,0.0,0,0,0.0,0,0,0,0,NO
6,hedwig-client-jms/src/main/java/org/apache/hedwig/jms/selector/InterpretSelectorParserVisitor.java,180,0,0.0,0,0,0.0,0,0,0.0,0,0,0.0,0,0,0,0,NO
6,hedwig-client-jms/src/main/java/org/apache/hedwig/jms/selector/LogicalComparisonFunction.java,64,0,0.0,0,0,0.0,0,0,0.0,0,0,0.0,0,0,0,0,NO
6,hedwig-client-jms/src/main/java/org/apache/hedwig/jms/selector/MyNode.java,101,0,0.0,0,0,0.0,0,0,0.0,0,0,0.0,0,0,0,0,NO
6,hedwig-client-jms/src/main/java/org/apache/hedwig/jms/selector/PropertyExprFunction.java,512,0,0.0,0,0,0.0,0,0,0.0,0,0,0.0,0,0,0,0,NO
6,hedwig-client-jms/src/main/java/org/apache/hedwig/jms/selector/SelectorConstant.java,187,0,0.0,0,0,0.0,0,0,0.0,0,0,0.0,0,0,0,0,NO
6,hedwig-client-jms/src/main/java/org/apache/hedwig/jms/selector/SelectorEvalState.java,56,0,0.0,0,0,0.0,0,0,0.0,0,0,0.0,0,0,0,0,NO
6,hedwig-client-jms/src/main/java/org/apache/hedwig/jms/selector/SelectorEvaluationException.java,39,0,0.0,0,0,0.0,0,0,0.0,0,0,0.0,0,0,0,0,NO
6,hedwig-client-jms/src/main/java/org/apache/hedwig/jms/selector/TreeDumperSelectorParserVisitor.java,261,0,0.0,0,0,0.0,0,0,0.0,0,0,0.0,0,0,0,0,NO
6,hedwig-client-jms/src/main/java/org/apache/hedwig/jms/selector/UnaryArithmeticFunction.java,73,0,0.0,0,0,0.0,0,0,0.0,0,0,0.0,0,0,0,0,NO
6,hedwig-client-jms/src/main/java/org/apache/hedwig/jms/selector/UnaryExprFunction.java,65,0,0.0,0,0,0.0,0,0,0.0,0,0,0.0,0,0,0,0,NO
6,hedwig-client-jms/src/main/java/org/apache/hedwig/jms/selector/ValueComparisonFunction.java,329,0,0.0,0,0,0.0,0,0,0.0,0,0,0.0,0,0,0,0,NO
6,hedwig-client-jms/src/main/java/org/apache/hedwig/jms/spi/HedwigConnectionFactoryImpl.java,64,0,0.0,0,0,0.0,0,0,0.0,0,0,0.0,0,0,0,0,NO
6,hedwig-client-jms/src/main/java/org/apache/hedwig/jms/spi/HedwigConnectionImpl.java,164,0,0.0,0,0,0.0,0,0,0.0,0,0,0.0,0,0,0,0,NO
6,hedwig-client-jms/src/main/java/org/apache/hedwig/jms/spi/HedwigMessagingSessionFacade.java,624,0,0.0,0,0,0.0,0,0,0.0,0,0,0.0,0,0,0,0,NO
6,hedwig-client-jms/src/main/java/org/apache/hedwig/jms/spi/MessageConsumerImpl.java,74,0,0.0,0,0,0.0,0,0,0.0,0,0,0.0,0,0,0,0,NO
6,hedwig-client-jms/src/main/java/org/apache/hedwig/jms/spi/MessageProducerImpl.java,117,0,0.0,0,0,0.0,0,0,0.0,0,0,0.0,0,0,0,0,NO
6,hedwig-client-jms/src/main/java/org/apache/hedwig/jms/spi/QueueSessionImpl.java,84,0,0.0,0,0,0.0,0,0,0.0,0,0,0.0,0,0,0,0,NO
6,hedwig-client-jms/src/main/java/org/apache/hedwig/jms/spi/TopicPublisherImpl.java,226,0,0.0,0,0,0.0,0,0,0.0,0,0,0.0,0,0,0,0,NO
6,hedwig-client-jms/src/main/java/org/apache/hedwig/jms/spi/TopicSessionImpl.java,76,0,0.0,0,0,0.0,0,0,0.0,0,0,0.0,0,0,0,0,NO
6,hedwig-client-jms/src/main/java/org/apache/hedwig/jms/spi/TopicSubscriberImpl.java,323,0,0.0,0,0,0.0,0,0,0.0,0,0,0.0,0,0,0,0,NO
6,hedwig-client/src/main/java/org/apache/hedwig/client/HedwigClient.java,72,0,0.0,0,0,0.0,0,0,0.0,0,0,0.0,0,0,0,0,NO
6,hedwig-client/src/main/java/org/apache/hedwig/client/api/Client.java,42,0,0.0,0,0,0.0,0,0,0.0,0,0,0.0,0,0,0,0,NO
6,hedwig-client/src/main/java/org/apache/hedwig/client/api/MessageHandler.java,48,0,0.0,0,0,0.0,0,0,0.0,0,0,0.0,0,0,0,0,NO
6,hedwig-client/src/main/java/org/apache/hedwig/client/api/Publisher.java,89,0,0.0,0,0,0.0,0,0,0.0,0,0,0.0,0,0,0,0,NO
6,hedwig-client/src/main/java/org/apache/hedwig/client/api/Subscriber.java,380,0,0.0,0,0,0.0,0,0,0.0,0,0,0.0,0,0,0,0,NO
6,hedwig-client/src/main/java/org/apache/hedwig/client/benchmark/BenchmarkPublisher.java,141,0,0.0,0,0,0.0,0,0,0.0,0,0,0.0,0,0,0,0,NO
6,hedwig-client/src/main/java/org/apache/hedwig/client/benchmark/BenchmarkSubscriber.java,148,0,0.0,0,0,0.0,0,0,0.0,0,0,0.0,0,0,0,0,NO
6,hedwig-client/src/main/java/org/apache/hedwig/client/benchmark/BenchmarkUtils.java,191,0,0.0,0,0,0.0,0,0,0.0,0,0,0.0,0,0,0,0,NO
6,hedwig-client/src/main/java/org/apache/hedwig/client/benchmark/BenchmarkWorker.java,46,0,0.0,0,0,0.0,0,0,0.0,0,0,0.0,0,0,0,0,NO
6,hedwig-client/src/main/java/org/apache/hedwig/client/benchmark/HedwigBenchmark.java,165,0,0.0,0,0,0.0,0,0,0.0,0,0,0.0,0,0,0,0,NO
6,hedwig-client/src/main/java/org/apache/hedwig/client/conf/ClientConfiguration.java,171,0,0.0,0,0,0.0,0,0,0.0,0,0,0.0,0,0,0,0,NO
6,hedwig-client/src/main/java/org/apache/hedwig/client/data/MessageConsumeData.java,56,0,0.0,0,0,0.0,0,0,0.0,0,0,0.0,0,0,0,0,NO
6,hedwig-client/src/main/java/org/apache/hedwig/client/data/PubSubData.java,179,0,0.0,0,0,0.0,0,0,0.0,0,0,0.0,0,0,0,0,NO
6,hedwig-client/src/main/java/org/apache/hedwig/client/data/TopicSubscriber.java,74,0,0.0,0,0,0.0,0,0,0.0,0,0,0.0,0,0,0,0,NO
6,hedwig-client/src/main/java/org/apache/hedwig/client/exceptions/AlreadyStartDeliveryException.java,36,0,0.0,0,0,0.0,0,0,0.0,0,0,0.0,0,0,0,0,NO
6,hedwig-client/src/main/java/org/apache/hedwig/client/exceptions/InvalidSubscriberIdException.java,37,0,0.0,0,0,0.0,0,0,0.0,0,0,0.0,0,0,0,0,NO
6,hedwig-client/src/main/java/org/apache/hedwig/client/exceptions/NoResponseHandlerException.java,34,0,0.0,0,0,0.0,0,0,0.0,0,0,0.0,0,0,0,0,NO
6,hedwig-client/src/main/java/org/apache/hedwig/client/exceptions/ResubscribeException.java,34,0,0.0,0,0,0.0,0,0,0.0,0,0,0.0,0,0,0,0,NO
6,hedwig-client/src/main/java/org/apache/hedwig/client/exceptions/ServerRedirectLoopException.java,38,0,0.0,0,0,0.0,0,0,0.0,0,0,0.0,0,0,0,0,NO
6,hedwig-client/src/main/java/org/apache/hedwig/client/exceptions/TooManyServerRedirectsException.java,39,0,0.0,0,0,0.0,0,0,0.0,0,0,0.0,0,0,0,0,NO
6,hedwig-client/src/main/java/org/apache/hedwig/client/handlers/AbstractResponseHandler.java,156,0,0.0,0,0,0.0,0,0,0.0,0,0,0.0,0,0,0,0,NO
6,hedwig-client/src/main/java/org/apache/hedwig/client/handlers/CloseSubscriptionResponseHandler.java,84,0,0.0,0,0,0.0,0,0,0.0,0,0,0.0,0,0,0,0,NO
6,hedwig-client/src/main/java/org/apache/hedwig/client/handlers/MessageConsumeCallback.java,117,0,0.0,0,0,0.0,0,0,0.0,0,0,0.0,0,0,0,0,NO
6,hedwig-client/src/main/java/org/apache/hedwig/client/handlers/PubSubCallback.java,94,0,0.0,0,0,0.0,0,0,0.0,0,0,0.0,0,0,0,0,NO
6,hedwig-client/src/main/java/org/apache/hedwig/client/handlers/PublishResponseHandler.java,71,0,0.0,0,0,0.0,0,0,0.0,0,0,0.0,0,0,0,0,NO
6,hedwig-client/src/main/java/org/apache/hedwig/client/handlers/SubscribeResponseHandler.java,183,0,0.0,0,0,0.0,0,0,0.0,0,0,0.0,0,0,0,0,NO
6,hedwig-client/src/main/java/org/apache/hedwig/client/handlers/UnsubscribeResponseHandler.java,85,0,0.0,0,0,0.0,0,0,0.0,0,0,0.0,0,0,0,0,NO
6,hedwig-client/src/main/java/org/apache/hedwig/client/netty/CleanupChannelMap.java,183,0,0.0,0,0,0.0,0,0,0.0,0,0,0.0,0,0,0,0,NO
6,hedwig-client/src/main/java/org/apache/hedwig/client/netty/FilterableMessageHandler.java,70,0,0.0,0,0,0.0,0,0,0.0,0,0,0.0,0,0,0,0,NO
6,hedwig-client/src/main/java/org/apache/hedwig/client/netty/HChannel.java,54,0,0.0,0,0,0.0,0,0,0.0,0,0,0.0,0,0,0,0,NO
6,hedwig-client/src/main/java/org/apache/hedwig/client/netty/HChannelManager.java,160,0,0.0,0,0,0.0,0,0,0.0,0,0,0.0,0,0,0,0,NO
6,hedwig-client/src/main/java/org/apache/hedwig/client/netty/HedwigClientImpl.java,128,0,0.0,0,0,0.0,0,0,0.0,0,0,0.0,0,0,0,0,NO
6,hedwig-client/src/main/java/org/apache/hedwig/client/netty/HedwigPublisher.java,151,0,0.0,0,0,0.0,0,0,0.0,0,0,0.0,0,0,0,0,NO
6,hedwig-client/src/main/java/org/apache/hedwig/client/netty/HedwigSubscriber.java,422,0,0.0,0,0,0.0,0,0,0.0,0,0,0.0,0,0,0,0,NO
6,hedwig-client/src/main/java/org/apache/hedwig/client/netty/NetUtils.java,221,0,0.0,0,0,0.0,0,0,0.0,0,0,0.0,0,0,0,0,NO
6,hedwig-client/src/main/java/org/apache/hedwig/client/netty/SubscriptionEventEmitter.java,50,0,0.0,0,0,0.0,0,0,0.0,0,0,0.0,0,0,0,0,NO
6,hedwig-client/src/main/java/org/apache/hedwig/client/netty/VoidCallbackAdapter.java,42,0,0.0,0,0,0.0,0,0,0.0,0,0,0.0,0,0,0,0,NO
6,hedwig-client/src/main/java/org/apache/hedwig/client/netty/impl/AbstractHChannelManager.java,624,0,0.0,0,0,0.0,0,0,0.0,0,0,0.0,0,0,0,0,NO
6,hedwig-client/src/main/java/org/apache/hedwig/client/netty/impl/AbstractSubscribeResponseHandler.java,377,0,0.0,0,0,0.0,0,0,0.0,0,0,0.0,0,0,0,0,NO
6,hedwig-client/src/main/java/org/apache/hedwig/client/netty/impl/ActiveSubscriber.java,382,0,0.0,0,0,0.0,0,0,0.0,0,0,0.0,0,0,0,0,NO
6,hedwig-client/src/main/java/org/apache/hedwig/client/netty/impl/ClientChannelPipelineFactory.java,72,0,0.0,0,0,0.0,0,0,0.0,0,0,0.0,0,0,0,0,NO
6,hedwig-client/src/main/java/org/apache/hedwig/client/netty/impl/DefaultServerChannel.java,92,0,0.0,0,0,0.0,0,0,0.0,0,0,0.0,0,0,0,0,NO
6,hedwig-client/src/main/java/org/apache/hedwig/client/netty/impl/HChannelHandler.java,282,0,0.0,0,0,0.0,0,0,0.0,0,0,0.0,0,0,0,0,NO
6,hedwig-client/src/main/java/org/apache/hedwig/client/netty/impl/HChannelImpl.java,371,0,0.0,0,0,0.0,0,0,0.0,0,0,0.0,0,0,0,0,NO
6,hedwig-client/src/main/java/org/apache/hedwig/client/netty/impl/NonSubscriptionChannelPipelineFactory.java,47,0,0.0,0,0,0.0,0,0,0.0,0,0,0.0,0,0,0,0,NO
6,hedwig-client/src/main/java/org/apache/hedwig/client/netty/impl/ResubscribeCallback.java,108,0,0.0,0,0,0.0,0,0,0.0,0,0,0.0,0,0,0,0,NO
6,hedwig-client/src/main/java/org/apache/hedwig/client/netty/impl/WriteCallback.java,111,0,0.0,0,0,0.0,0,0,0.0,0,0,0.0,0,0,0,0,NO
6,hedwig-client/src/main/java/org/apache/hedwig/client/netty/impl/multiplex/MultiplexHChannelManager.java,319,0,0.0,0,0,0.0,0,0,0.0,0,0,0.0,0,0,0,0,NO
6,hedwig-client/src/main/java/org/apache/hedwig/client/netty/impl/multiplex/MultiplexSubscribeResponseHandler.java,129,0,0.0,0,0,0.0,0,0,0.0,0,0,0.0,0,0,0,0,NO
6,hedwig-client/src/main/java/org/apache/hedwig/client/netty/impl/multiplex/MultiplexSubscriptionChannelPipelineFactory.java,49,0,0.0,0,0,0.0,0,0,0.0,0,0,0.0,0,0,0,0,NO
6,hedwig-client/src/main/java/org/apache/hedwig/client/netty/impl/simple/SimpleHChannelManager.java,358,0,0.0,0,0,0.0,0,0,0.0,0,0,0.0,0,0,0,0,NO
6,hedwig-client/src/main/java/org/apache/hedwig/client/netty/impl/simple/SimpleSubscribeResponseHandler.java,277,0,0.0,0,0,0.0,0,0,0.0,0,0,0.0,0,0,0,0,NO
6,hedwig-client/src/main/java/org/apache/hedwig/client/netty/impl/simple/SimpleSubscriptionChannelPipelineFactory.java,49,0,0.0,0,0,0.0,0,0,0.0,0,0,0.0,0,0,0,0,NO
6,hedwig-client/src/main/java/org/apache/hedwig/client/netty/package-info.java,89,0,0.0,0,0,0.0,0,0,0.0,0,0,0.0,0,0,0,0,NO
6,hedwig-client/src/main/java/org/apache/hedwig/client/ssl/SslClientContextFactory.java,41,0,0.0,0,0,0.0,0,0,0.0,0,0,0.0,0,0,0,0,NO
6,hedwig-client/src/main/java/org/apache/hedwig/client/ssl/SslContextFactory.java,66,0,0.0,0,0,0.0,0,0,0.0,0,0,0.0,0,0,0,0,NO
6,hedwig-client/src/main/java/org/apache/hedwig/conf/AbstractConfiguration.java,63,0,0.0,0,0,0.0,0,0,0.0,0,0,0.0,0,0,0,0,NO
6,hedwig-client/src/main/java/org/apache/hedwig/filter/ClientMessageFilter.java,24,0,0.0,0,0,0.0,0,0,0.0,0,0,0.0,0,0,0,0,NO
6,hedwig-client/src/main/java/org/apache/hedwig/filter/MessageFilterBase.java,50,0,0.0,0,0,0.0,0,0,0.0,0,0,0.0,0,0,0,0,NO
6,hedwig-client/src/main/java/org/apache/hedwig/filter/PipelineFilter.java,72,0,0.0,0,0,0.0,0,0,0.0,0,0,0.0,0,0,0,0,NO
6,hedwig-client/src/main/java/org/apache/hedwig/filter/ServerMessageFilter.java,47,0,0.0,0,0,0.0,0,0,0.0,0,0,0.0,0,0,0,0,NO
6,hedwig-client/src/main/java/org/apache/hedwig/util/Callback.java,47,0,0.0,0,0,0.0,0,0,0.0,0,0,0.0,0,0,0,0,NO
6,hedwig-client/src/main/java/org/apache/hedwig/util/CallbackUtils.java,183,0,0.0,0,0,0.0,0,0,0.0,0,0,0.0,0,0,0,0,NO
6,hedwig-client/src/main/java/org/apache/hedwig/util/ConcurrencyUtils.java,49,0,0.0,0,0,0.0,0,0,0.0,0,0,0.0,0,0,0,0,NO
6,hedwig-client/src/main/java/org/apache/hedwig/util/Either.java,50,0,0.0,0,0,0.0,0,0,0.0,0,0,0.0,0,0,0,0,NO
6,hedwig-client/src/main/java/org/apache/hedwig/util/FileUtils.java,98,0,0.0,0,0,0.0,0,0,0.0,0,0,0.0,0,0,0,0,NO
6,hedwig-client/src/main/java/org/apache/hedwig/util/HedwigSocketAddress.java,143,0,0.0,0,0,0.0,0,0,0.0,0,0,0.0,0,0,0,0,NO
6,hedwig-client/src/main/java/org/apache/hedwig/util/Option.java,43,0,0.0,0,0,0.0,0,0,0.0,0,0,0.0,0,0,0,0,NO
6,hedwig-client/src/main/java/org/apache/hedwig/util/Pair.java,42,0,0.0,0,0,0.0,0,0,0.0,0,0,0.0,0,0,0,0,NO
6,hedwig-client/src/main/java/org/apache/hedwig/util/PathUtils.java,56,0,0.0,0,0,0.0,0,0,0.0,0,0,0.0,0,0,0,0,NO
6,hedwig-client/src/main/java/org/apache/hedwig/util/SubscriptionListener.java,44,0,0.0,0,0,0.0,0,0,0.0,0,0,0.0,0,0,0,0,NO
6,hedwig-client/src/main/java/org/apache/hedwig/util/VarArgs.java,26,0,0.0,0,0,0.0,0,0,0.0,0,0,0.0,0,0,0,0,NO
6,hedwig-protocol/src/main/java/org/apache/hedwig/exceptions/PubSubException.java,254,0,0.0,0,0,0.0,0,0,0.0,0,0,0.0,0,0,0,0,NO
6,hedwig-protocol/src/main/java/org/apache/hedwig/protocol/PubSubProtocol.java,16883,0,0.0,0,0,0.0,0,0,0.0,0,0,0.0,0,0,0,0,NO
6,hedwig-protocol/src/main/java/org/apache/hedwig/protoextensions/MapUtils.java,74,0,0.0,0,0,0.0,0,0,0.0,0,0,0.0,0,0,0,0,NO
6,hedwig-protocol/src/main/java/org/apache/hedwig/protoextensions/MessageIdUtils.java,153,0,0.0,0,0,0.0,0,0,0.0,0,0,0.0,0,0,0,0,NO
6,hedwig-protocol/src/main/java/org/apache/hedwig/protoextensions/PubSubResponseUtils.java,68,0,0.0,0,0,0.0,0,0,0.0,0,0,0.0,0,0,0,0,NO
6,hedwig-protocol/src/main/java/org/apache/hedwig/protoextensions/SubscriptionStateUtils.java,100,0,0.0,0,0,0.0,0,0,0.0,0,0,0.0,0,0,0,0,NO
6,hedwig-server/src/main/java/org/apache/hedwig/admin/HedwigAdmin.java,550,0,0.0,0,0,0.0,0,0,0.0,0,0,0.0,0,0,0,0,NO
6,hedwig-server/src/main/java/org/apache/hedwig/admin/console/HedwigCommands.java,437,0,0.0,0,0,0.0,0,0,0.0,0,0,0.0,0,0,0,0,NO
6,hedwig-server/src/main/java/org/apache/hedwig/admin/console/HedwigConsole.java,1038,0,0.0,0,0,0.0,0,0,0.0,0,0,0.0,0,0,0,0,NO
6,hedwig-server/src/main/java/org/apache/hedwig/admin/console/JLineHedwigCompletor.java,104,0,0.0,0,0,0.0,0,0,0.0,0,0,0.0,0,0,0,0,NO
6,hedwig-server/src/main/java/org/apache/hedwig/admin/console/ReadTopic.java,332,0,0.0,0,0,0.0,0,0,0.0,0,0,0.0,0,0,0,0,NO
6,hedwig-server/src/main/java/org/apache/hedwig/data/MessageFormatter.java,123,0,0.0,0,0,0.0,0,0,0.0,0,0,0.0,0,0,0,0,NO
6,hedwig-server/src/main/java/org/apache/hedwig/server/benchmark/AbstractBenchmark.java,106,0,0.0,0,0,0.0,0,0,0.0,0,0,0.0,0,0,0,0,NO
6,hedwig-server/src/main/java/org/apache/hedwig/server/benchmark/BookieBenchmark.java,106,0,0.0,0,0,0.0,0,0,0.0,0,0,0.0,0,0,0,0,NO
6,hedwig-server/src/main/java/org/apache/hedwig/server/benchmark/BookkeeperBenchmark.java,94,0,0.0,0,0,0.0,0,0,0.0,0,0,0.0,0,0,0,0,NO
6,hedwig-server/src/main/java/org/apache/hedwig/server/benchmark/FakeBookie.java,101,0,0.0,0,0,0.0,0,0,0.0,0,0,0.0,0,0,0,0,NO
6,hedwig-server/src/main/java/org/apache/hedwig/server/common/ByteStringInterner.java,38,0,0.0,0,0,0.0,0,0,0.0,0,0,0.0,0,0,0,0,NO
6,hedwig-server/src/main/java/org/apache/hedwig/server/common/ServerConfiguration.java,628,0,0.0,0,0,0.0,0,0,0.0,0,0,0.0,0,0,0,0,YES
6,hedwig-server/src/main/java/org/apache/hedwig/server/common/TerminateJVMExceptionHandler.java,32,0,0.0,0,0,0.0,0,0,0.0,0,0,0.0,0,0,0,0,NO
6,hedwig-server/src/main/java/org/apache/hedwig/server/common/TopicOpQueuer.java,111,0,0.0,0,0,0.0,0,0,0.0,0,0,0.0,0,0,0,0,NO
6,hedwig-server/src/main/java/org/apache/hedwig/server/common/UnexpectedError.java,35,0,0.0,0,0,0.0,0,0,0.0,0,0,0.0,0,0,0,0,NO
6,hedwig-server/src/main/java/org/apache/hedwig/server/delivery/ChannelEndPoint.java,90,0,0.0,0,0,0.0,0,0,0.0,0,0,0.0,0,0,0,0,NO
6,hedwig-server/src/main/java/org/apache/hedwig/server/delivery/DeliveryCallback.java,27,0,0.0,0,0,0.0,0,0,0.0,0,0,0.0,0,0,0,0,NO
6,hedwig-server/src/main/java/org/apache/hedwig/server/delivery/DeliveryEndPoint.java,28,0,0.0,0,0,0.0,0,0,0.0,0,0,0.0,0,0,0,0,NO
6,hedwig-server/src/main/java/org/apache/hedwig/server/delivery/DeliveryManager.java,92,0,0.0,0,0,0.0,0,0,0.0,0,0,0.0,0,0,0,0,NO
6,hedwig-server/src/main/java/org/apache/hedwig/server/delivery/FIFODeliveryManager.java,979,0,0.0,0,0,0.0,0,0,0.0,0,0,0.0,0,0,0,0,NO
6,hedwig-server/src/main/java/org/apache/hedwig/server/handlers/BaseHandler.java,67,0,0.0,0,0,0.0,0,0,0.0,0,0,0.0,0,0,0,0,NO
6,hedwig-server/src/main/java/org/apache/hedwig/server/handlers/ChannelDisconnectListener.java,29,0,0.0,0,0,0.0,0,0,0.0,0,0,0.0,0,0,0,0,NO
6,hedwig-server/src/main/java/org/apache/hedwig/server/handlers/CloseSubscriptionHandler.java,105,0,0.0,0,0,0.0,0,0,0.0,0,0,0.0,0,0,0,0,NO
6,hedwig-server/src/main/java/org/apache/hedwig/server/handlers/ConsumeHandler.java,72,0,0.0,0,0,0.0,0,0,0.0,0,0,0.0,0,0,0,0,NO
6,hedwig-server/src/main/java/org/apache/hedwig/server/handlers/Handler.java,37,0,0.0,0,0,0.0,0,0,0.0,0,0,0.0,0,0,0,0,NO
6,hedwig-server/src/main/java/org/apache/hedwig/server/handlers/NettyHandlerBean.java,47,0,0.0,0,0,0.0,0,0,0.0,0,0,0.0,0,0,0,0,NO
6,hedwig-server/src/main/java/org/apache/hedwig/server/handlers/NettyHandlerMXBean.java,31,0,0.0,0,0,0.0,0,0,0.0,0,0,0.0,0,0,0,0,NO
6,hedwig-server/src/main/java/org/apache/hedwig/server/handlers/PublishHandler.java,90,0,0.0,0,0,0.0,0,0,0.0,0,0,0.0,0,0,0,0,NO
6,hedwig-server/src/main/java/org/apache/hedwig/server/handlers/SubscribeHandler.java,223,0,0.0,0,0,0.0,0,0,0.0,0,0,0.0,0,0,0,0,NO
6,hedwig-server/src/main/java/org/apache/hedwig/server/handlers/SubscriptionChannelManager.java,214,0,0.0,0,0,0.0,0,0,0.0,0,0,0.0,0,0,0,0,NO
6,hedwig-server/src/main/java/org/apache/hedwig/server/handlers/UnsubscribeHandler.java,107,0,0.0,0,0,0.0,0,0,0.0,0,0,0.0,0,0,0,0,NO
6,hedwig-server/src/main/java/org/apache/hedwig/server/jmx/HedwigJMXService.java,37,0,0.0,0,0,0.0,0,0,0.0,0,0,0.0,0,0,0,0,NO
6,hedwig-server/src/main/java/org/apache/hedwig/server/jmx/HedwigMBeanInfo.java,27,0,0.0,0,0,0.0,0,0,0.0,0,0,0.0,0,0,0,0,NO
6,hedwig-server/src/main/java/org/apache/hedwig/server/jmx/HedwigMBeanRegistry.java,48,0,0.0,0,0,0.0,0,0,0.0,0,0,0.0,0,0,0,0,NO
6,hedwig-server/src/main/java/org/apache/hedwig/server/meta/FactoryLayout.java,167,0,0.0,0,0,0.0,0,0,0.0,0,0,0.0,0,0,0,0,NO
6,hedwig-server/src/main/java/org/apache/hedwig/server/meta/MetadataManagerFactory.java,213,0,0.0,0,0,0.0,0,0,0.0,0,0,0.0,0,0,0,0,NO
6,hedwig-server/src/main/java/org/apache/hedwig/server/meta/MsMetadataManagerFactory.java,867,0,0.0,0,0,0.0,0,0,0.0,0,0,0.0,0,0,0,0,NO
6,hedwig-server/src/main/java/org/apache/hedwig/server/meta/SubscriptionDataManager.java,159,0,0.0,0,0,0.0,0,0,0.0,0,0,0.0,0,0,0,0,NO
6,hedwig-server/src/main/java/org/apache/hedwig/server/meta/TopicOwnershipManager.java,100,0,0.0,0,0,0.0,0,0,0.0,0,0,0.0,0,0,0,0,NO
6,hedwig-server/src/main/java/org/apache/hedwig/server/meta/TopicPersistenceManager.java,96,0,0.0,0,0,0.0,0,0,0.0,0,0,0.0,0,0,0,0,NO
6,hedwig-server/src/main/java/org/apache/hedwig/server/meta/ZkMetadataManagerFactory.java,842,0,0.0,0,0,0.0,0,0,0.0,0,0,0.0,0,0,0,0,NO
6,hedwig-server/src/main/java/org/apache/hedwig/server/netty/PubSubServer.java,535,0,0.0,0,0,0.0,0,0,0.0,0,0,0.0,0,0,0,0,NO
6,hedwig-server/src/main/java/org/apache/hedwig/server/netty/PubSubServerBean.java,83,0,0.0,0,0,0.0,0,0,0.0,0,0,0.0,0,0,0,0,NO
6,hedwig-server/src/main/java/org/apache/hedwig/server/netty/PubSubServerMXBean.java,63,0,0.0,0,0,0.0,0,0,0.0,0,0,0.0,0,0,0,0,NO
6,hedwig-server/src/main/java/org/apache/hedwig/server/netty/PubSubServerPipelineFactory.java,76,0,0.0,0,0,0.0,0,0,0.0,0,0,0.0,0,0,0,0,NO
6,hedwig-server/src/main/java/org/apache/hedwig/server/netty/ServerStats.java,202,0,0.0,0,0,0.0,0,0,0.0,0,0,0.0,0,0,0,0,NO
6,hedwig-server/src/main/java/org/apache/hedwig/server/netty/UmbrellaHandler.java,155,0,0.0,0,0,0.0,0,0,0.0,0,0,0.0,0,0,0,0,NO
6,hedwig-server/src/main/java/org/apache/hedwig/server/persistence/BookkeeperPersistenceManager.java,1263,0,0.0,0,0,0.0,0,0,0.0,0,0,0.0,0,0,0,0,NO
6,hedwig-server/src/main/java/org/apache/hedwig/server/persistence/CacheKey.java,74,0,0.0,0,0,0.0,0,0,0.0,0,0,0.0,0,0,0,0,NO
6,hedwig-server/src/main/java/org/apache/hedwig/server/persistence/CacheValue.java,101,0,0.0,0,0,0.0,0,0,0.0,0,0,0.0,0,0,0,0,NO
6,hedwig-server/src/main/java/org/apache/hedwig/server/persistence/CancelScanRequest.java,27,0,0.0,0,0,0.0,0,0,0.0,0,0,0.0,0,0,0,0,NO
6,hedwig-server/src/main/java/org/apache/hedwig/server/persistence/Factory.java,22,0,0.0,0,0,0.0,0,0,0.0,0,0,0.0,0,0,0,0,NO
6,hedwig-server/src/main/java/org/apache/hedwig/server/persistence/LocalDBPersistenceManager.java,491,0,0.0,0,0,0.0,0,0,0.0,0,0,0.0,0,0,0,0,NO
6,hedwig-server/src/main/java/org/apache/hedwig/server/persistence/MapMethods.java,62,0,0.0,0,0,0.0,0,0,0.0,0,0,0.0,0,0,0,0,NO
6,hedwig-server/src/main/java/org/apache/hedwig/server/persistence/PersistRequest.java,59,0,0.0,0,0,0.0,0,0,0.0,0,0,0.0,0,0,0,0,NO
6,hedwig-server/src/main/java/org/apache/hedwig/server/persistence/PersistenceManager.java,99,0,0.0,0,0,0.0,0,0,0.0,0,0,0.0,0,0,0,0,NO
6,hedwig-server/src/main/java/org/apache/hedwig/server/persistence/PersistenceManagerWithRangeScan.java,27,0,0.0,0,0,0.0,0,0,0.0,0,0,0.0,0,0,0,0,NO
6,hedwig-server/src/main/java/org/apache/hedwig/server/persistence/RangeScanRequest.java,77,0,0.0,0,0,0.0,0,0,0.0,0,0,0.0,0,0,0,0,NO
6,hedwig-server/src/main/java/org/apache/hedwig/server/persistence/ReadAheadCache.java,863,0,0.0,0,0,0.0,0,0,0.0,0,0,0.0,0,0,0,0,NO
6,hedwig-server/src/main/java/org/apache/hedwig/server/persistence/ReadAheadCacheBean.java,64,0,0.0,0,0,0.0,0,0,0.0,0,0,0.0,0,0,0,0,NO
6,hedwig-server/src/main/java/org/apache/hedwig/server/persistence/ReadAheadCacheMXBean.java,45,0,0.0,0,0,0.0,0,0,0.0,0,0,0.0,0,0,0,0,NO
6,hedwig-server/src/main/java/org/apache/hedwig/server/persistence/ScanCallback.java,63,0,0.0,0,0,0.0,0,0,0.0,0,0,0.0,0,0,0,0,NO
6,hedwig-server/src/main/java/org/apache/hedwig/server/persistence/ScanCallbackWithContext.java,54,0,0.0,0,0,0.0,0,0,0.0,0,0,0.0,0,0,0,0,NO
6,hedwig-server/src/main/java/org/apache/hedwig/server/persistence/ScanRequest.java,64,0,0.0,0,0,0.0,0,0,0.0,0,0,0.0,0,0,0,0,NO
6,hedwig-server/src/main/java/org/apache/hedwig/server/proxy/ChannelTracker.java,132,0,0.0,0,0,0.0,0,0,0.0,0,0,0.0,0,0,0,0,NO
6,hedwig-server/src/main/java/org/apache/hedwig/server/proxy/HedwigProxy.java,182,0,0.0,0,0,0.0,0,0,0.0,0,0,0.0,0,0,0,0,NO
6,hedwig-server/src/main/java/org/apache/hedwig/server/proxy/ProxyCloseSubscriptionHandler.java,70,0,0.0,0,0,0.0,0,0,0.0,0,0,0.0,0,0,0,0,NO
6,hedwig-server/src/main/java/org/apache/hedwig/server/proxy/ProxyConfiguration.java,36,0,0.0,0,0,0.0,0,0,0.0,0,0,0.0,0,0,0,0,NO
6,hedwig-server/src/main/java/org/apache/hedwig/server/proxy/ProxyConsumeHandler.java,58,0,0.0,0,0,0.0,0,0,0.0,0,0,0.0,0,0,0,0,NO
6,hedwig-server/src/main/java/org/apache/hedwig/server/proxy/ProxyPublishHander.java,62,0,0.0,0,0,0.0,0,0,0.0,0,0,0.0,0,0,0,0,NO
6,hedwig-server/src/main/java/org/apache/hedwig/server/proxy/ProxyStartDeliveryHandler.java,132,0,0.0,0,0,0.0,0,0,0.0,0,0,0.0,0,0,0,0,NO
6,hedwig-server/src/main/java/org/apache/hedwig/server/proxy/ProxyStopDeliveryHandler.java,74,0,0.0,0,0,0.0,0,0,0.0,0,0,0.0,0,0,0,0,NO
6,hedwig-server/src/main/java/org/apache/hedwig/server/proxy/ProxySubscribeHandler.java,86,0,0.0,0,0,0.0,0,0,0.0,0,0,0.0,0,0,0,0,NO
6,hedwig-server/src/main/java/org/apache/hedwig/server/proxy/ProxyUnsubscribeHandler.java,74,0,0.0,0,0,0.0,0,0,0.0,0,0,0.0,0,0,0,0,NO
6,hedwig-server/src/main/java/org/apache/hedwig/server/regions/HedwigHubClient.java,48,0,0.0,0,0,0.0,0,0,0.0,0,0,0.0,0,0,0,0,NO
6,hedwig-server/src/main/java/org/apache/hedwig/server/regions/HedwigHubClientFactory.java,74,0,0.0,0,0,0.0,0,0,0.0,0,0,0.0,0,0,0,0,NO
6,hedwig-server/src/main/java/org/apache/hedwig/server/regions/HedwigHubSubscriber.java,86,0,0.0,0,0,0.0,0,0,0.0,0,0,0.0,0,0,0,0,NO
6,hedwig-server/src/main/java/org/apache/hedwig/server/regions/RegionManager.java,355,0,0.0,0,0,0.0,0,0,0.0,0,0,0.0,0,0,0,0,NO
6,hedwig-server/src/main/java/org/apache/hedwig/server/ssl/SslServerContextFactory.java,53,0,0.0,0,0,0.0,0,0,0.0,0,0,0.0,0,0,0,0,NO
6,hedwig-server/src/main/java/org/apache/hedwig/server/subscriptions/AbstractSubscriptionManager.java,804,0,0.0,0,0,0.0,0,0,0.0,0,0,0.0,0,0,0,0,NO
6,hedwig-server/src/main/java/org/apache/hedwig/server/subscriptions/AllToAllTopologyFilter.java,75,0,0.0,0,0,0.0,0,0,0.0,0,0,0.0,0,0,0,0,NO
6,hedwig-server/src/main/java/org/apache/hedwig/server/subscriptions/InMemorySubscriptionManager.java,125,0,0.0,0,0,0.0,0,0,0.0,0,0,0.0,0,0,0,0,NO
6,hedwig-server/src/main/java/org/apache/hedwig/server/subscriptions/InMemorySubscriptionState.java,200,0,0.0,0,0,0.0,0,0,0.0,0,0,0.0,0,0,0,0,NO
6,hedwig-server/src/main/java/org/apache/hedwig/server/subscriptions/MMSubscriptionManager.java,134,0,0.0,0,0,0.0,0,0,0.0,0,0,0.0,0,0,0,0,NO
6,hedwig-server/src/main/java/org/apache/hedwig/server/subscriptions/SubscriptionEventListener.java,57,0,0.0,0,0,0.0,0,0,0.0,0,0,0.0,0,0,0,0,NO
6,hedwig-server/src/main/java/org/apache/hedwig/server/subscriptions/SubscriptionManager.java,123,0,0.0,0,0,0.0,0,0,0.0,0,0,0.0,0,0,0,0,NO
6,hedwig-server/src/main/java/org/apache/hedwig/server/topics/AbstractTopicManager.java,266,0,0.0,0,0,0.0,0,0,0.0,0,0,0.0,0,0,0,0,YES
6,hedwig-server/src/main/java/org/apache/hedwig/server/topics/HubInfo.java,162,0,0.0,0,0,0.0,0,0,0.0,0,0,0.0,0,0,0,0,NO
6,hedwig-server/src/main/java/org/apache/hedwig/server/topics/HubLoad.java,130,0,0.0,0,0,0.0,0,0,0.0,0,0,0.0,0,0,0,0,YES
6,hedwig-server/src/main/java/org/apache/hedwig/server/topics/HubServerManager.java,108,0,0.0,0,0,0.0,0,0,0.0,0,0,0.0,0,0,0,0,YES
6,hedwig-server/src/main/java/org/apache/hedwig/server/topics/MMTopicManager.java,354,0,0.0,0,0,0.0,0,0,0.0,0,0,0.0,0,0,0,0,YES
6,hedwig-server/src/main/java/org/apache/hedwig/server/topics/TopicManager.java,88,0,0.0,0,0,0.0,0,0,0.0,0,0,0.0,0,0,0,0,YES
6,hedwig-server/src/main/java/org/apache/hedwig/server/topics/TopicOwnershipChangeListener.java,28,0,0.0,0,0,0.0,0,0,0.0,0,0,0.0,0,0,0,0,NO
6,hedwig-server/src/main/java/org/apache/hedwig/server/topics/TrivialOwnAllTopicManager.java,58,0,0.0,0,0,0.0,0,0,0.0,0,0,0.0,0,0,0,0,NO
6,hedwig-server/src/main/java/org/apache/hedwig/server/topics/ZkHubServerManager.java,308,0,0.0,0,0,0.0,0,0,0.0,0,0,0.0,0,0,0,0,YES
6,hedwig-server/src/main/java/org/apache/hedwig/server/topics/ZkTopicManager.java,343,0,0.0,0,0,0.0,0,0,0.0,0,0,0.0,0,0,0,0,YES
6,hedwig-server/src/main/java/org/apache/hedwig/zookeeper/SafeAsynBKCallback.java,103,0,0.0,0,0,0.0,0,0,0.0,0,0,0.0,0,0,0,0,NO
6,hedwig-server/src/main/java/org/apache/hedwig/zookeeper/SafeAsyncCallback.java,35,0,0.0,0,0,0.0,0,0,0.0,0,0,0.0,0,0,0,0,NO
6,hedwig-server/src/main/java/org/apache/hedwig/zookeeper/SafeAsyncZKCallback.java,98,0,0.0,0,0,0.0,0,0,0.0,0,0,0.0,0,0,0,0,NO
6,hedwig-server/src/main/java/org/apache/hedwig/zookeeper/ZkUtils.java,117,0,0.0,0,0,0.0,0,0,0.0,0,0,0.0,0,0,0,0,NO
