RELEASE_ID,FILE_NAME,SIZE,LOC_ADDED,LOC_ADDED_AVG,LOC_ADDED_MAX,LOC_REMOVED,LOC_REMOVED_AVG,LOC_REMOVED_MAX,LOC_TOUCHED,LOC_TOUCHED_AVG,LOC_TOUCHED_MAX,CHURN,CHURN_AVG,CHURN_MAX,NUMBER_OF_REVISIONS,NUMBER_OF_DEFECT_FIXES,NUMBER_OF_AUTHORS,IS_BUGGY
1,src/java/jmx/org/apache/zookeeper/jmx/CommonNames.java,29,36,12.0,36,7,2.3333333,7,43,14.333333,43,29,9.666667,29,3,0,1,NO
1,src/java/jmx/org/apache/zookeeper/jmx/MBeanRegistry.java,175,182,45.5,182,7,1.75,7,189,47.25,189,175,43.75,175,4,0,2,NO
1,src/java/jmx/org/apache/zookeeper/jmx/ZKMBeanInfo.java,36,42,14.0,42,6,2.0,6,48,16.0,48,36,12.0,36,3,0,1,NO
1,src/java/jmx/org/apache/zookeeper/jmx/server/ConnectionBean.java,112,125,25.0,125,13,2.6,13,138,27.6,138,112,22.4,112,5,0,3,NO
1,src/java/jmx/org/apache/zookeeper/jmx/server/ConnectionMXBean.java,68,74,24.666666,74,6,2.0,6,80,26.666666,80,68,22.666666,68,3,0,1,NO
1,src/java/jmx/org/apache/zookeeper/jmx/server/DataTreeBean.java,88,105,21.0,105,17,3.4,17,122,24.4,122,96,19.2,96,5,0,2,NO
1,src/java/jmx/org/apache/zookeeper/jmx/server/DataTreeMXBean.java,46,52,17.333334,52,6,2.0,6,58,19.333334,58,46,15.333333,46,3,0,1,NO
1,src/java/jmx/org/apache/zookeeper/jmx/server/ZooKeeperServerBean.java,117,130,32.5,130,13,3.25,13,143,35.75,143,117,29.25,117,4,0,2,NO
1,src/java/jmx/org/apache/zookeeper/jmx/server/ZooKeeperServerMXBean.java,74,80,26.666666,80,6,2.0,6,86,28.666666,86,74,24.666666,74,3,0,1,NO
1,src/java/jmx/org/apache/zookeeper/jmx/server/quorum/FollowerBean.java,28,34,11.333333,34,6,2.0,6,40,13.333333,40,28,9.333333,28,3,0,1,NO
1,src/java/jmx/org/apache/zookeeper/jmx/server/quorum/FollowerMXBean.java,26,32,10.666667,32,6,2.0,6,38,12.666667,38,26,8.666667,26,3,0,1,NO
1,src/java/jmx/org/apache/zookeeper/jmx/server/quorum/LeaderBean.java,29,35,11.666667,35,6,2.0,6,41,13.666667,41,29,9.666667,29,3,0,1,NO
1,src/java/jmx/org/apache/zookeeper/jmx/server/quorum/LeaderElectionBean.java,43,50,16.666666,50,7,2.3333333,7,57,19.0,57,43,14.333333,43,3,0,1,NO
1,src/java/jmx/org/apache/zookeeper/jmx/server/quorum/LeaderElectionMXBean.java,34,40,13.333333,40,6,2.0,6,46,15.333333,46,34,11.333333,34,3,0,1,NO
1,src/java/jmx/org/apache/zookeeper/jmx/server/quorum/LeaderMXBean.java,26,32,10.666667,32,6,2.0,6,38,12.666667,38,26,8.666667,26,3,0,1,NO
1,src/java/jmx/org/apache/zookeeper/jmx/server/quorum/LocalPeerBean.java,53,61,15.25,61,8,2.0,8,69,17.25,69,53,13.25,53,4,0,2,NO
1,src/java/jmx/org/apache/zookeeper/jmx/server/quorum/LocalPeerMXBean.java,34,41,13.666667,41,7,2.3333333,7,48,16.0,48,34,11.333333,34,3,0,1,NO
1,src/java/jmx/org/apache/zookeeper/jmx/server/quorum/QuorumBean.java,44,52,17.333334,52,8,2.6666667,8,60,20.0,60,44,14.666667,44,3,0,1,NO
1,src/java/jmx/org/apache/zookeeper/jmx/server/quorum/QuorumMXBean.java,33,39,13.0,39,6,2.0,6,45,15.0,45,33,11.0,33,3,0,1,NO
1,src/java/jmx/org/apache/zookeeper/jmx/server/quorum/RemotePeerBean.java,45,53,17.666666,53,8,2.6666667,8,61,20.333334,61,45,15.0,45,3,0,1,NO
1,src/java/jmx/org/apache/zookeeper/jmx/server/quorum/RemotePeerMXBean.java,33,39,13.0,39,6,2.0,6,45,15.0,45,33,11.0,33,3,0,1,NO
1,src/java/jmx/org/apache/zookeeper/jmx/server/quorum/ServerBean.java,38,45,15.0,45,7,2.3333333,7,52,17.333334,52,38,12.666667,38,3,0,1,NO
1,src/java/jmx/org/apache/zookeeper/jmx/server/quorum/ServerMXBean.java,33,39,13.0,39,6,2.0,6,45,15.0,45,33,11.0,33,3,0,1,NO
1,src/java/jmx/org/apache/zookeeper/server/ManagedZooKeeperServer.java,125,180,30.0,180,55,9.166667,55,235,39.166668,235,157,26.166666,157,6,0,3,NO
1,src/java/jmx/org/apache/zookeeper/server/ManagedZooKeeperServerMain.java,79,86,28.666666,86,7,2.3333333,7,93,31.0,93,81,27.0,81,3,0,2,NO
1,src/java/jmx/org/apache/zookeeper/server/ObservableDataTree.java,115,130,32.5,130,15,3.75,15,145,36.25,145,115,28.75,115,4,0,2,NO
1,src/java/jmx/org/apache/zookeeper/server/ObservableNIOServerCnxn.java,85,94,31.333334,94,9,3.0,9,103,34.333332,103,85,28.333334,85,3,0,1,NO
1,src/java/jmx/org/apache/zookeeper/server/ObservableZooKeeperServer.java,56,79,13.166667,79,23,3.8333333,23,102,17.0,102,60,10.0,60,6,0,3,NO
1,src/java/jmx/org/apache/zookeeper/server/ZooKeeperObserverNotifier.java,76,85,28.333334,85,9,3.0,9,94,31.333334,94,76,25.333334,76,3,0,1,NO
1,src/java/jmx/org/apache/zookeeper/server/quorum/ManagedQuorumPeer.java,225,315,45.0,315,90,12.857142,90,405,57.857143,405,281,40.142857,281,7,0,3,NO
1,src/java/jmx/org/apache/zookeeper/server/quorum/ManagedQuorumPeerMain.java,132,163,40.75,163,31,7.75,31,194,48.5,194,170,42.5,170,4,0,2,NO
1,src/java/jmx/org/apache/zookeeper/server/quorum/ObservableFollower.java,78,87,29.0,87,9,3.0,9,96,32.0,96,78,26.0,78,3,0,1,NO
1,src/java/jmx/org/apache/zookeeper/server/quorum/ObservableFollowerZooKeeperServer.java,55,67,16.75,67,12,3.0,12,79,19.75,79,55,13.75,55,4,0,2,NO
1,src/java/jmx/org/apache/zookeeper/server/quorum/ObservableLeader.java,82,91,30.333334,91,9,3.0,9,100,33.333332,100,82,27.333334,82,3,0,1,NO
1,src/java/jmx/org/apache/zookeeper/server/quorum/ObservableLeaderZooKeeperServer.java,55,67,16.75,67,12,3.0,12,79,19.75,79,55,13.75,55,4,0,2,NO
1,src/java/jmx/org/apache/zookeeper/server/quorum/ObservableQuorumPeer.java,115,166,23.714285,166,51,7.285714,51,217,31.0,217,131,18.714285,131,7,0,3,NO
1,src/java/jmx/org/apache/zookeeper/server/util/ConnectionObserver.java,38,45,15.0,45,7,2.3333333,7,52,17.333334,52,38,12.666667,38,3,0,1,NO
1,src/java/jmx/org/apache/zookeeper/server/util/DataTreeObserver.java,53,61,20.333334,61,8,2.6666667,8,69,23.0,69,53,17.666666,53,3,0,1,NO
1,src/java/jmx/org/apache/zookeeper/server/util/EventInfo.java,30,36,12.0,36,6,2.0,6,42,14.0,42,30,10.0,30,3,0,1,NO
1,src/java/jmx/org/apache/zookeeper/server/util/ObservableComponent.java,34,40,13.333333,40,6,2.0,6,46,15.333333,46,34,11.333333,34,3,0,1,NO
1,src/java/jmx/org/apache/zookeeper/server/util/ObserverManager.java,95,101,33.666668,101,6,2.0,6,107,35.666668,107,95,31.666666,95,3,0,1,NO
1,src/java/jmx/org/apache/zookeeper/server/util/QuorumPeerObserver.java,69,78,26.0,78,9,3.0,9,87,29.0,87,69,23.0,69,3,0,1,NO
1,src/java/jmx/org/apache/zookeeper/server/util/ServerObserver.java,38,45,15.0,45,7,2.3333333,7,52,17.333334,52,38,12.666667,38,3,0,1,NO
1,src/java/jmx/org/apache/zookeeper/server/util/ZooKeeperObserverManager.java,61,71,23.666666,71,10,3.3333333,10,81,27.0,81,61,20.333334,61,3,0,1,NO
1,src/java/main/org/apache/jute/BinaryInputArchive.java,132,133,44.333332,133,1,0.33333334,1,134,44.666668,134,132,44.0,132,3,0,1,NO
1,src/java/main/org/apache/jute/BinaryOutputArchive.java,149,150,50.0,150,1,0.33333334,1,151,50.333332,151,149,49.666668,149,3,0,1,NO
1,src/java/main/org/apache/jute/CsvInputArchive.java,210,211,70.333336,211,1,0.33333334,1,212,70.666664,212,210,70.0,210,3,0,1,NO
1,src/java/main/org/apache/jute/CsvOutputArchive.java,151,152,38.0,152,1,0.25,1,153,38.25,153,151,37.75,151,4,0,2,NO
1,src/java/main/org/apache/jute/Index.java,39,40,13.333333,40,1,0.33333334,1,41,13.666667,41,39,13.0,39,3,0,1,NO
1,src/java/main/org/apache/jute/InputArchive.java,45,46,15.333333,46,1,0.33333334,1,47,15.666667,47,45,15.0,45,3,0,1,NO
1,src/java/main/org/apache/jute/OutputArchive.java,48,49,16.333334,49,1,0.33333334,1,50,16.666666,50,48,16.0,48,3,0,1,NO
1,src/java/main/org/apache/jute/Record.java,33,34,11.333333,34,1,0.33333334,1,35,11.666667,35,33,11.0,33,3,0,1,NO
1,src/java/main/org/apache/jute/RecordReader.java,98,99,33.0,99,1,0.33333334,1,100,33.333332,100,98,32.666668,98,3,0,1,NO
1,src/java/main/org/apache/jute/RecordWriter.java,117,118,39.333332,118,1,0.33333334,1,119,39.666668,119,117,39.0,117,3,0,1,NO
1,src/java/main/org/apache/jute/Utils.java,278,281,70.25,281,3,0.75,3,284,71.0,284,278,69.5,278,4,0,2,YES
1,src/java/main/org/apache/jute/XmlInputArchive.java,251,252,84.0,252,1,0.33333334,1,253,84.333336,253,251,83.666664,251,3,0,1,NO
1,src/java/main/org/apache/jute/XmlOutputArchive.java,252,253,84.333336,253,1,0.33333334,1,254,84.666664,254,252,84.0,252,3,0,1,NO
1,src/java/main/org/apache/jute/compiler/CGenerator.java,88,92,30.666666,92,4,1.3333334,4,96,32.0,96,88,29.333334,88,3,0,1,NO
1,src/java/main/org/apache/jute/compiler/CppGenerator.java,83,87,21.75,87,4,1.0,4,91,22.75,91,83,20.75,83,4,0,1,NO
1,src/java/main/org/apache/jute/compiler/JBoolean.java,43,44,14.666667,44,1,0.33333334,1,45,15.0,45,43,14.333333,43,3,0,1,NO
1,src/java/main/org/apache/jute/compiler/JBuffer.java,107,114,38.0,114,7,2.3333333,7,121,40.333332,121,107,35.666668,107,3,0,1,NO
1,src/java/main/org/apache/jute/compiler/JByte.java,35,36,12.0,36,1,0.33333334,1,37,12.333333,37,35,11.666667,35,3,0,1,NO
1,src/java/main/org/apache/jute/compiler/JCompType.java,55,56,18.666666,56,1,0.33333334,1,57,19.0,57,55,18.333334,55,3,0,1,NO
1,src/java/main/org/apache/jute/compiler/JDouble.java,41,42,14.0,42,1,0.33333334,1,43,14.333333,43,41,13.666667,41,3,0,1,NO
1,src/java/main/org/apache/jute/compiler/JField.java,99,100,33.333332,100,1,0.33333334,1,101,33.666668,101,99,33.0,99,3,0,1,NO
1,src/java/main/org/apache/jute/compiler/JFile.java,75,80,20.0,80,5,1.25,5,85,21.25,85,75,18.75,75,4,0,1,NO
1,src/java/main/org/apache/jute/compiler/JFloat.java,40,41,13.666667,41,1,0.33333334,1,42,14.0,42,40,13.333333,40,3,0,1,NO
1,src/java/main/org/apache/jute/compiler/JInt.java,35,36,12.0,36,1,0.33333334,1,37,12.333333,37,35,11.666667,35,3,0,1,NO
1,src/java/main/org/apache/jute/compiler/JLong.java,39,40,13.333333,40,1,0.33333334,1,41,13.666667,41,39,13.0,39,3,0,1,NO
1,src/java/main/org/apache/jute/compiler/JMap.java,101,103,34.333332,103,2,0.6666667,2,105,35.0,105,101,33.666668,101,3,0,1,NO
1,src/java/main/org/apache/jute/compiler/JRecord.java,508,512,128.0,512,4,1.0,4,516,129.0,516,508,127.0,508,4,0,1,NO
1,src/java/main/org/apache/jute/compiler/JString.java,47,48,16.0,48,1,0.33333334,1,49,16.333334,49,47,15.666667,47,3,0,1,NO
1,src/java/main/org/apache/jute/compiler/JType.java,142,143,47.666668,143,1,0.33333334,1,144,48.0,144,142,47.333332,142,3,0,1,NO
1,src/java/main/org/apache/jute/compiler/JVector.java,106,107,35.666668,107,1,0.33333334,1,108,36.0,108,106,35.333332,106,3,0,1,NO
1,src/java/main/org/apache/jute/compiler/JavaGenerator.java,62,65,16.25,65,3,0.75,3,68,17.0,68,62,15.5,62,4,0,1,NO
1,src/java/main/org/apache/jute/compiler/generated/ParseException.java,210,211,70.333336,211,1,0.33333334,1,212,70.666664,212,210,70.0,210,3,0,1,NO
1,src/java/main/org/apache/jute/compiler/generated/Rcc.java,525,550,137.5,550,25,6.25,25,575,143.75,575,525,131.25,525,4,0,1,NO
1,src/java/main/org/apache/jute/compiler/generated/RccConstants.java,88,89,29.666666,89,1,0.33333334,1,90,30.0,90,88,29.333334,88,3,0,1,NO
1,src/java/main/org/apache/jute/compiler/generated/RccTokenManager.java,833,835,278.33334,835,2,0.6666667,2,837,279.0,837,833,277.66666,833,3,0,1,NO
1,src/java/main/org/apache/jute/compiler/generated/SimpleCharStream.java,457,458,152.66667,458,1,0.33333334,1,459,153.0,459,457,152.33333,457,3,0,1,NO
1,src/java/main/org/apache/jute/compiler/generated/Token.java,99,100,33.333332,100,1,0.33333334,1,101,33.666668,101,99,33.0,99,3,0,1,NO
1,src/java/main/org/apache/jute/compiler/generated/TokenMgrError.java,151,152,50.666668,152,1,0.33333334,1,153,51.0,153,151,50.333332,151,3,0,1,NO
1,src/java/main/org/apache/zookeeper/AsyncCallback.java,52,61,20.333334,61,9,3.0,9,70,23.333334,70,52,17.333334,52,3,0,1,NO
1,src/java/main/org/apache/zookeeper/ClientCnxn.java,1031,1220,71.76471,1220,189,11.117647,189,1409,82.882355,1409,1035,60.882355,1035,17,0,4,YES
1,src/java/main/org/apache/zookeeper/ClientWatchManager.java,39,44,14.666667,44,5,1.6666666,5,49,16.333334,49,45,15.0,45,3,0,2,NO
1,src/java/main/org/apache/zookeeper/CreateMode.java,89,89,89.0,89,0,0.0,0,89,89.0,89,89,89.0,89,1,0,1,NO
1,src/java/main/org/apache/zookeeper/KeeperException.java,336,343,85.75,343,7,1.75,7,350,87.5,350,336,84.0,336,4,0,1,YES
1,src/java/main/org/apache/zookeeper/ServerAdminClient.java,312,603,120.6,603,291,58.2,291,894,178.8,894,312,62.4,312,5,0,2,NO
1,src/java/main/org/apache/zookeeper/Version.java,78,87,29.0,87,9,3.0,9,96,32.0,96,78,26.0,78,3,0,1,NO
1,src/java/main/org/apache/zookeeper/WatchedEvent.java,81,83,41.5,83,2,1.0,2,85,42.5,85,81,40.5,81,2,0,1,NO
1,src/java/main/org/apache/zookeeper/Watcher.java,107,134,22.333334,134,27,4.5,27,161,26.833334,161,111,18.5,111,6,0,1,NO
1,src/java/main/org/apache/zookeeper/ZooDefs.java,112,127,21.166666,127,15,2.5,15,142,23.666666,142,124,20.666666,124,6,0,2,NO
1,src/java/main/org/apache/zookeeper/ZooKeeper.java,1030,1558,86.55556,1558,528,29.333334,528,2086,115.888885,2086,1440,80.0,1440,18,0,3,YES
1,src/java/main/org/apache/zookeeper/ZooKeeperMain.java,232,246,41.0,246,14,2.3333333,14,260,43.333332,260,236,39.333332,236,6,0,2,NO
1,src/java/main/org/apache/zookeeper/server/ByteBufferInputStream.java,72,79,26.333334,79,7,2.3333333,7,86,28.666666,86,72,24.0,72,3,0,1,NO
1,src/java/main/org/apache/zookeeper/server/DataNode.java,125,164,18.222221,164,39,4.3333335,39,203,22.555555,203,149,16.555555,149,9,0,3,NO
1,src/java/main/org/apache/zookeeper/server/DataTree.java,798,865,61.785713,865,67,4.785714,67,932,66.57143,932,806,57.57143,806,14,0,3,YES
1,src/java/main/org/apache/zookeeper/server/FinalRequestProcessor.java,265,305,33.88889,305,40,4.4444447,40,345,38.333332,345,267,29.666666,267,9,0,4,NO
1,src/java/main/org/apache/zookeeper/server/LogFormatter.java,72,84,21.0,84,12,3.0,12,96,24.0,96,72,18.0,72,4,0,2,NO
1,src/java/main/org/apache/zookeeper/server/NIOServerCnxn.java,873,1767,160.63637,1767,894,81.27273,894,2661,241.90909,2661,873,79.36364,873,11,0,4,YES
1,src/java/main/org/apache/zookeeper/server/PrepRequestProcessor.java,460,509,42.416668,509,49,4.0833335,49,558,46.5,558,466,38.833332,466,12,0,4,NO
1,src/java/main/org/apache/zookeeper/server/PurgeTxnLog.java,94,208,41.6,208,114,22.8,114,322,64.4,322,94,18.8,94,5,0,2,YES
1,src/java/main/org/apache/zookeeper/server/Request.java,197,224,32.0,224,27,3.857143,27,251,35.857143,251,199,28.428572,199,7,0,4,NO
1,src/java/main/org/apache/zookeeper/server/RequestProcessor.java,37,44,14.666667,44,7,2.3333333,7,51,17.0,51,37,12.333333,37,3,0,1,NO
1,src/java/main/org/apache/zookeeper/server/ServerCnxn.java,78,91,18.2,91,13,2.6,13,104,20.8,104,78,15.6,78,5,0,1,YES
1,src/java/main/org/apache/zookeeper/server/ServerConfig.java,69,104,26.0,104,35,8.75,35,139,34.75,139,69,17.25,69,4,0,1,NO
1,src/java/main/org/apache/zookeeper/server/ServerStats.java,140,148,37.0,148,8,2.0,8,156,39.0,156,140,35.0,140,4,0,2,NO
1,src/java/main/org/apache/zookeeper/server/SessionTracker.java,58,66,22.0,66,8,2.6666667,8,74,24.666666,74,58,19.333334,58,3,0,1,NO
1,src/java/main/org/apache/zookeeper/server/SessionTrackerImpl.java,219,240,48.0,240,21,4.2,21,261,52.2,261,225,45.0,225,5,0,3,NO
1,src/java/main/org/apache/zookeeper/server/SyncRequestProcessor.java,132,584,73.0,584,452,56.5,452,1036,129.5,1036,434,54.25,434,8,0,4,NO
1,src/java/main/org/apache/zookeeper/server/TraceFormatter.java,119,129,32.25,129,10,2.5,10,139,34.75,139,119,29.75,119,4,0,2,NO
1,src/java/main/org/apache/zookeeper/server/WatchManager.java,113,131,26.2,131,18,3.6,18,149,29.8,149,113,22.6,113,5,0,1,NO
1,src/java/main/org/apache/zookeeper/server/ZooKeeperServer.java,610,1208,100.666664,1208,598,49.833332,598,1806,150.5,1806,1370,114.166664,1370,12,0,4,NO
1,src/java/main/org/apache/zookeeper/server/ZooKeeperServerMain.java,80,84,42.0,84,4,2.0,4,88,44.0,88,80,40.0,80,2,0,2,NO
1,src/java/main/org/apache/zookeeper/server/ZooTrace.java,92,193,38.6,193,101,20.2,101,294,58.8,294,92,18.4,92,5,0,2,NO
1,src/java/main/org/apache/zookeeper/server/auth/AuthenticationProvider.java,81,89,29.666666,89,8,2.6666667,8,97,32.333332,97,81,27.0,81,3,0,1,NO
1,src/java/main/org/apache/zookeeper/server/auth/DigestAuthenticationProvider.java,127,264,66.0,264,137,34.25,137,401,100.25,401,127,31.75,127,4,0,1,NO
1,src/java/main/org/apache/zookeeper/server/auth/HostAuthenticationProvider.java,67,77,25.666666,77,10,3.3333333,10,87,29.0,87,67,22.333334,67,3,0,1,NO
1,src/java/main/org/apache/zookeeper/server/auth/IPAuthenticationProvider.java,115,125,41.666668,125,10,3.3333333,10,135,45.0,135,115,38.333332,115,3,0,1,NO
1,src/java/main/org/apache/zookeeper/server/auth/ProviderRegistry.java,78,157,31.4,157,79,15.8,79,236,47.2,236,78,15.6,78,5,0,2,NO
1,src/java/main/org/apache/zookeeper/server/persistence/FileSnap.java,159,170,34.0,170,11,2.2,11,181,36.2,181,159,31.8,159,5,0,3,YES
1,src/java/main/org/apache/zookeeper/server/persistence/FileTxnLog.java,485,491,122.75,491,6,1.5,6,497,124.25,497,485,121.25,485,4,0,2,YES
1,src/java/main/org/apache/zookeeper/server/persistence/FileTxnSnapLog.java,246,254,63.5,254,8,2.0,8,262,65.5,262,246,61.5,246,4,0,3,YES
1,src/java/main/org/apache/zookeeper/server/persistence/SnapShot.java,60,61,30.5,61,1,0.5,1,62,31.0,62,60,30.0,60,2,0,2,NO
1,src/java/main/org/apache/zookeeper/server/persistence/TxnLog.java,114,115,115.0,115,0,0.0,0,115,115.0,115,115,115.0,115,1,0,1,NO
1,src/java/main/org/apache/zookeeper/server/persistence/Util.java,305,337,112.333336,337,32,10.666667,32,369,123.0,369,367,122.333336,367,3,0,3,YES
1,src/java/main/org/apache/zookeeper/server/quorum/AckRequestProcessor.java,45,54,18.0,54,9,3.0,9,63,21.0,63,45,15.0,45,3,0,1,NO
1,src/java/main/org/apache/zookeeper/server/quorum/AuthFastLeaderElection.java,898,1850,231.25,1850,952,119.0,952,2802,350.25,2802,922,115.25,922,8,0,3,NO
1,src/java/main/org/apache/zookeeper/server/quorum/CommitProcessor.java,189,393,56.142857,393,204,29.142857,204,597,85.28571,597,197,28.142857,197,7,0,4,YES
1,src/java/main/org/apache/zookeeper/server/quorum/Election.java,26,29,7.25,29,3,0.75,3,32,8.0,32,26,6.5,26,4,0,2,NO
1,src/java/main/org/apache/zookeeper/server/quorum/FastLeaderElection.java,626,771,70.09091,771,145,13.181818,145,916,83.27273,916,668,60.727272,668,11,0,4,NO
1,src/java/main/org/apache/zookeeper/server/quorum/Follower.java,378,786,87.333336,786,408,45.333332,408,1194,132.66667,1194,378,42.0,378,9,0,3,NO
1,src/java/main/org/apache/zookeeper/server/quorum/FollowerHandler.java,395,824,91.55556,824,429,47.666668,429,1253,139.22223,1253,397,44.11111,397,9,0,4,NO
1,src/java/main/org/apache/zookeeper/server/quorum/FollowerRequestProcessor.java,107,119,17.0,119,12,1.7142857,12,131,18.714285,131,107,15.285714,107,7,0,4,NO
1,src/java/main/org/apache/zookeeper/server/quorum/FollowerSessionTracker.java,85,94,31.333334,94,9,3.0,9,103,34.333332,103,85,28.333334,85,3,0,1,NO
1,src/java/main/org/apache/zookeeper/server/quorum/FollowerSyncRequest.java,34,34,17.0,34,0,0.0,0,34,17.0,34,34,17.0,34,2,0,2,NO
1,src/java/main/org/apache/zookeeper/server/quorum/FollowerZooKeeperServer.java,177,209,23.222221,209,32,3.5555556,32,241,26.777779,241,185,20.555555,185,9,0,4,NO
1,src/java/main/org/apache/zookeeper/server/quorum/Leader.java,633,735,81.666664,735,102,11.333333,102,837,93.0,837,637,70.77778,637,9,0,4,NO
1,src/java/main/org/apache/zookeeper/server/quorum/LeaderElection.java,194,215,30.714285,215,21,3.0,21,236,33.714287,236,194,27.714285,194,7,0,3,NO
1,src/java/main/org/apache/zookeeper/server/quorum/LeaderZooKeeperServer.java,88,106,17.666666,106,18,3.0,18,124,20.666666,124,88,14.666667,88,6,0,3,NO
1,src/java/main/org/apache/zookeeper/server/quorum/ProposalRequestProcessor.java,76,102,20.4,102,26,5.2,26,128,25.6,128,90,18.0,90,5,0,3,NO
1,src/java/main/org/apache/zookeeper/server/quorum/QuorumCnxManager.java,564,768,128.0,768,204,34.0,204,972,162.0,972,694,115.666664,694,6,0,3,NO
1,src/java/main/org/apache/zookeeper/server/quorum/QuorumPeer.java,590,1511,107.92857,1511,921,65.78571,921,2432,173.71428,2432,768,54.857143,768,14,0,4,YES
1,src/java/main/org/apache/zookeeper/server/quorum/QuorumPeerConfig.java,230,470,58.75,470,240,30.0,240,710,88.75,710,232,29.0,232,8,0,2,NO
1,src/java/main/org/apache/zookeeper/server/quorum/QuorumPeerMain.java,110,117,39.0,117,7,2.3333333,7,124,41.333332,124,114,38.0,114,3,0,2,NO
1,src/java/main/org/apache/zookeeper/server/quorum/QuorumStats.java,81,115,23.0,115,34,6.8,34,149,29.8,149,81,16.2,81,5,0,2,NO
1,src/java/main/org/apache/zookeeper/server/quorum/SendAckRequestProcessor.java,54,64,21.333334,64,10,3.3333333,10,74,24.666666,74,54,18.0,54,3,0,1,NO
1,src/java/main/org/apache/zookeeper/server/quorum/Vote.java,69,77,15.4,77,8,1.6,8,85,17.0,85,69,13.8,69,5,0,2,NO
1,src/java/main/org/apache/zookeeper/server/upgrade/DataNodeV1.java,129,129,129.0,129,0,0.0,0,129,129.0,129,129,129.0,129,1,0,1,NO
1,src/java/main/org/apache/zookeeper/server/upgrade/DataTreeV1.java,582,582,582.0,582,0,0.0,0,582,582.0,582,582,582.0,582,1,0,1,NO
1,src/java/main/org/apache/zookeeper/server/upgrade/UpgradeMain.java,181,181,181.0,181,0,0.0,0,181,181.0,181,181,181.0,181,1,0,1,NO
1,src/java/main/org/apache/zookeeper/server/upgrade/UpgradeSnapShot.java,33,33,33.0,33,0,0.0,0,33,33.0,33,33,33.0,33,1,0,1,NO
1,src/java/main/org/apache/zookeeper/server/upgrade/UpgradeSnapShotV1.java,323,323,323.0,323,0,0.0,0,323,323.0,323,323,323.0,323,1,0,1,YES
1,src/java/main/org/apache/zookeeper/server/util/Profiler.java,40,87,21.75,87,47,11.75,47,134,33.5,134,40,10.0,40,4,0,1,NO
1,src/java/main/org/apache/zookeeper/server/util/SerializeUtils.java,105,105,105.0,105,0,0.0,0,105,105.0,105,105,105.0,105,1,0,1,NO
1,src/java/main/org/apache/zookeeper/version/util/VerGen.java,120,167,27.833334,167,47,7.8333335,47,214,35.666668,214,120,20.0,120,6,0,2,YES
2,src/java/jmx/org/apache/zookeeper/jmx/CommonNames.java,29,0,0.0,0,0,0.0,0,0,0.0,0,0,0.0,0,0,0,0,NO
2,src/java/jmx/org/apache/zookeeper/jmx/MBeanRegistry.java,175,0,0.0,0,0,0.0,0,0,0.0,0,0,0.0,0,0,0,0,NO
2,src/java/jmx/org/apache/zookeeper/jmx/ZKMBeanInfo.java,36,0,0.0,0,0,0.0,0,0,0.0,0,0,0.0,0,0,0,0,NO
2,src/java/jmx/org/apache/zookeeper/jmx/server/ConnectionBean.java,112,0,0.0,0,0,0.0,0,0,0.0,0,0,0.0,0,0,0,0,NO
2,src/java/jmx/org/apache/zookeeper/jmx/server/ConnectionMXBean.java,68,0,0.0,0,0,0.0,0,0,0.0,0,0,0.0,0,0,0,0,NO
2,src/java/jmx/org/apache/zookeeper/jmx/server/DataTreeBean.java,88,0,0.0,0,0,0.0,0,0,0.0,0,0,0.0,0,0,0,0,NO
2,src/java/jmx/org/apache/zookeeper/jmx/server/DataTreeMXBean.java,46,0,0.0,0,0,0.0,0,0,0.0,0,0,0.0,0,0,0,0,NO
2,src/java/jmx/org/apache/zookeeper/jmx/server/ZooKeeperServerBean.java,117,0,0.0,0,0,0.0,0,0,0.0,0,0,0.0,0,0,0,0,NO
2,src/java/jmx/org/apache/zookeeper/jmx/server/ZooKeeperServerMXBean.java,74,0,0.0,0,0,0.0,0,0,0.0,0,0,0.0,0,0,0,0,NO
2,src/java/jmx/org/apache/zookeeper/jmx/server/quorum/FollowerBean.java,28,0,0.0,0,0,0.0,0,0,0.0,0,0,0.0,0,0,0,0,NO
2,src/java/jmx/org/apache/zookeeper/jmx/server/quorum/FollowerMXBean.java,26,0,0.0,0,0,0.0,0,0,0.0,0,0,0.0,0,0,0,0,NO
2,src/java/jmx/org/apache/zookeeper/jmx/server/quorum/LeaderBean.java,29,0,0.0,0,0,0.0,0,0,0.0,0,0,0.0,0,0,0,0,NO
2,src/java/jmx/org/apache/zookeeper/jmx/server/quorum/LeaderElectionBean.java,43,0,0.0,0,0,0.0,0,0,0.0,0,0,0.0,0,0,0,0,NO
2,src/java/jmx/org/apache/zookeeper/jmx/server/quorum/LeaderElectionMXBean.java,34,0,0.0,0,0,0.0,0,0,0.0,0,0,0.0,0,0,0,0,NO
2,src/java/jmx/org/apache/zookeeper/jmx/server/quorum/LeaderMXBean.java,26,0,0.0,0,0,0.0,0,0,0.0,0,0,0.0,0,0,0,0,NO
2,src/java/jmx/org/apache/zookeeper/jmx/server/quorum/LocalPeerBean.java,53,0,0.0,0,0,0.0,0,0,0.0,0,0,0.0,0,0,0,0,NO
2,src/java/jmx/org/apache/zookeeper/jmx/server/quorum/LocalPeerMXBean.java,34,0,0.0,0,0,0.0,0,0,0.0,0,0,0.0,0,0,0,0,NO
2,src/java/jmx/org/apache/zookeeper/jmx/server/quorum/QuorumBean.java,44,0,0.0,0,0,0.0,0,0,0.0,0,0,0.0,0,0,0,0,NO
2,src/java/jmx/org/apache/zookeeper/jmx/server/quorum/QuorumMXBean.java,33,0,0.0,0,0,0.0,0,0,0.0,0,0,0.0,0,0,0,0,NO
2,src/java/jmx/org/apache/zookeeper/jmx/server/quorum/RemotePeerBean.java,45,0,0.0,0,0,0.0,0,0,0.0,0,0,0.0,0,0,0,0,NO
2,src/java/jmx/org/apache/zookeeper/jmx/server/quorum/RemotePeerMXBean.java,33,0,0.0,0,0,0.0,0,0,0.0,0,0,0.0,0,0,0,0,NO
2,src/java/jmx/org/apache/zookeeper/jmx/server/quorum/ServerBean.java,38,0,0.0,0,0,0.0,0,0,0.0,0,0,0.0,0,0,0,0,NO
2,src/java/jmx/org/apache/zookeeper/jmx/server/quorum/ServerMXBean.java,33,0,0.0,0,0,0.0,0,0,0.0,0,0,0.0,0,0,0,0,NO
2,src/java/jmx/org/apache/zookeeper/server/ManagedZooKeeperServer.java,125,0,0.0,0,0,0.0,0,0,0.0,0,0,0.0,0,0,0,0,NO
2,src/java/jmx/org/apache/zookeeper/server/ManagedZooKeeperServerMain.java,86,8,8.0,8,1,1.0,1,9,9.0,9,7,7.0,7,1,0,1,NO
2,src/java/jmx/org/apache/zookeeper/server/ObservableDataTree.java,115,0,0.0,0,0,0.0,0,0,0.0,0,0,0.0,0,0,0,0,NO
2,src/java/jmx/org/apache/zookeeper/server/ObservableNIOServerCnxn.java,85,0,0.0,0,0,0.0,0,0,0.0,0,0,0.0,0,0,0,0,NO
2,src/java/jmx/org/apache/zookeeper/server/ObservableZooKeeperServer.java,56,0,0.0,0,0,0.0,0,0,0.0,0,0,0.0,0,0,0,0,NO
2,src/java/jmx/org/apache/zookeeper/server/ZooKeeperObserverNotifier.java,76,0,0.0,0,0,0.0,0,0,0.0,0,0,0.0,0,0,0,0,NO
2,src/java/jmx/org/apache/zookeeper/server/quorum/ManagedQuorumPeer.java,225,0,0.0,0,0,0.0,0,0,0.0,0,0,0.0,0,0,0,0,NO
2,src/java/jmx/org/apache/zookeeper/server/quorum/ManagedQuorumPeerMain.java,137,6,6.0,6,1,1.0,1,7,7.0,7,5,5.0,5,1,0,1,NO
2,src/java/jmx/org/apache/zookeeper/server/quorum/ObservableFollower.java,78,0,0.0,0,0,0.0,0,0,0.0,0,0,0.0,0,0,0,0,NO
2,src/java/jmx/org/apache/zookeeper/server/quorum/ObservableFollowerZooKeeperServer.java,55,0,0.0,0,0,0.0,0,0,0.0,0,0,0.0,0,0,0,0,NO
2,src/java/jmx/org/apache/zookeeper/server/quorum/ObservableLeader.java,82,0,0.0,0,0,0.0,0,0,0.0,0,0,0.0,0,0,0,0,NO
2,src/java/jmx/org/apache/zookeeper/server/quorum/ObservableLeaderZooKeeperServer.java,55,0,0.0,0,0,0.0,0,0,0.0,0,0,0.0,0,0,0,0,NO
2,src/java/jmx/org/apache/zookeeper/server/quorum/ObservableQuorumPeer.java,115,0,0.0,0,0,0.0,0,0,0.0,0,0,0.0,0,0,0,0,NO
2,src/java/jmx/org/apache/zookeeper/server/util/ConnectionObserver.java,38,0,0.0,0,0,0.0,0,0,0.0,0,0,0.0,0,0,0,0,NO
2,src/java/jmx/org/apache/zookeeper/server/util/DataTreeObserver.java,53,0,0.0,0,0,0.0,0,0,0.0,0,0,0.0,0,0,0,0,NO
2,src/java/jmx/org/apache/zookeeper/server/util/EventInfo.java,30,0,0.0,0,0,0.0,0,0,0.0,0,0,0.0,0,0,0,0,NO
2,src/java/jmx/org/apache/zookeeper/server/util/ObservableComponent.java,34,0,0.0,0,0,0.0,0,0,0.0,0,0,0.0,0,0,0,0,NO
2,src/java/jmx/org/apache/zookeeper/server/util/ObserverManager.java,95,0,0.0,0,0,0.0,0,0,0.0,0,0,0.0,0,0,0,0,NO
2,src/java/jmx/org/apache/zookeeper/server/util/QuorumPeerObserver.java,69,0,0.0,0,0,0.0,0,0,0.0,0,0,0.0,0,0,0,0,NO
2,src/java/jmx/org/apache/zookeeper/server/util/ServerObserver.java,38,0,0.0,0,0,0.0,0,0,0.0,0,0,0.0,0,0,0,0,NO
2,src/java/jmx/org/apache/zookeeper/server/util/ZooKeeperObserverManager.java,61,0,0.0,0,0,0.0,0,0,0.0,0,0,0.0,0,0,0,0,NO
2,src/java/main/org/apache/jute/BinaryInputArchive.java,132,0,0.0,0,0,0.0,0,0,0.0,0,0,0.0,0,0,0,0,NO
2,src/java/main/org/apache/jute/BinaryOutputArchive.java,149,0,0.0,0,0,0.0,0,0,0.0,0,0,0.0,0,0,0,0,NO
2,src/java/main/org/apache/jute/CsvInputArchive.java,210,0,0.0,0,0,0.0,0,0,0.0,0,0,0.0,0,0,0,0,NO
2,src/java/main/org/apache/jute/CsvOutputArchive.java,151,0,0.0,0,0,0.0,0,0,0.0,0,0,0.0,0,0,0,0,NO
2,src/java/main/org/apache/jute/Index.java,39,0,0.0,0,0,0.0,0,0,0.0,0,0,0.0,0,0,0,0,NO
2,src/java/main/org/apache/jute/InputArchive.java,45,0,0.0,0,0,0.0,0,0,0.0,0,0,0.0,0,0,0,0,NO
2,src/java/main/org/apache/jute/OutputArchive.java,48,0,0.0,0,0,0.0,0,0,0.0,0,0,0.0,0,0,0,0,NO
2,src/java/main/org/apache/jute/Record.java,33,0,0.0,0,0,0.0,0,0,0.0,0,0,0.0,0,0,0,0,NO
2,src/java/main/org/apache/jute/RecordReader.java,98,0,0.0,0,0,0.0,0,0,0.0,0,0,0.0,0,0,0,0,NO
2,src/java/main/org/apache/jute/RecordWriter.java,117,0,0.0,0,0,0.0,0,0,0.0,0,0,0.0,0,0,0,0,NO
2,src/java/main/org/apache/jute/Utils.java,278,0,0.0,0,0,0.0,0,0,0.0,0,0,0.0,0,0,0,0,YES
2,src/java/main/org/apache/jute/XmlInputArchive.java,251,0,0.0,0,0,0.0,0,0,0.0,0,0,0.0,0,0,0,0,NO
2,src/java/main/org/apache/jute/XmlOutputArchive.java,252,0,0.0,0,0,0.0,0,0,0.0,0,0,0.0,0,0,0,0,NO
2,src/java/main/org/apache/jute/compiler/CGenerator.java,88,0,0.0,0,0,0.0,0,0,0.0,0,0,0.0,0,0,0,0,NO
2,src/java/main/org/apache/jute/compiler/CppGenerator.java,83,0,0.0,0,0,0.0,0,0,0.0,0,0,0.0,0,0,0,0,NO
2,src/java/main/org/apache/jute/compiler/JBoolean.java,43,0,0.0,0,0,0.0,0,0,0.0,0,0,0.0,0,0,0,0,NO
2,src/java/main/org/apache/jute/compiler/JBuffer.java,107,0,0.0,0,0,0.0,0,0,0.0,0,0,0.0,0,0,0,0,NO
2,src/java/main/org/apache/jute/compiler/JByte.java,35,0,0.0,0,0,0.0,0,0,0.0,0,0,0.0,0,0,0,0,NO
2,src/java/main/org/apache/jute/compiler/JCompType.java,55,0,0.0,0,0,0.0,0,0,0.0,0,0,0.0,0,0,0,0,NO
2,src/java/main/org/apache/jute/compiler/JDouble.java,41,0,0.0,0,0,0.0,0,0,0.0,0,0,0.0,0,0,0,0,NO
2,src/java/main/org/apache/jute/compiler/JField.java,99,0,0.0,0,0,0.0,0,0,0.0,0,0,0.0,0,0,0,0,NO
2,src/java/main/org/apache/jute/compiler/JFile.java,75,0,0.0,0,0,0.0,0,0,0.0,0,0,0.0,0,0,0,0,NO
2,src/java/main/org/apache/jute/compiler/JFloat.java,40,0,0.0,0,0,0.0,0,0,0.0,0,0,0.0,0,0,0,0,NO
2,src/java/main/org/apache/jute/compiler/JInt.java,35,0,0.0,0,0,0.0,0,0,0.0,0,0,0.0,0,0,0,0,NO
2,src/java/main/org/apache/jute/compiler/JLong.java,39,0,0.0,0,0,0.0,0,0,0.0,0,0,0.0,0,0,0,0,NO
2,src/java/main/org/apache/jute/compiler/JMap.java,101,0,0.0,0,0,0.0,0,0,0.0,0,0,0.0,0,0,0,0,NO
2,src/java/main/org/apache/jute/compiler/JRecord.java,508,0,0.0,0,0,0.0,0,0,0.0,0,0,0.0,0,0,0,0,NO
2,src/java/main/org/apache/jute/compiler/JString.java,47,0,0.0,0,0,0.0,0,0,0.0,0,0,0.0,0,0,0,0,NO
2,src/java/main/org/apache/jute/compiler/JType.java,142,0,0.0,0,0,0.0,0,0,0.0,0,0,0.0,0,0,0,0,NO
2,src/java/main/org/apache/jute/compiler/JVector.java,106,0,0.0,0,0,0.0,0,0,0.0,0,0,0.0,0,0,0,0,NO
2,src/java/main/org/apache/jute/compiler/JavaGenerator.java,62,0,0.0,0,0,0.0,0,0,0.0,0,0,0.0,0,0,0,0,NO
2,src/java/main/org/apache/jute/compiler/generated/ParseException.java,210,0,0.0,0,0,0.0,0,0,0.0,0,0,0.0,0,0,0,0,NO
2,src/java/main/org/apache/jute/compiler/generated/Rcc.java,525,0,0.0,0,0,0.0,0,0,0.0,0,0,0.0,0,0,0,0,NO
2,src/java/main/org/apache/jute/compiler/generated/RccConstants.java,88,0,0.0,0,0,0.0,0,0,0.0,0,0,0.0,0,0,0,0,NO
2,src/java/main/org/apache/jute/compiler/generated/RccTokenManager.java,833,0,0.0,0,0,0.0,0,0,0.0,0,0,0.0,0,0,0,0,NO
2,src/java/main/org/apache/jute/compiler/generated/SimpleCharStream.java,457,0,0.0,0,0,0.0,0,0,0.0,0,0,0.0,0,0,0,0,NO
2,src/java/main/org/apache/jute/compiler/generated/Token.java,99,0,0.0,0,0,0.0,0,0,0.0,0,0,0.0,0,0,0,0,NO
2,src/java/main/org/apache/jute/compiler/generated/TokenMgrError.java,151,0,0.0,0,0,0.0,0,0,0.0,0,0,0.0,0,0,0,0,NO
2,src/java/main/org/apache/zookeeper/AsyncCallback.java,52,0,0.0,0,0,0.0,0,0,0.0,0,0,0.0,0,0,0,0,NO
2,src/java/main/org/apache/zookeeper/ClientCnxn.java,1045,98,98.0,98,84,84.0,84,182,182.0,182,14,14.0,14,1,0,1,YES
2,src/java/main/org/apache/zookeeper/ClientWatchManager.java,39,0,0.0,0,0,0.0,0,0,0.0,0,0,0.0,0,0,0,0,NO
2,src/java/main/org/apache/zookeeper/CreateMode.java,89,0,0.0,0,0,0.0,0,0,0.0,0,0,0.0,0,0,0,0,NO
2,src/java/main/org/apache/zookeeper/Environment.java,100,100,100.0,100,0,0.0,0,100,100.0,100,100,100.0,100,1,0,1,NO
2,src/java/main/org/apache/zookeeper/KeeperException.java,336,0,0.0,0,0,0.0,0,0,0.0,0,0,0.0,0,0,0,0,YES
2,src/java/main/org/apache/zookeeper/ServerAdminClient.java,312,0,0.0,0,0,0.0,0,0,0.0,0,0,0.0,0,0,0,0,NO
2,src/java/main/org/apache/zookeeper/Version.java,78,0,0.0,0,0,0.0,0,0,0.0,0,0,0.0,0,0,0,0,NO
2,src/java/main/org/apache/zookeeper/WatchedEvent.java,81,0,0.0,0,0,0.0,0,0,0.0,0,0,0.0,0,0,0,0,NO
2,src/java/main/org/apache/zookeeper/Watcher.java,107,0,0.0,0,0,0.0,0,0,0.0,0,0,0.0,0,0,0,0,NO
2,src/java/main/org/apache/zookeeper/ZooDefs.java,112,0,0.0,0,0,0.0,0,0,0.0,0,0,0.0,0,0,0,0,NO
2,src/java/main/org/apache/zookeeper/ZooKeeper.java,1040,13,6.5,13,3,1.5,3,16,8.0,16,10,5.0,10,2,0,1,YES
2,src/java/main/org/apache/zookeeper/ZooKeeperMain.java,232,0,0.0,0,0,0.0,0,0,0.0,0,0,0.0,0,0,0,0,NO
2,src/java/main/org/apache/zookeeper/server/ByteBufferInputStream.java,72,0,0.0,0,0,0.0,0,0,0.0,0,0,0.0,0,0,0,0,NO
2,src/java/main/org/apache/zookeeper/server/DataNode.java,125,1,1.0,1,1,1.0,1,2,2.0,2,0,0.0,0,1,1,1,NO
2,src/java/main/org/apache/zookeeper/server/DataTree.java,798,0,0.0,0,0,0.0,0,0,0.0,0,0,0.0,0,0,0,0,YES
2,src/java/main/org/apache/zookeeper/server/FinalRequestProcessor.java,265,0,0.0,0,0,0.0,0,0,0.0,0,0,0.0,0,0,0,0,NO
2,src/java/main/org/apache/zookeeper/server/LogFormatter.java,72,0,0.0,0,0,0.0,0,0,0.0,0,0,0.0,0,0,0,0,NO
2,src/java/main/org/apache/zookeeper/server/NIOServerCnxn.java,888,18,18.0,18,3,3.0,3,21,21.0,21,15,15.0,15,1,0,1,YES
2,src/java/main/org/apache/zookeeper/server/PrepRequestProcessor.java,460,0,0.0,0,0,0.0,0,0,0.0,0,0,0.0,0,0,0,0,NO
2,src/java/main/org/apache/zookeeper/server/PurgeTxnLog.java,94,0,0.0,0,0,0.0,0,0,0.0,0,0,0.0,0,0,0,0,YES
2,src/java/main/org/apache/zookeeper/server/Request.java,197,0,0.0,0,0,0.0,0,0,0.0,0,0,0.0,0,0,0,0,NO
2,src/java/main/org/apache/zookeeper/server/RequestProcessor.java,37,0,0.0,0,0,0.0,0,0,0.0,0,0,0.0,0,0,0,0,NO
2,src/java/main/org/apache/zookeeper/server/ServerCnxn.java,80,2,2.0,2,0,0.0,0,2,2.0,2,2,2.0,2,1,0,1,YES
2,src/java/main/org/apache/zookeeper/server/ServerConfig.java,67,3,3.0,3,5,5.0,5,8,8.0,8,2,2.0,2,1,0,1,NO
2,src/java/main/org/apache/zookeeper/server/ServerStats.java,140,0,0.0,0,0,0.0,0,0,0.0,0,0,0.0,0,0,0,0,NO
2,src/java/main/org/apache/zookeeper/server/SessionTracker.java,58,0,0.0,0,0,0.0,0,0,0.0,0,0,0.0,0,0,0,0,NO
2,src/java/main/org/apache/zookeeper/server/SessionTrackerImpl.java,219,0,0.0,0,0,0.0,0,0,0.0,0,0,0.0,0,0,0,0,NO
2,src/java/main/org/apache/zookeeper/server/SyncRequestProcessor.java,144,17,17.0,17,5,5.0,5,22,22.0,22,12,12.0,12,1,1,1,NO
2,src/java/main/org/apache/zookeeper/server/TraceFormatter.java,119,0,0.0,0,0,0.0,0,0,0.0,0,0,0.0,0,0,0,0,NO
2,src/java/main/org/apache/zookeeper/server/WatchManager.java,113,0,0.0,0,0,0.0,0,0,0.0,0,0,0.0,0,0,0,0,NO
2,src/java/main/org/apache/zookeeper/server/ZooKeeperServer.java,616,8,8.0,8,2,2.0,2,10,10.0,10,6,6.0,6,1,0,1,NO
2,src/java/main/org/apache/zookeeper/server/ZooKeeperServerMain.java,86,8,8.0,8,2,2.0,2,10,10.0,10,6,6.0,6,1,0,1,NO
2,src/java/main/org/apache/zookeeper/server/ZooTrace.java,92,0,0.0,0,0,0.0,0,0,0.0,0,0,0.0,0,0,0,0,NO
2,src/java/main/org/apache/zookeeper/server/auth/AuthenticationProvider.java,81,0,0.0,0,0,0.0,0,0,0.0,0,0,0.0,0,0,0,0,NO
2,src/java/main/org/apache/zookeeper/server/auth/DigestAuthenticationProvider.java,127,0,0.0,0,0,0.0,0,0,0.0,0,0,0.0,0,0,0,0,NO
2,src/java/main/org/apache/zookeeper/server/auth/HostAuthenticationProvider.java,67,0,0.0,0,0,0.0,0,0,0.0,0,0,0.0,0,0,0,0,NO
2,src/java/main/org/apache/zookeeper/server/auth/IPAuthenticationProvider.java,115,0,0.0,0,0,0.0,0,0,0.0,0,0,0.0,0,0,0,0,NO
2,src/java/main/org/apache/zookeeper/server/auth/ProviderRegistry.java,78,0,0.0,0,0,0.0,0,0,0.0,0,0,0.0,0,0,0,0,NO
2,src/java/main/org/apache/zookeeper/server/persistence/FileSnap.java,159,0,0.0,0,0,0.0,0,0,0.0,0,0,0.0,0,0,0,0,YES
2,src/java/main/org/apache/zookeeper/server/persistence/FileTxnLog.java,485,0,0.0,0,0,0.0,0,0,0.0,0,0,0.0,0,0,0,0,YES
2,src/java/main/org/apache/zookeeper/server/persistence/FileTxnSnapLog.java,246,0,0.0,0,0,0.0,0,0,0.0,0,0,0.0,0,0,0,0,YES
2,src/java/main/org/apache/zookeeper/server/persistence/SnapShot.java,60,0,0.0,0,0,0.0,0,0,0.0,0,0,0.0,0,0,0,0,NO
2,src/java/main/org/apache/zookeeper/server/persistence/TxnLog.java,114,0,0.0,0,0,0.0,0,0,0.0,0,0,0.0,0,0,0,0,NO
2,src/java/main/org/apache/zookeeper/server/persistence/Util.java,305,0,0.0,0,0,0.0,0,0,0.0,0,0,0.0,0,0,0,0,YES
2,src/java/main/org/apache/zookeeper/server/quorum/AckRequestProcessor.java,45,0,0.0,0,0,0.0,0,0,0.0,0,0,0.0,0,0,0,0,NO
2,src/java/main/org/apache/zookeeper/server/quorum/AuthFastLeaderElection.java,898,0,0.0,0,0,0.0,0,0,0.0,0,0,0.0,0,0,0,0,NO
2,src/java/main/org/apache/zookeeper/server/quorum/CommitProcessor.java,189,0,0.0,0,0,0.0,0,0,0.0,0,0,0.0,0,0,0,0,YES
2,src/java/main/org/apache/zookeeper/server/quorum/Election.java,26,0,0.0,0,0,0.0,0,0,0.0,0,0,0.0,0,0,0,0,NO
2,src/java/main/org/apache/zookeeper/server/quorum/FastLeaderElection.java,626,0,0.0,0,0,0.0,0,0,0.0,0,0,0.0,0,0,0,0,NO
2,src/java/main/org/apache/zookeeper/server/quorum/Follower.java,378,0,0.0,0,0,0.0,0,0,0.0,0,0,0.0,0,0,0,0,NO
2,src/java/main/org/apache/zookeeper/server/quorum/FollowerHandler.java,395,0,0.0,0,0,0.0,0,0,0.0,0,0,0.0,0,0,0,0,NO
2,src/java/main/org/apache/zookeeper/server/quorum/FollowerRequestProcessor.java,107,0,0.0,0,0,0.0,0,0,0.0,0,0,0.0,0,0,0,0,NO
2,src/java/main/org/apache/zookeeper/server/quorum/FollowerSessionTracker.java,85,0,0.0,0,0,0.0,0,0,0.0,0,0,0.0,0,0,0,0,NO
2,src/java/main/org/apache/zookeeper/server/quorum/FollowerSyncRequest.java,34,0,0.0,0,0,0.0,0,0,0.0,0,0,0.0,0,0,0,0,NO
2,src/java/main/org/apache/zookeeper/server/quorum/FollowerZooKeeperServer.java,177,0,0.0,0,0,0.0,0,0,0.0,0,0,0.0,0,0,0,0,NO
2,src/java/main/org/apache/zookeeper/server/quorum/Leader.java,633,0,0.0,0,0,0.0,0,0,0.0,0,0,0.0,0,0,0,0,NO
2,src/java/main/org/apache/zookeeper/server/quorum/LeaderElection.java,194,0,0.0,0,0,0.0,0,0,0.0,0,0,0.0,0,0,0,0,NO
2,src/java/main/org/apache/zookeeper/server/quorum/LeaderZooKeeperServer.java,88,0,0.0,0,0,0.0,0,0,0.0,0,0,0.0,0,0,0,0,NO
2,src/java/main/org/apache/zookeeper/server/quorum/ProposalRequestProcessor.java,76,0,0.0,0,0,0.0,0,0,0.0,0,0,0.0,0,0,0,0,NO
2,src/java/main/org/apache/zookeeper/server/quorum/QuorumCnxManager.java,564,0,0.0,0,0,0.0,0,0,0.0,0,0,0.0,0,0,0,0,NO
2,src/java/main/org/apache/zookeeper/server/quorum/QuorumPeer.java,590,0,0.0,0,0,0.0,0,0,0.0,0,0,0.0,0,0,0,0,YES
2,src/java/main/org/apache/zookeeper/server/quorum/QuorumPeerConfig.java,222,129,129.0,129,137,137.0,137,266,266.0,266,8,8.0,8,1,0,1,YES
2,src/java/main/org/apache/zookeeper/server/quorum/QuorumPeerMain.java,115,6,6.0,6,1,1.0,1,7,7.0,7,5,5.0,5,1,0,1,NO
2,src/java/main/org/apache/zookeeper/server/quorum/QuorumStats.java,81,0,0.0,0,0,0.0,0,0,0.0,0,0,0.0,0,0,0,0,NO
2,src/java/main/org/apache/zookeeper/server/quorum/SendAckRequestProcessor.java,54,0,0.0,0,0,0.0,0,0,0.0,0,0,0.0,0,0,0,0,NO
2,src/java/main/org/apache/zookeeper/server/quorum/Vote.java,69,0,0.0,0,0,0.0,0,0,0.0,0,0,0.0,0,0,0,0,NO
2,src/java/main/org/apache/zookeeper/server/upgrade/DataNodeV1.java,129,0,0.0,0,0,0.0,0,0,0.0,0,0,0.0,0,0,0,0,NO
2,src/java/main/org/apache/zookeeper/server/upgrade/DataTreeV1.java,582,0,0.0,0,0,0.0,0,0,0.0,0,0,0.0,0,0,0,0,NO
2,src/java/main/org/apache/zookeeper/server/upgrade/UpgradeMain.java,181,0,0.0,0,0,0.0,0,0,0.0,0,0,0.0,0,0,0,0,NO
2,src/java/main/org/apache/zookeeper/server/upgrade/UpgradeSnapShot.java,33,0,0.0,0,0,0.0,0,0,0.0,0,0,0.0,0,0,0,0,NO
2,src/java/main/org/apache/zookeeper/server/upgrade/UpgradeSnapShotV1.java,323,0,0.0,0,0,0.0,0,0,0.0,0,0,0.0,0,0,0,0,YES
2,src/java/main/org/apache/zookeeper/server/util/Profiler.java,40,0,0.0,0,0,0.0,0,0,0.0,0,0,0.0,0,0,0,0,NO
2,src/java/main/org/apache/zookeeper/server/util/SerializeUtils.java,105,0,0.0,0,0,0.0,0,0,0.0,0,0,0.0,0,0,0,0,NO
2,src/java/main/org/apache/zookeeper/version/util/VerGen.java,120,0,0.0,0,0,0.0,0,0,0.0,0,0,0.0,0,0,0,0,YES
3,src/contrib/bookkeeper/benchmark/org/apache/bookkeeper/benchmark/MySqlClient.java,137,137,137.0,137,0,0.0,0,137,137.0,137,137,137.0,137,1,0,1,NO
3,src/contrib/bookkeeper/benchmark/org/apache/bookkeeper/benchmark/TestClient.java,269,269,269.0,269,0,0.0,0,269,269.0,269,269,269.0,269,1,0,1,YES
3,src/contrib/bookkeeper/src/java/org/apache/bookkeeper/bookie/Bookie.java,343,343,343.0,343,0,0.0,0,343,343.0,343,343,343.0,343,1,0,1,YES
3,src/contrib/bookkeeper/src/java/org/apache/bookkeeper/bookie/LedgerDescriptor.java,154,154,154.0,154,0,0.0,0,154,154.0,154,154,154.0,154,1,0,1,NO
3,src/contrib/bookkeeper/src/java/org/apache/bookkeeper/client/AddCallback.java,37,37,37.0,37,0,0.0,0,37,37.0,37,37,37.0,37,1,0,1,NO
3,src/contrib/bookkeeper/src/java/org/apache/bookkeeper/client/BKException.java,130,130,130.0,130,0,0.0,0,130,130.0,130,130,130.0,130,1,0,1,NO
3,src/contrib/bookkeeper/src/java/org/apache/bookkeeper/client/BookKeeper.java,701,701,701.0,701,0,0.0,0,701,701.0,701,701,701.0,701,1,0,1,NO
3,src/contrib/bookkeeper/src/java/org/apache/bookkeeper/client/BookieHandle.java,250,250,250.0,250,0,0.0,0,250,250.0,250,250,250.0,250,1,0,1,YES
3,src/contrib/bookkeeper/src/java/org/apache/bookkeeper/client/ClientCBWorker.java,112,112,112.0,112,0,0.0,0,112,112.0,112,112,112.0,112,1,0,1,YES
3,src/contrib/bookkeeper/src/java/org/apache/bookkeeper/client/ErrorCodes.java,29,29,29.0,29,0,0.0,0,29,29.0,29,29,29.0,29,1,0,1,NO
3,src/contrib/bookkeeper/src/java/org/apache/bookkeeper/client/LedgerEntry.java,63,63,63.0,63,0,0.0,0,63,63.0,63,63,63.0,63,1,0,1,NO
3,src/contrib/bookkeeper/src/java/org/apache/bookkeeper/client/LedgerHandle.java,349,349,349.0,349,0,0.0,0,349,349.0,349,349,349.0,349,1,0,1,YES
3,src/contrib/bookkeeper/src/java/org/apache/bookkeeper/client/LedgerRecoveryMonitor.java,213,213,213.0,213,0,0.0,0,213,213.0,213,213,213.0,213,1,0,1,YES
3,src/contrib/bookkeeper/src/java/org/apache/bookkeeper/client/LedgerSequence.java,65,65,65.0,65,0,0.0,0,65,65.0,65,65,65.0,65,1,0,1,NO
3,src/contrib/bookkeeper/src/java/org/apache/bookkeeper/client/LedgerStream.java,104,104,104.0,104,0,0.0,0,104,104.0,104,104,104.0,104,1,0,1,NO
3,src/contrib/bookkeeper/src/java/org/apache/bookkeeper/client/QuorumEngine.java,265,265,265.0,265,0,0.0,0,265,265.0,265,265,265.0,265,1,0,1,NO
3,src/contrib/bookkeeper/src/java/org/apache/bookkeeper/client/QuorumOpMonitor.java,496,496,496.0,496,0,0.0,0,496,496.0,496,496,496.0,496,1,0,1,NO
3,src/contrib/bookkeeper/src/java/org/apache/bookkeeper/client/ReadCallback.java,38,38,38.0,38,0,0.0,0,38,38.0,38,38,38.0,38,1,0,1,NO
3,src/contrib/bookkeeper/src/java/org/apache/bookkeeper/proto/BookieClient.java,342,342,342.0,342,0,0.0,0,342,342.0,342,342,342.0,342,1,0,1,YES
3,src/contrib/bookkeeper/src/java/org/apache/bookkeeper/proto/BookieProtocol.java,70,70,70.0,70,0,0.0,0,70,70.0,70,70,70.0,70,1,0,1,NO
3,src/contrib/bookkeeper/src/java/org/apache/bookkeeper/proto/BookieServer.java,179,179,179.0,179,0,0.0,0,179,179.0,179,179,179.0,179,1,0,1,NO
3,src/contrib/bookkeeper/src/java/org/apache/bookkeeper/proto/NIOServerFactory.java,532,532,532.0,532,0,0.0,0,532,532.0,532,532,532.0,532,1,0,1,YES
3,src/contrib/bookkeeper/src/java/org/apache/bookkeeper/proto/ReadEntryCallback.java,35,35,35.0,35,0,0.0,0,35,35.0,35,35,35.0,35,1,0,1,NO
3,src/contrib/bookkeeper/src/java/org/apache/bookkeeper/proto/ServerStats.java,133,133,133.0,133,0,0.0,0,133,133.0,133,133,133.0,133,1,0,1,NO
3,src/contrib/bookkeeper/src/java/org/apache/bookkeeper/proto/WriteCallback.java,32,32,32.0,32,0,0.0,0,32,32.0,32,32,32.0,32,1,0,1,NO
3,src/contrib/bookkeeper/src/java/org/apache/bookkeeper/util/ClientBase.java,343,343,343.0,343,0,0.0,0,343,343.0,343,343,343.0,343,1,0,1,NO
3,src/contrib/bookkeeper/src/java/org/apache/bookkeeper/util/LocalBookKeeper.java,164,164,164.0,164,0,0.0,0,164,164.0,164,164,164.0,164,1,0,1,YES
3,src/contrib/bookkeeper/src/java/org/apache/bookkeeper/util/Main.java,55,55,55.0,55,0,0.0,0,55,55.0,55,55,55.0,55,1,0,1,NO
3,src/contrib/fatjar/src/java/org/apache/zookeeper/util/FatJarMain.java,126,126,126.0,126,0,0.0,0,126,126.0,126,126,126.0,126,1,0,1,NO
3,src/java/main/org/apache/jute/BinaryInputArchive.java,132,0,0.0,0,0,0.0,0,0,0.0,0,0,0.0,0,0,0,0,NO
3,src/java/main/org/apache/jute/BinaryOutputArchive.java,149,0,0.0,0,0,0.0,0,0,0.0,0,0,0.0,0,0,0,0,NO
3,src/java/main/org/apache/jute/CsvInputArchive.java,210,0,0.0,0,0,0.0,0,0,0.0,0,0,0.0,0,0,0,0,NO
3,src/java/main/org/apache/jute/CsvOutputArchive.java,151,0,0.0,0,0,0.0,0,0,0.0,0,0,0.0,0,0,0,0,NO
3,src/java/main/org/apache/jute/Index.java,39,0,0.0,0,0,0.0,0,0,0.0,0,0,0.0,0,0,0,0,NO
3,src/java/main/org/apache/jute/InputArchive.java,45,0,0.0,0,0,0.0,0,0,0.0,0,0,0.0,0,0,0,0,NO
3,src/java/main/org/apache/jute/OutputArchive.java,48,0,0.0,0,0,0.0,0,0,0.0,0,0,0.0,0,0,0,0,NO
3,src/java/main/org/apache/jute/Record.java,33,0,0.0,0,0,0.0,0,0,0.0,0,0,0.0,0,0,0,0,NO
3,src/java/main/org/apache/jute/RecordReader.java,98,0,0.0,0,0,0.0,0,0,0.0,0,0,0.0,0,0,0,0,NO
3,src/java/main/org/apache/jute/RecordWriter.java,117,0,0.0,0,0,0.0,0,0,0.0,0,0,0.0,0,0,0,0,NO
3,src/java/main/org/apache/jute/Utils.java,283,16,16.0,16,11,11.0,11,27,27.0,27,5,5.0,5,1,1,1,NO
3,src/java/main/org/apache/jute/XmlInputArchive.java,251,0,0.0,0,0,0.0,0,0,0.0,0,0,0.0,0,0,0,0,NO
3,src/java/main/org/apache/jute/XmlOutputArchive.java,252,0,0.0,0,0,0.0,0,0,0.0,0,0,0.0,0,0,0,0,NO
3,src/java/main/org/apache/jute/compiler/CGenerator.java,88,0,0.0,0,0,0.0,0,0,0.0,0,0,0.0,0,0,0,0,NO
3,src/java/main/org/apache/jute/compiler/CppGenerator.java,83,0,0.0,0,0,0.0,0,0,0.0,0,0,0.0,0,0,0,0,NO
3,src/java/main/org/apache/jute/compiler/JBoolean.java,43,0,0.0,0,0,0.0,0,0,0.0,0,0,0.0,0,0,0,0,NO
3,src/java/main/org/apache/jute/compiler/JBuffer.java,107,0,0.0,0,0,0.0,0,0,0.0,0,0,0.0,0,0,0,0,NO
3,src/java/main/org/apache/jute/compiler/JByte.java,35,0,0.0,0,0,0.0,0,0,0.0,0,0,0.0,0,0,0,0,NO
3,src/java/main/org/apache/jute/compiler/JCompType.java,55,0,0.0,0,0,0.0,0,0,0.0,0,0,0.0,0,0,0,0,NO
3,src/java/main/org/apache/jute/compiler/JDouble.java,41,0,0.0,0,0,0.0,0,0,0.0,0,0,0.0,0,0,0,0,NO
3,src/java/main/org/apache/jute/compiler/JField.java,99,0,0.0,0,0,0.0,0,0,0.0,0,0,0.0,0,0,0,0,NO
3,src/java/main/org/apache/jute/compiler/JFile.java,75,0,0.0,0,0,0.0,0,0,0.0,0,0,0.0,0,0,0,0,NO
3,src/java/main/org/apache/jute/compiler/JFloat.java,40,0,0.0,0,0,0.0,0,0,0.0,0,0,0.0,0,0,0,0,NO
3,src/java/main/org/apache/jute/compiler/JInt.java,35,0,0.0,0,0,0.0,0,0,0.0,0,0,0.0,0,0,0,0,NO
3,src/java/main/org/apache/jute/compiler/JLong.java,39,0,0.0,0,0,0.0,0,0,0.0,0,0,0.0,0,0,0,0,NO
3,src/java/main/org/apache/jute/compiler/JMap.java,101,0,0.0,0,0,0.0,0,0,0.0,0,0,0.0,0,0,0,0,NO
3,src/java/main/org/apache/jute/compiler/JRecord.java,508,0,0.0,0,0,0.0,0,0,0.0,0,0,0.0,0,0,0,0,NO
3,src/java/main/org/apache/jute/compiler/JString.java,47,0,0.0,0,0,0.0,0,0,0.0,0,0,0.0,0,0,0,0,NO
3,src/java/main/org/apache/jute/compiler/JType.java,142,0,0.0,0,0,0.0,0,0,0.0,0,0,0.0,0,0,0,0,NO
3,src/java/main/org/apache/jute/compiler/JVector.java,106,0,0.0,0,0,0.0,0,0,0.0,0,0,0.0,0,0,0,0,NO
3,src/java/main/org/apache/jute/compiler/JavaGenerator.java,62,0,0.0,0,0,0.0,0,0,0.0,0,0,0.0,0,0,0,0,NO
3,src/java/main/org/apache/jute/compiler/generated/ParseException.java,210,0,0.0,0,0,0.0,0,0,0.0,0,0,0.0,0,0,0,0,NO
3,src/java/main/org/apache/jute/compiler/generated/Rcc.java,525,0,0.0,0,0,0.0,0,0,0.0,0,0,0.0,0,0,0,0,NO
3,src/java/main/org/apache/jute/compiler/generated/RccConstants.java,88,0,0.0,0,0,0.0,0,0,0.0,0,0,0.0,0,0,0,0,NO
3,src/java/main/org/apache/jute/compiler/generated/RccTokenManager.java,833,0,0.0,0,0,0.0,0,0,0.0,0,0,0.0,0,0,0,0,NO
3,src/java/main/org/apache/jute/compiler/generated/SimpleCharStream.java,457,0,0.0,0,0,0.0,0,0,0.0,0,0,0.0,0,0,0,0,NO
3,src/java/main/org/apache/jute/compiler/generated/Token.java,99,0,0.0,0,0,0.0,0,0,0.0,0,0,0.0,0,0,0,0,NO
3,src/java/main/org/apache/jute/compiler/generated/TokenMgrError.java,151,0,0.0,0,0,0.0,0,0,0.0,0,0,0.0,0,0,0,0,NO
3,src/java/main/org/apache/zookeeper/AsyncCallback.java,52,0,0.0,0,0,0.0,0,0,0.0,0,0,0.0,0,0,0,0,NO
3,src/java/main/org/apache/zookeeper/ClientCnxn.java,1069,37,7.4,37,13,2.6,13,50,10.0,50,24,4.8,24,5,2,3,YES
3,src/java/main/org/apache/zookeeper/ClientWatchManager.java,39,0,0.0,0,0,0.0,0,0,0.0,0,0,0.0,0,0,0,0,NO
3,src/java/main/org/apache/zookeeper/CreateMode.java,89,0,0.0,0,0,0.0,0,0,0.0,0,0,0.0,0,0,0,0,NO
3,src/java/main/org/apache/zookeeper/Environment.java,100,0,0.0,0,0,0.0,0,0,0.0,0,0,0.0,0,0,0,0,NO
3,src/java/main/org/apache/zookeeper/KeeperException.java,622,530,265.0,530,244,122.0,244,774,387.0,774,286,143.0,286,2,1,1,YES
3,src/java/main/org/apache/zookeeper/Quotas.java,68,68,68.0,68,0,0.0,0,68,68.0,68,68,68.0,68,1,0,1,NO
3,src/java/main/org/apache/zookeeper/ServerAdminClient.java,312,0,0.0,0,0,0.0,0,0,0.0,0,0,0.0,0,0,0,0,NO
3,src/java/main/org/apache/zookeeper/StatsTrack.java,101,101,101.0,101,0,0.0,0,101,101.0,101,101,101.0,101,1,0,1,NO
3,src/java/main/org/apache/zookeeper/Version.java,78,0,0.0,0,0,0.0,0,0,0.0,0,0,0.0,0,0,0,0,NO
3,src/java/main/org/apache/zookeeper/WatchedEvent.java,81,0,0.0,0,0,0.0,0,0,0.0,0,0,0.0,0,0,0,0,NO
3,src/java/main/org/apache/zookeeper/Watcher.java,125,18,18.0,18,0,0.0,0,18,18.0,18,18,18.0,18,1,0,1,NO
3,src/java/main/org/apache/zookeeper/ZooDefs.java,112,0,0.0,0,0,0.0,0,0,0.0,0,0,0.0,0,0,0,0,NO
3,src/java/main/org/apache/zookeeper/ZooKeeper.java,1179,167,33.4,167,28,5.6,28,195,39.0,195,139,27.8,139,5,0,2,YES
3,src/java/main/org/apache/zookeeper/ZooKeeperMain.java,505,284,284.0,284,11,11.0,11,295,295.0,295,273,273.0,273,1,0,1,YES
3,src/java/main/org/apache/zookeeper/common/PathTrie.java,280,280,280.0,280,0,0.0,0,280,280.0,280,280,280.0,280,1,0,1,NO
3,src/java/main/org/apache/zookeeper/jmx/CommonNames.java,29,29,29.0,29,0,0.0,0,29,29.0,29,29,29.0,29,1,0,1,NO
3,src/java/main/org/apache/zookeeper/jmx/MBeanRegistry.java,194,214,107.0,214,20,10.0,20,234,117.0,234,194,97.0,194,2,0,2,NO
3,src/java/main/org/apache/zookeeper/jmx/ManagedUtil.java,72,72,72.0,72,0,0.0,0,72,72.0,72,72,72.0,72,1,0,1,NO
3,src/java/main/org/apache/zookeeper/jmx/ZKMBeanInfo.java,36,36,36.0,36,0,0.0,0,36,36.0,36,36,36.0,36,1,0,1,NO
3,src/java/main/org/apache/zookeeper/server/ByteBufferInputStream.java,72,0,0.0,0,0,0.0,0,0,0.0,0,0,0.0,0,0,0,0,NO
3,src/java/main/org/apache/zookeeper/server/ConnectionBean.java,121,130,65.0,130,9,4.5,9,139,69.5,139,121,60.5,121,2,0,2,NO
3,src/java/main/org/apache/zookeeper/server/ConnectionMXBean.java,68,68,68.0,68,0,0.0,0,68,68.0,68,68,68.0,68,1,0,1,NO
3,src/java/main/org/apache/zookeeper/server/DataNode.java,131,29,14.5,29,23,11.5,23,52,26.0,52,14,7.0,14,2,0,2,NO
3,src/java/main/org/apache/zookeeper/server/DataTree.java,1069,310,62.0,310,39,7.8,39,349,69.8,349,273,54.6,273,5,1,3,NO
3,src/java/main/org/apache/zookeeper/server/DataTreeBean.java,70,70,70.0,70,0,0.0,0,70,70.0,70,70,70.0,70,1,0,1,NO
3,src/java/main/org/apache/zookeeper/server/DataTreeMXBean.java,47,47,47.0,47,0,0.0,0,47,47.0,47,47,47.0,47,1,0,1,NO
3,src/java/main/org/apache/zookeeper/server/FinalRequestProcessor.java,268,17,5.6666665,17,14,4.6666665,14,31,10.333333,31,3,1.0,3,3,0,3,YES
3,src/java/main/org/apache/zookeeper/server/LogFormatter.java,72,1,1.0,1,1,1.0,1,2,2.0,2,0,0.0,0,1,0,1,NO
3,src/java/main/org/apache/zookeeper/server/NIOServerCnxn.java,959,146,18.25,146,75,9.375,75,221,27.625,221,71,8.875,71,8,0,3,YES
3,src/java/main/org/apache/zookeeper/server/PrepRequestProcessor.java,478,33,6.6,33,15,3.0,15,48,9.6,48,20,4.0,20,5,0,3,YES
3,src/java/main/org/apache/zookeeper/server/PurgeTxnLog.java,132,53,53.0,53,15,15.0,15,68,68.0,68,38,38.0,38,1,1,1,NO
3,src/java/main/org/apache/zookeeper/server/Request.java,197,0,0.0,0,0,0.0,0,0,0.0,0,0,0.0,0,0,0,0,YES
3,src/java/main/org/apache/zookeeper/server/RequestProcessor.java,37,0,0.0,0,0,0.0,0,0,0.0,0,0,0.0,0,0,0,0,NO
3,src/java/main/org/apache/zookeeper/server/ServerCnxn.java,86,14,7.0,14,8,4.0,8,22,11.0,22,8,4.0,8,2,0,2,YES
3,src/java/main/org/apache/zookeeper/server/ServerConfig.java,67,0,0.0,0,0,0.0,0,0,0.0,0,0,0.0,0,0,0,0,NO
3,src/java/main/org/apache/zookeeper/server/ServerStats.java,132,32,10.666667,32,40,13.333333,40,72,24.0,72,20,6.6666665,20,3,0,2,NO
3,src/java/main/org/apache/zookeeper/server/SessionTracker.java,58,0,0.0,0,0,0.0,0,0,0.0,0,0,0.0,0,0,0,0,YES
3,src/java/main/org/apache/zookeeper/server/SessionTrackerImpl.java,218,3,3.0,3,4,4.0,4,7,7.0,7,1,1.0,1,1,0,1,YES
3,src/java/main/org/apache/zookeeper/server/SyncRequestProcessor.java,142,4,2.0,4,6,3.0,6,10,5.0,10,2,1.0,2,2,0,2,NO
3,src/java/main/org/apache/zookeeper/server/TraceFormatter.java,119,0,0.0,0,0,0.0,0,0,0.0,0,0,0.0,0,0,0,0,NO
3,src/java/main/org/apache/zookeeper/server/WatchManager.java,111,1,1.0,1,3,3.0,3,4,4.0,4,2,2.0,2,1,0,1,NO
3,src/java/main/org/apache/zookeeper/server/ZooKeeperServer.java,664,87,21.75,87,39,9.75,39,126,31.5,126,62,15.5,62,4,0,3,YES
3,src/java/main/org/apache/zookeeper/server/ZooKeeperServerBean.java,114,117,58.5,117,3,1.5,3,120,60.0,120,118,59.0,118,2,0,2,NO
3,src/java/main/org/apache/zookeeper/server/ZooKeeperServerMXBean.java,82,82,82.0,82,0,0.0,0,82,82.0,82,82,82.0,82,1,0,1,NO
3,src/java/main/org/apache/zookeeper/server/ZooKeeperServerMain.java,93,15,7.5,15,8,4.0,8,23,11.5,23,9,4.5,9,2,0,2,NO
3,src/java/main/org/apache/zookeeper/server/ZooTrace.java,92,0,0.0,0,0,0.0,0,0,0.0,0,0,0.0,0,0,0,0,NO
3,src/java/main/org/apache/zookeeper/server/auth/AuthenticationProvider.java,82,2,2.0,2,1,1.0,1,3,3.0,3,1,1.0,1,1,0,1,NO
3,src/java/main/org/apache/zookeeper/server/auth/DigestAuthenticationProvider.java,128,5,5.0,5,4,4.0,4,9,9.0,9,1,1.0,1,1,0,1,YES
3,src/java/main/org/apache/zookeeper/server/auth/HostAuthenticationProvider.java,69,4,4.0,4,2,2.0,2,6,6.0,6,2,2.0,2,1,0,1,NO
3,src/java/main/org/apache/zookeeper/server/auth/IPAuthenticationProvider.java,117,4,4.0,4,2,2.0,2,6,6.0,6,2,2.0,2,1,0,1,NO
3,src/java/main/org/apache/zookeeper/server/auth/ProviderRegistry.java,78,0,0.0,0,0,0.0,0,0,0.0,0,0,0.0,0,0,0,0,YES
3,src/java/main/org/apache/zookeeper/server/persistence/FileSnap.java,186,29,14.5,29,2,1.0,2,31,15.5,31,27,13.5,27,2,2,1,NO
3,src/java/main/org/apache/zookeeper/server/persistence/FileTxnLog.java,487,3,3.0,3,1,1.0,1,4,4.0,4,2,2.0,2,1,1,1,NO
3,src/java/main/org/apache/zookeeper/server/persistence/FileTxnSnapLog.java,276,31,10.333333,31,1,0.33333334,1,32,10.666667,32,32,10.666667,32,3,2,1,NO
3,src/java/main/org/apache/zookeeper/server/persistence/SnapShot.java,60,0,0.0,0,0,0.0,0,0,0.0,0,0,0.0,0,0,0,0,NO
3,src/java/main/org/apache/zookeeper/server/persistence/TxnLog.java,114,0,0.0,0,0,0.0,0,0,0.0,0,0,0.0,0,0,0,0,NO
3,src/java/main/org/apache/zookeeper/server/persistence/Util.java,310,5,5.0,5,0,0.0,0,5,5.0,5,5,5.0,5,1,1,1,NO
3,src/java/main/org/apache/zookeeper/server/quorum/AckRequestProcessor.java,45,0,0.0,0,0,0.0,0,0,0.0,0,0,0.0,0,0,0,0,NO
3,src/java/main/org/apache/zookeeper/server/quorum/AuthFastLeaderElection.java,892,10,10.0,10,16,16.0,16,26,26.0,26,6,6.0,6,1,0,1,NO
3,src/java/main/org/apache/zookeeper/server/quorum/CommitProcessor.java,186,2,1.0,2,5,2.5,5,7,3.5,7,3,1.5,3,2,1,1,NO
3,src/java/main/org/apache/zookeeper/server/quorum/Election.java,26,0,0.0,0,0,0.0,0,0,0.0,0,0,0.0,0,0,0,0,NO
3,src/java/main/org/apache/zookeeper/server/quorum/FastLeaderElection.java,654,121,30.25,121,93,23.25,93,214,53.5,214,30,7.5,30,4,1,3,YES
3,src/java/main/org/apache/zookeeper/server/quorum/Follower.java,403,190,95.0,190,165,82.5,165,355,177.5,355,25,12.5,25,2,0,2,YES
3,src/java/main/org/apache/zookeeper/server/quorum/FollowerBean.java,50,50,50.0,50,0,0.0,0,50,50.0,50,50,50.0,50,1,0,1,NO
3,src/java/main/org/apache/zookeeper/server/quorum/FollowerHandler.java,407,21,10.5,21,9,4.5,9,30,15.0,30,12,6.0,12,2,0,2,YES
3,src/java/main/org/apache/zookeeper/server/quorum/FollowerMXBean.java,41,41,41.0,41,0,0.0,0,41,41.0,41,41,41.0,41,1,0,1,NO
3,src/java/main/org/apache/zookeeper/server/quorum/FollowerRequestProcessor.java,106,3,1.5,3,4,2.0,4,7,3.5,7,1,0.5,1,2,0,2,NO
3,src/java/main/org/apache/zookeeper/server/quorum/FollowerSessionTracker.java,85,0,0.0,0,0,0.0,0,0,0.0,0,0,0.0,0,0,0,0,YES
3,src/java/main/org/apache/zookeeper/server/quorum/FollowerSyncRequest.java,34,0,0.0,0,0,0.0,0,0,0.0,0,0,0.0,0,0,0,0,NO
3,src/java/main/org/apache/zookeeper/server/quorum/FollowerZooKeeperServer.java,245,75,18.75,75,7,1.75,7,82,20.5,82,68,17.0,68,4,0,3,NO
3,src/java/main/org/apache/zookeeper/server/quorum/Leader.java,638,85,42.5,85,80,40.0,80,165,82.5,165,5,2.5,5,2,0,2,YES
3,src/java/main/org/apache/zookeeper/server/quorum/LeaderBean.java,53,53,53.0,53,0,0.0,0,53,53.0,53,53,53.0,53,1,0,1,NO
3,src/java/main/org/apache/zookeeper/server/quorum/LeaderElection.java,193,4,4.0,4,5,5.0,5,9,9.0,9,1,1.0,1,1,0,1,NO
3,src/java/main/org/apache/zookeeper/server/quorum/LeaderElectionBean.java,42,42,42.0,42,0,0.0,0,42,42.0,42,42,42.0,42,1,0,1,NO
3,src/java/main/org/apache/zookeeper/server/quorum/LeaderElectionMXBean.java,31,31,31.0,31,0,0.0,0,31,31.0,31,31,31.0,31,1,0,1,NO
3,src/java/main/org/apache/zookeeper/server/quorum/LeaderMXBean.java,36,36,36.0,36,0,0.0,0,36,36.0,36,36,36.0,36,1,0,1,NO
3,src/java/main/org/apache/zookeeper/server/quorum/LeaderZooKeeperServer.java,154,69,23.0,69,3,1.0,3,72,24.0,72,66,22.0,66,3,0,2,YES
3,src/java/main/org/apache/zookeeper/server/quorum/LocalPeerBean.java,68,68,68.0,68,0,0.0,0,68,68.0,68,68,68.0,68,1,0,1,NO
3,src/java/main/org/apache/zookeeper/server/quorum/LocalPeerMXBean.java,64,64,64.0,64,0,0.0,0,64,64.0,64,64,64.0,64,1,0,1,NO
3,src/java/main/org/apache/zookeeper/server/quorum/ProposalRequestProcessor.java,75,0,0.0,0,1,1.0,1,1,1.0,1,1,1.0,1,1,0,1,NO
3,src/java/main/org/apache/zookeeper/server/quorum/QuorumBean.java,44,44,44.0,44,0,0.0,0,44,44.0,44,44,44.0,44,1,0,1,NO
3,src/java/main/org/apache/zookeeper/server/quorum/QuorumCnxManager.java,584,95,31.666666,95,75,25.0,75,170,56.666668,170,32,10.666667,32,3,1,2,YES
3,src/java/main/org/apache/zookeeper/server/quorum/QuorumMXBean.java,34,34,34.0,34,0,0.0,0,34,34.0,34,34,34.0,34,1,0,1,NO
3,src/java/main/org/apache/zookeeper/server/quorum/QuorumPeer.java,650,126,25.2,126,66,13.2,66,192,38.4,192,60,12.0,60,5,2,2,YES
3,src/java/main/org/apache/zookeeper/server/quorum/QuorumPeerConfig.java,221,2,2.0,2,3,3.0,3,5,5.0,5,1,1.0,1,1,0,1,YES
3,src/java/main/org/apache/zookeeper/server/quorum/QuorumPeerMain.java,123,9,9.0,9,1,1.0,1,10,10.0,10,8,8.0,8,1,0,1,NO
3,src/java/main/org/apache/zookeeper/server/quorum/QuorumStats.java,67,10,10.0,10,24,24.0,24,34,34.0,34,14,14.0,14,1,0,1,NO
3,src/java/main/org/apache/zookeeper/server/quorum/RemotePeerBean.java,45,45,45.0,45,0,0.0,0,45,45.0,45,45,45.0,45,1,0,1,NO
3,src/java/main/org/apache/zookeeper/server/quorum/RemotePeerMXBean.java,33,33,33.0,33,0,0.0,0,33,33.0,33,33,33.0,33,1,0,1,NO
3,src/java/main/org/apache/zookeeper/server/quorum/SendAckRequestProcessor.java,54,1,1.0,1,1,1.0,1,2,2.0,2,0,0.0,0,1,0,1,NO
3,src/java/main/org/apache/zookeeper/server/quorum/ServerBean.java,38,38,38.0,38,0,0.0,0,38,38.0,38,38,38.0,38,1,0,1,NO
3,src/java/main/org/apache/zookeeper/server/quorum/ServerMXBean.java,33,33,33.0,33,0,0.0,0,33,33.0,33,33,33.0,33,1,0,1,NO
3,src/java/main/org/apache/zookeeper/server/quorum/Vote.java,69,0,0.0,0,0,0.0,0,0,0.0,0,0,0.0,0,0,0,0,YES
3,src/java/main/org/apache/zookeeper/server/upgrade/DataNodeV1.java,129,0,0.0,0,0,0.0,0,0,0.0,0,0,0.0,0,0,0,0,NO
3,src/java/main/org/apache/zookeeper/server/upgrade/DataTreeV1.java,583,16,8.0,16,15,7.5,15,31,15.5,31,1,0.5,1,2,0,2,NO
3,src/java/main/org/apache/zookeeper/server/upgrade/UpgradeMain.java,181,0,0.0,0,0,0.0,0,0,0.0,0,0,0.0,0,0,0,0,NO
3,src/java/main/org/apache/zookeeper/server/upgrade/UpgradeSnapShot.java,33,0,0.0,0,0,0.0,0,0,0.0,0,0,0.0,0,0,0,0,NO
3,src/java/main/org/apache/zookeeper/server/upgrade/UpgradeSnapShotV1.java,327,8,4.0,8,4,2.0,4,12,6.0,12,4,2.0,4,2,1,2,NO
3,src/java/main/org/apache/zookeeper/server/util/Profiler.java,40,1,1.0,1,1,1.0,1,2,2.0,2,0,0.0,0,1,0,1,NO
3,src/java/main/org/apache/zookeeper/server/util/SerializeUtils.java,105,0,0.0,0,0,0.0,0,0,0.0,0,0,0.0,0,0,0,0,NO
3,src/java/main/org/apache/zookeeper/version/util/VerGen.java,128,9,9.0,9,1,1.0,1,10,10.0,10,8,8.0,8,1,1,1,NO
4,src/contrib/bookkeeper/benchmark/org/apache/bookkeeper/benchmark/MySqlClient.java,137,0,0.0,0,0,0.0,0,0,0.0,0,0,0.0,0,0,0,0,NO
4,src/contrib/bookkeeper/benchmark/org/apache/bookkeeper/benchmark/TestClient.java,252,31,31.0,31,48,48.0,48,79,79.0,79,17,17.0,17,1,1,1,NO
4,src/contrib/bookkeeper/src/java/org/apache/bookkeeper/bookie/Bookie.java,343,0,0.0,0,0,0.0,0,0,0.0,0,0,0.0,0,0,0,0,YES
4,src/contrib/bookkeeper/src/java/org/apache/bookkeeper/bookie/LedgerDescriptor.java,154,0,0.0,0,0,0.0,0,0,0.0,0,0,0.0,0,0,0,0,YES
4,src/contrib/bookkeeper/src/java/org/apache/bookkeeper/client/AddCallback.java,37,0,0.0,0,0,0.0,0,0,0.0,0,0,0.0,0,0,0,0,NO
4,src/contrib/bookkeeper/src/java/org/apache/bookkeeper/client/BKException.java,130,0,0.0,0,0,0.0,0,0,0.0,0,0,0.0,0,0,0,0,NO
4,src/contrib/bookkeeper/src/java/org/apache/bookkeeper/client/BookKeeper.java,701,0,0.0,0,0,0.0,0,0,0.0,0,0,0.0,0,0,0,0,NO
4,src/contrib/bookkeeper/src/java/org/apache/bookkeeper/client/BookieHandle.java,250,0,0.0,0,0,0.0,0,0,0.0,0,0,0.0,0,0,0,0,YES
4,src/contrib/bookkeeper/src/java/org/apache/bookkeeper/client/ClientCBWorker.java,112,0,0.0,0,0,0.0,0,0,0.0,0,0,0.0,0,0,0,0,YES
4,src/contrib/bookkeeper/src/java/org/apache/bookkeeper/client/ErrorCodes.java,29,0,0.0,0,0,0.0,0,0,0.0,0,0,0.0,0,0,0,0,NO
4,src/contrib/bookkeeper/src/java/org/apache/bookkeeper/client/LedgerEntry.java,63,0,0.0,0,0,0.0,0,0,0.0,0,0,0.0,0,0,0,0,NO
4,src/contrib/bookkeeper/src/java/org/apache/bookkeeper/client/LedgerHandle.java,349,0,0.0,0,0,0.0,0,0,0.0,0,0,0.0,0,0,0,0,YES
4,src/contrib/bookkeeper/src/java/org/apache/bookkeeper/client/LedgerRecoveryMonitor.java,213,0,0.0,0,0,0.0,0,0,0.0,0,0,0.0,0,0,0,0,YES
4,src/contrib/bookkeeper/src/java/org/apache/bookkeeper/client/LedgerSequence.java,65,0,0.0,0,0,0.0,0,0,0.0,0,0,0.0,0,0,0,0,NO
4,src/contrib/bookkeeper/src/java/org/apache/bookkeeper/client/LedgerStream.java,104,0,0.0,0,0,0.0,0,0,0.0,0,0,0.0,0,0,0,0,NO
4,src/contrib/bookkeeper/src/java/org/apache/bookkeeper/client/QuorumEngine.java,265,0,0.0,0,0,0.0,0,0,0.0,0,0,0.0,0,0,0,0,NO
4,src/contrib/bookkeeper/src/java/org/apache/bookkeeper/client/QuorumOpMonitor.java,496,0,0.0,0,0,0.0,0,0,0.0,0,0,0.0,0,0,0,0,NO
4,src/contrib/bookkeeper/src/java/org/apache/bookkeeper/client/ReadCallback.java,38,0,0.0,0,0,0.0,0,0,0.0,0,0,0.0,0,0,0,0,NO
4,src/contrib/bookkeeper/src/java/org/apache/bookkeeper/proto/BookieClient.java,342,0,0.0,0,0,0.0,0,0,0.0,0,0,0.0,0,0,0,0,YES
4,src/contrib/bookkeeper/src/java/org/apache/bookkeeper/proto/BookieProtocol.java,70,0,0.0,0,0,0.0,0,0,0.0,0,0,0.0,0,0,0,0,NO
4,src/contrib/bookkeeper/src/java/org/apache/bookkeeper/proto/BookieServer.java,179,0,0.0,0,0,0.0,0,0,0.0,0,0,0.0,0,0,0,0,NO
4,src/contrib/bookkeeper/src/java/org/apache/bookkeeper/proto/NIOServerFactory.java,532,0,0.0,0,0,0.0,0,0,0.0,0,0,0.0,0,0,0,0,YES
4,src/contrib/bookkeeper/src/java/org/apache/bookkeeper/proto/ReadEntryCallback.java,35,0,0.0,0,0,0.0,0,0,0.0,0,0,0.0,0,0,0,0,NO
4,src/contrib/bookkeeper/src/java/org/apache/bookkeeper/proto/ServerStats.java,133,0,0.0,0,0,0.0,0,0,0.0,0,0,0.0,0,0,0,0,NO
4,src/contrib/bookkeeper/src/java/org/apache/bookkeeper/proto/WriteCallback.java,32,0,0.0,0,0,0.0,0,0,0.0,0,0,0.0,0,0,0,0,NO
4,src/contrib/bookkeeper/src/java/org/apache/bookkeeper/util/ClientBase.java,343,0,0.0,0,0,0.0,0,0,0.0,0,0,0.0,0,0,0,0,NO
4,src/contrib/bookkeeper/src/java/org/apache/bookkeeper/util/LocalBookKeeper.java,164,0,0.0,0,0,0.0,0,0,0.0,0,0,0.0,0,0,0,0,YES
4,src/contrib/bookkeeper/src/java/org/apache/bookkeeper/util/Main.java,55,0,0.0,0,0,0.0,0,0,0.0,0,0,0.0,0,0,0,0,NO
4,src/contrib/fatjar/src/java/org/apache/zookeeper/util/FatJarMain.java,126,0,0.0,0,0,0.0,0,0,0.0,0,0,0.0,0,0,0,0,NO
4,src/java/main/org/apache/jute/BinaryInputArchive.java,132,0,0.0,0,0,0.0,0,0,0.0,0,0,0.0,0,0,0,0,NO
4,src/java/main/org/apache/jute/BinaryOutputArchive.java,149,0,0.0,0,0,0.0,0,0,0.0,0,0,0.0,0,0,0,0,NO
4,src/java/main/org/apache/jute/CsvInputArchive.java,210,0,0.0,0,0,0.0,0,0,0.0,0,0,0.0,0,0,0,0,NO
4,src/java/main/org/apache/jute/CsvOutputArchive.java,151,0,0.0,0,0,0.0,0,0,0.0,0,0,0.0,0,0,0,0,NO
4,src/java/main/org/apache/jute/Index.java,39,0,0.0,0,0,0.0,0,0,0.0,0,0,0.0,0,0,0,0,NO
4,src/java/main/org/apache/jute/InputArchive.java,45,0,0.0,0,0,0.0,0,0,0.0,0,0,0.0,0,0,0,0,NO
4,src/java/main/org/apache/jute/OutputArchive.java,48,0,0.0,0,0,0.0,0,0,0.0,0,0,0.0,0,0,0,0,NO
4,src/java/main/org/apache/jute/Record.java,33,0,0.0,0,0,0.0,0,0,0.0,0,0,0.0,0,0,0,0,NO
4,src/java/main/org/apache/jute/RecordReader.java,98,0,0.0,0,0,0.0,0,0,0.0,0,0,0.0,0,0,0,0,NO
4,src/java/main/org/apache/jute/RecordWriter.java,117,0,0.0,0,0,0.0,0,0,0.0,0,0,0.0,0,0,0,0,NO
4,src/java/main/org/apache/jute/Utils.java,283,0,0.0,0,0,0.0,0,0,0.0,0,0,0.0,0,0,0,0,NO
4,src/java/main/org/apache/jute/XmlInputArchive.java,251,0,0.0,0,0,0.0,0,0,0.0,0,0,0.0,0,0,0,0,NO
4,src/java/main/org/apache/jute/XmlOutputArchive.java,252,0,0.0,0,0,0.0,0,0,0.0,0,0,0.0,0,0,0,0,NO
4,src/java/main/org/apache/jute/compiler/CGenerator.java,88,0,0.0,0,0,0.0,0,0,0.0,0,0,0.0,0,0,0,0,NO
4,src/java/main/org/apache/jute/compiler/CppGenerator.java,83,0,0.0,0,0,0.0,0,0,0.0,0,0,0.0,0,0,0,0,NO
4,src/java/main/org/apache/jute/compiler/JBoolean.java,43,0,0.0,0,0,0.0,0,0,0.0,0,0,0.0,0,0,0,0,NO
4,src/java/main/org/apache/jute/compiler/JBuffer.java,107,0,0.0,0,0,0.0,0,0,0.0,0,0,0.0,0,0,0,0,NO
4,src/java/main/org/apache/jute/compiler/JByte.java,35,0,0.0,0,0,0.0,0,0,0.0,0,0,0.0,0,0,0,0,NO
4,src/java/main/org/apache/jute/compiler/JCompType.java,55,0,0.0,0,0,0.0,0,0,0.0,0,0,0.0,0,0,0,0,NO
4,src/java/main/org/apache/jute/compiler/JDouble.java,41,0,0.0,0,0,0.0,0,0,0.0,0,0,0.0,0,0,0,0,NO
4,src/java/main/org/apache/jute/compiler/JField.java,99,0,0.0,0,0,0.0,0,0,0.0,0,0,0.0,0,0,0,0,NO
4,src/java/main/org/apache/jute/compiler/JFile.java,75,0,0.0,0,0,0.0,0,0,0.0,0,0,0.0,0,0,0,0,NO
4,src/java/main/org/apache/jute/compiler/JFloat.java,40,0,0.0,0,0,0.0,0,0,0.0,0,0,0.0,0,0,0,0,NO
4,src/java/main/org/apache/jute/compiler/JInt.java,35,0,0.0,0,0,0.0,0,0,0.0,0,0,0.0,0,0,0,0,NO
4,src/java/main/org/apache/jute/compiler/JLong.java,39,0,0.0,0,0,0.0,0,0,0.0,0,0,0.0,0,0,0,0,NO
4,src/java/main/org/apache/jute/compiler/JMap.java,101,0,0.0,0,0,0.0,0,0,0.0,0,0,0.0,0,0,0,0,NO
4,src/java/main/org/apache/jute/compiler/JRecord.java,508,0,0.0,0,0,0.0,0,0,0.0,0,0,0.0,0,0,0,0,NO
4,src/java/main/org/apache/jute/compiler/JString.java,47,0,0.0,0,0,0.0,0,0,0.0,0,0,0.0,0,0,0,0,NO
4,src/java/main/org/apache/jute/compiler/JType.java,142,0,0.0,0,0,0.0,0,0,0.0,0,0,0.0,0,0,0,0,NO
4,src/java/main/org/apache/jute/compiler/JVector.java,106,0,0.0,0,0,0.0,0,0,0.0,0,0,0.0,0,0,0,0,NO
4,src/java/main/org/apache/jute/compiler/JavaGenerator.java,62,0,0.0,0,0,0.0,0,0,0.0,0,0,0.0,0,0,0,0,NO
4,src/java/main/org/apache/jute/compiler/generated/ParseException.java,210,0,0.0,0,0,0.0,0,0,0.0,0,0,0.0,0,0,0,0,NO
4,src/java/main/org/apache/jute/compiler/generated/Rcc.java,525,0,0.0,0,0,0.0,0,0,0.0,0,0,0.0,0,0,0,0,NO
4,src/java/main/org/apache/jute/compiler/generated/RccConstants.java,88,0,0.0,0,0,0.0,0,0,0.0,0,0,0.0,0,0,0,0,NO
4,src/java/main/org/apache/jute/compiler/generated/RccTokenManager.java,833,0,0.0,0,0,0.0,0,0,0.0,0,0,0.0,0,0,0,0,NO
4,src/java/main/org/apache/jute/compiler/generated/SimpleCharStream.java,457,0,0.0,0,0,0.0,0,0,0.0,0,0,0.0,0,0,0,0,NO
4,src/java/main/org/apache/jute/compiler/generated/Token.java,99,0,0.0,0,0,0.0,0,0,0.0,0,0,0.0,0,0,0,0,NO
4,src/java/main/org/apache/jute/compiler/generated/TokenMgrError.java,151,0,0.0,0,0,0.0,0,0,0.0,0,0,0.0,0,0,0,0,NO
4,src/java/main/org/apache/zookeeper/AsyncCallback.java,52,0,0.0,0,0,0.0,0,0,0.0,0,0,0.0,0,0,0,0,NO
4,src/java/main/org/apache/zookeeper/ClientCnxn.java,1069,0,0.0,0,0,0.0,0,0,0.0,0,0,0.0,0,0,0,0,YES
4,src/java/main/org/apache/zookeeper/ClientWatchManager.java,39,0,0.0,0,0,0.0,0,0,0.0,0,0,0.0,0,0,0,0,NO
4,src/java/main/org/apache/zookeeper/CreateMode.java,89,0,0.0,0,0,0.0,0,0,0.0,0,0,0.0,0,0,0,0,NO
4,src/java/main/org/apache/zookeeper/Environment.java,100,0,0.0,0,0,0.0,0,0,0.0,0,0,0.0,0,0,0,0,NO
4,src/java/main/org/apache/zookeeper/KeeperException.java,622,0,0.0,0,0,0.0,0,0,0.0,0,0,0.0,0,0,0,0,YES
4,src/java/main/org/apache/zookeeper/Quotas.java,68,0,0.0,0,0,0.0,0,0,0.0,0,0,0.0,0,0,0,0,NO
4,src/java/main/org/apache/zookeeper/ServerAdminClient.java,312,0,0.0,0,0,0.0,0,0,0.0,0,0,0.0,0,0,0,0,NO
4,src/java/main/org/apache/zookeeper/StatsTrack.java,101,0,0.0,0,0,0.0,0,0,0.0,0,0,0.0,0,0,0,0,NO
4,src/java/main/org/apache/zookeeper/Version.java,78,0,0.0,0,0,0.0,0,0,0.0,0,0,0.0,0,0,0,0,NO
4,src/java/main/org/apache/zookeeper/WatchedEvent.java,81,0,0.0,0,0,0.0,0,0,0.0,0,0,0.0,0,0,0,0,NO
4,src/java/main/org/apache/zookeeper/Watcher.java,125,0,0.0,0,0,0.0,0,0,0.0,0,0,0.0,0,0,0,0,NO
4,src/java/main/org/apache/zookeeper/ZooDefs.java,112,0,0.0,0,0,0.0,0,0,0.0,0,0,0.0,0,0,0,0,YES
4,src/java/main/org/apache/zookeeper/ZooKeeper.java,1179,0,0.0,0,0,0.0,0,0,0.0,0,0,0.0,0,0,0,0,YES
4,src/java/main/org/apache/zookeeper/ZooKeeperMain.java,505,0,0.0,0,0,0.0,0,0,0.0,0,0,0.0,0,0,0,0,YES
4,src/java/main/org/apache/zookeeper/common/PathTrie.java,280,0,0.0,0,0,0.0,0,0,0.0,0,0,0.0,0,0,0,0,YES
4,src/java/main/org/apache/zookeeper/jmx/CommonNames.java,29,0,0.0,0,0,0.0,0,0,0.0,0,0,0.0,0,0,0,0,NO
4,src/java/main/org/apache/zookeeper/jmx/MBeanRegistry.java,194,0,0.0,0,0,0.0,0,0,0.0,0,0,0.0,0,0,0,0,NO
4,src/java/main/org/apache/zookeeper/jmx/ManagedUtil.java,72,0,0.0,0,0,0.0,0,0,0.0,0,0,0.0,0,0,0,0,NO
4,src/java/main/org/apache/zookeeper/jmx/ZKMBeanInfo.java,36,0,0.0,0,0,0.0,0,0,0.0,0,0,0.0,0,0,0,0,NO
4,src/java/main/org/apache/zookeeper/server/ByteBufferInputStream.java,72,0,0.0,0,0,0.0,0,0,0.0,0,0,0.0,0,0,0,0,NO
4,src/java/main/org/apache/zookeeper/server/ConnectionBean.java,121,0,0.0,0,0,0.0,0,0,0.0,0,0,0.0,0,0,0,0,NO
4,src/java/main/org/apache/zookeeper/server/ConnectionMXBean.java,68,0,0.0,0,0,0.0,0,0,0.0,0,0,0.0,0,0,0,0,NO
4,src/java/main/org/apache/zookeeper/server/DataNode.java,131,0,0.0,0,0,0.0,0,0,0.0,0,0,0.0,0,0,0,0,NO
4,src/java/main/org/apache/zookeeper/server/DataTree.java,1069,0,0.0,0,0,0.0,0,0,0.0,0,0,0.0,0,0,0,0,YES
4,src/java/main/org/apache/zookeeper/server/DataTreeBean.java,70,0,0.0,0,0,0.0,0,0,0.0,0,0,0.0,0,0,0,0,NO
4,src/java/main/org/apache/zookeeper/server/DataTreeMXBean.java,47,0,0.0,0,0,0.0,0,0,0.0,0,0,0.0,0,0,0,0,NO
4,src/java/main/org/apache/zookeeper/server/FinalRequestProcessor.java,271,4,4.0,4,1,1.0,1,5,5.0,5,3,3.0,3,1,0,1,YES
4,src/java/main/org/apache/zookeeper/server/LogFormatter.java,72,0,0.0,0,0,0.0,0,0,0.0,0,0,0.0,0,0,0,0,NO
4,src/java/main/org/apache/zookeeper/server/NIOServerCnxn.java,973,15,15.0,15,1,1.0,1,16,16.0,16,14,14.0,14,1,0,1,YES
4,src/java/main/org/apache/zookeeper/server/PrepRequestProcessor.java,482,4,4.0,4,0,0.0,0,4,4.0,4,4,4.0,4,1,0,1,YES
4,src/java/main/org/apache/zookeeper/server/PurgeTxnLog.java,132,0,0.0,0,0,0.0,0,0,0.0,0,0,0.0,0,0,0,0,NO
4,src/java/main/org/apache/zookeeper/server/Request.java,197,0,0.0,0,0,0.0,0,0,0.0,0,0,0.0,0,0,0,0,YES
4,src/java/main/org/apache/zookeeper/server/RequestProcessor.java,37,0,0.0,0,0,0.0,0,0,0.0,0,0,0.0,0,0,0,0,NO
4,src/java/main/org/apache/zookeeper/server/ServerCnxn.java,86,0,0.0,0,0,0.0,0,0,0.0,0,0,0.0,0,0,0,0,YES
4,src/java/main/org/apache/zookeeper/server/ServerConfig.java,81,17,17.0,17,3,3.0,3,20,20.0,20,14,14.0,14,1,0,1,NO
4,src/java/main/org/apache/zookeeper/server/ServerStats.java,132,0,0.0,0,0,0.0,0,0,0.0,0,0,0.0,0,0,0,0,NO
4,src/java/main/org/apache/zookeeper/server/SessionTracker.java,58,0,0.0,0,0,0.0,0,0,0.0,0,0,0.0,0,0,0,0,YES
4,src/java/main/org/apache/zookeeper/server/SessionTrackerImpl.java,218,0,0.0,0,0,0.0,0,0,0.0,0,0,0.0,0,0,0,0,YES
4,src/java/main/org/apache/zookeeper/server/SyncRequestProcessor.java,147,7,7.0,7,2,2.0,2,9,9.0,9,5,5.0,5,1,0,1,NO
4,src/java/main/org/apache/zookeeper/server/TraceFormatter.java,119,0,0.0,0,0,0.0,0,0,0.0,0,0,0.0,0,0,0,0,NO
4,src/java/main/org/apache/zookeeper/server/WatchManager.java,111,0,0.0,0,0,0.0,0,0,0.0,0,0,0.0,0,0,0,0,NO
4,src/java/main/org/apache/zookeeper/server/ZooKeeperServer.java,668,6,3.0,6,2,1.0,2,8,4.0,8,4,2.0,4,2,0,1,YES
4,src/java/main/org/apache/zookeeper/server/ZooKeeperServerBean.java,114,0,0.0,0,0,0.0,0,0,0.0,0,0,0.0,0,0,0,0,NO
4,src/java/main/org/apache/zookeeper/server/ZooKeeperServerMXBean.java,82,0,0.0,0,0,0.0,0,0,0.0,0,0,0.0,0,0,0,0,NO
4,src/java/main/org/apache/zookeeper/server/ZooKeeperServerMain.java,99,10,5.0,10,4,2.0,4,14,7.0,14,6,3.0,6,2,1,1,NO
4,src/java/main/org/apache/zookeeper/server/ZooTrace.java,92,0,0.0,0,0,0.0,0,0,0.0,0,0,0.0,0,0,0,0,NO
4,src/java/main/org/apache/zookeeper/server/auth/AuthenticationProvider.java,82,0,0.0,0,0,0.0,0,0,0.0,0,0,0.0,0,0,0,0,NO
4,src/java/main/org/apache/zookeeper/server/auth/DigestAuthenticationProvider.java,128,0,0.0,0,0,0.0,0,0,0.0,0,0,0.0,0,0,0,0,YES
4,src/java/main/org/apache/zookeeper/server/auth/HostAuthenticationProvider.java,69,0,0.0,0,0,0.0,0,0,0.0,0,0,0.0,0,0,0,0,NO
4,src/java/main/org/apache/zookeeper/server/auth/IPAuthenticationProvider.java,117,0,0.0,0,0,0.0,0,0,0.0,0,0,0.0,0,0,0,0,NO
4,src/java/main/org/apache/zookeeper/server/auth/ProviderRegistry.java,78,0,0.0,0,0,0.0,0,0,0.0,0,0,0.0,0,0,0,0,YES
4,src/java/main/org/apache/zookeeper/server/persistence/FileSnap.java,186,0,0.0,0,0,0.0,0,0,0.0,0,0,0.0,0,0,0,0,NO
4,src/java/main/org/apache/zookeeper/server/persistence/FileTxnLog.java,498,20,20.0,20,9,9.0,9,29,29.0,29,11,11.0,11,1,0,1,YES
4,src/java/main/org/apache/zookeeper/server/persistence/FileTxnSnapLog.java,277,2,2.0,2,1,1.0,1,3,3.0,3,1,1.0,1,1,0,1,NO
4,src/java/main/org/apache/zookeeper/server/persistence/SnapShot.java,60,0,0.0,0,0,0.0,0,0,0.0,0,0,0.0,0,0,0,0,NO
4,src/java/main/org/apache/zookeeper/server/persistence/TxnLog.java,115,2,2.0,2,1,1.0,1,3,3.0,3,1,1.0,1,1,0,1,NO
4,src/java/main/org/apache/zookeeper/server/persistence/Util.java,310,0,0.0,0,0,0.0,0,0,0.0,0,0,0.0,0,0,0,0,NO
4,src/java/main/org/apache/zookeeper/server/quorum/AckRequestProcessor.java,45,0,0.0,0,0,0.0,0,0,0.0,0,0,0.0,0,0,0,0,NO
4,src/java/main/org/apache/zookeeper/server/quorum/AuthFastLeaderElection.java,892,0,0.0,0,0,0.0,0,0,0.0,0,0,0.0,0,0,0,0,NO
4,src/java/main/org/apache/zookeeper/server/quorum/CommitProcessor.java,188,3,3.0,3,1,1.0,1,4,4.0,4,2,2.0,2,1,0,1,YES
4,src/java/main/org/apache/zookeeper/server/quorum/Election.java,26,0,0.0,0,0,0.0,0,0,0.0,0,0,0.0,0,0,0,0,NO
4,src/java/main/org/apache/zookeeper/server/quorum/FastLeaderElection.java,654,0,0.0,0,0,0.0,0,0,0.0,0,0,0.0,0,0,0,0,YES
4,src/java/main/org/apache/zookeeper/server/quorum/Follower.java,408,19,19.0,19,14,14.0,14,33,33.0,33,5,5.0,5,1,0,1,YES
4,src/java/main/org/apache/zookeeper/server/quorum/FollowerBean.java,50,0,0.0,0,0,0.0,0,0,0.0,0,0,0.0,0,0,0,0,NO
4,src/java/main/org/apache/zookeeper/server/quorum/FollowerHandler.java,410,15,15.0,15,12,12.0,12,27,27.0,27,3,3.0,3,1,0,1,YES
4,src/java/main/org/apache/zookeeper/server/quorum/FollowerMXBean.java,41,0,0.0,0,0,0.0,0,0,0.0,0,0,0.0,0,0,0,0,NO
4,src/java/main/org/apache/zookeeper/server/quorum/FollowerRequestProcessor.java,106,0,0.0,0,0,0.0,0,0,0.0,0,0,0.0,0,0,0,0,NO
4,src/java/main/org/apache/zookeeper/server/quorum/FollowerSessionTracker.java,85,0,0.0,0,0,0.0,0,0,0.0,0,0,0.0,0,0,0,0,YES
4,src/java/main/org/apache/zookeeper/server/quorum/FollowerSyncRequest.java,34,0,0.0,0,0,0.0,0,0,0.0,0,0,0.0,0,0,0,0,NO
4,src/java/main/org/apache/zookeeper/server/quorum/FollowerZooKeeperServer.java,245,0,0.0,0,0,0.0,0,0,0.0,0,0,0.0,0,0,0,0,NO
4,src/java/main/org/apache/zookeeper/server/quorum/Leader.java,648,61,61.0,61,51,51.0,51,112,112.0,112,10,10.0,10,1,0,1,YES
4,src/java/main/org/apache/zookeeper/server/quorum/LeaderBean.java,53,0,0.0,0,0,0.0,0,0,0.0,0,0,0.0,0,0,0,0,NO
4,src/java/main/org/apache/zookeeper/server/quorum/LeaderElection.java,193,0,0.0,0,0,0.0,0,0,0.0,0,0,0.0,0,0,0,0,YES
4,src/java/main/org/apache/zookeeper/server/quorum/LeaderElectionBean.java,42,0,0.0,0,0,0.0,0,0,0.0,0,0,0.0,0,0,0,0,NO
4,src/java/main/org/apache/zookeeper/server/quorum/LeaderElectionMXBean.java,31,0,0.0,0,0,0.0,0,0,0.0,0,0,0.0,0,0,0,0,NO
4,src/java/main/org/apache/zookeeper/server/quorum/LeaderMXBean.java,36,0,0.0,0,0,0.0,0,0,0.0,0,0,0.0,0,0,0,0,NO
4,src/java/main/org/apache/zookeeper/server/quorum/LeaderZooKeeperServer.java,154,0,0.0,0,0,0.0,0,0,0.0,0,0,0.0,0,0,0,0,YES
4,src/java/main/org/apache/zookeeper/server/quorum/LocalPeerBean.java,68,0,0.0,0,0,0.0,0,0,0.0,0,0,0.0,0,0,0,0,NO
4,src/java/main/org/apache/zookeeper/server/quorum/LocalPeerMXBean.java,64,0,0.0,0,0,0.0,0,0,0.0,0,0,0.0,0,0,0,0,NO
4,src/java/main/org/apache/zookeeper/server/quorum/ProposalRequestProcessor.java,75,0,0.0,0,0,0.0,0,0,0.0,0,0,0.0,0,0,0,0,NO
4,src/java/main/org/apache/zookeeper/server/quorum/QuorumBean.java,44,0,0.0,0,0,0.0,0,0,0.0,0,0,0.0,0,0,0,0,NO
4,src/java/main/org/apache/zookeeper/server/quorum/QuorumCnxManager.java,584,0,0.0,0,0,0.0,0,0,0.0,0,0,0.0,0,0,0,0,YES
4,src/java/main/org/apache/zookeeper/server/quorum/QuorumMXBean.java,34,0,0.0,0,0,0.0,0,0,0.0,0,0,0.0,0,0,0,0,NO
4,src/java/main/org/apache/zookeeper/server/quorum/QuorumPeer.java,650,0,0.0,0,0,0.0,0,0,0.0,0,0,0.0,0,0,0,0,YES
4,src/java/main/org/apache/zookeeper/server/quorum/QuorumPeerConfig.java,220,14,4.6666665,14,15,5.0,15,29,9.666667,29,11,3.6666667,11,3,1,2,NO
4,src/java/main/org/apache/zookeeper/server/quorum/QuorumPeerMain.java,123,0,0.0,0,0,0.0,0,0,0.0,0,0,0.0,0,0,0,0,NO
4,src/java/main/org/apache/zookeeper/server/quorum/QuorumStats.java,67,0,0.0,0,0,0.0,0,0,0.0,0,0,0.0,0,0,0,0,NO
4,src/java/main/org/apache/zookeeper/server/quorum/RemotePeerBean.java,45,0,0.0,0,0,0.0,0,0,0.0,0,0,0.0,0,0,0,0,NO
4,src/java/main/org/apache/zookeeper/server/quorum/RemotePeerMXBean.java,33,0,0.0,0,0,0.0,0,0,0.0,0,0,0.0,0,0,0,0,NO
4,src/java/main/org/apache/zookeeper/server/quorum/SendAckRequestProcessor.java,59,7,7.0,7,2,2.0,2,9,9.0,9,5,5.0,5,1,0,1,YES
4,src/java/main/org/apache/zookeeper/server/quorum/ServerBean.java,38,0,0.0,0,0,0.0,0,0,0.0,0,0,0.0,0,0,0,0,NO
4,src/java/main/org/apache/zookeeper/server/quorum/ServerMXBean.java,33,0,0.0,0,0,0.0,0,0,0.0,0,0,0.0,0,0,0,0,NO
4,src/java/main/org/apache/zookeeper/server/quorum/Vote.java,69,0,0.0,0,0,0.0,0,0,0.0,0,0,0.0,0,0,0,0,YES
4,src/java/main/org/apache/zookeeper/server/upgrade/DataNodeV1.java,129,0,0.0,0,0,0.0,0,0,0.0,0,0,0.0,0,0,0,0,NO
4,src/java/main/org/apache/zookeeper/server/upgrade/DataTreeV1.java,583,0,0.0,0,0,0.0,0,0,0.0,0,0,0.0,0,0,0,0,NO
4,src/java/main/org/apache/zookeeper/server/upgrade/UpgradeMain.java,181,0,0.0,0,0,0.0,0,0,0.0,0,0,0.0,0,0,0,0,NO
4,src/java/main/org/apache/zookeeper/server/upgrade/UpgradeSnapShot.java,33,0,0.0,0,0,0.0,0,0,0.0,0,0,0.0,0,0,0,0,NO
4,src/java/main/org/apache/zookeeper/server/upgrade/UpgradeSnapShotV1.java,327,0,0.0,0,0,0.0,0,0,0.0,0,0,0.0,0,0,0,0,NO
4,src/java/main/org/apache/zookeeper/server/util/Profiler.java,40,0,0.0,0,0,0.0,0,0,0.0,0,0,0.0,0,0,0,0,NO
4,src/java/main/org/apache/zookeeper/server/util/SerializeUtils.java,113,18,18.0,18,10,10.0,10,28,28.0,28,8,8.0,8,1,0,1,NO
4,src/java/main/org/apache/zookeeper/version/util/VerGen.java,128,0,0.0,0,0,0.0,0,0,0.0,0,0,0.0,0,0,0,0,NO
5,src/contrib/bookkeeper/benchmark/org/apache/bookkeeper/benchmark/MySqlClient.java,137,0,0.0,0,0,0.0,0,0,0.0,0,0,0.0,0,0,0,0,NO
5,src/contrib/bookkeeper/benchmark/org/apache/bookkeeper/benchmark/TestClient.java,252,0,0.0,0,0,0.0,0,0,0.0,0,0,0.0,0,0,0,0,NO
5,src/contrib/bookkeeper/src/java/org/apache/bookkeeper/bookie/Bookie.java,362,41,8.2,41,22,4.4,22,63,12.6,63,29,5.8,29,5,2,2,NO
5,src/contrib/bookkeeper/src/java/org/apache/bookkeeper/bookie/BookieException.java,81,81,81.0,81,0,0.0,0,81,81.0,81,81,81.0,81,1,0,1,NO
5,src/contrib/bookkeeper/src/java/org/apache/bookkeeper/bookie/LedgerDescriptor.java,165,12,6.0,12,1,0.5,1,13,6.5,13,11,5.5,11,2,1,1,NO
5,src/contrib/bookkeeper/src/java/org/apache/bookkeeper/client/AsyncCallback.java,81,82,41.0,82,1,0.5,1,83,41.5,83,83,41.5,83,2,0,2,NO
5,src/contrib/bookkeeper/src/java/org/apache/bookkeeper/client/BKDefs.java,107,107,53.5,107,0,0.0,0,107,53.5,107,107,53.5,107,2,0,2,NO
5,src/contrib/bookkeeper/src/java/org/apache/bookkeeper/client/BKException.java,163,34,17.0,34,1,0.5,1,35,17.5,35,33,16.5,33,2,0,1,NO
5,src/contrib/bookkeeper/src/java/org/apache/bookkeeper/client/BookKeeper.java,616,302,50.333332,302,387,64.5,387,689,114.833336,689,363,60.5,363,6,0,3,NO
5,src/contrib/bookkeeper/src/java/org/apache/bookkeeper/client/BookieHandle.java,371,253,50.6,253,132,26.4,132,385,77.0,385,139,27.8,139,5,1,3,YES
5,src/contrib/bookkeeper/src/java/org/apache/bookkeeper/client/ClientCBWorker.java,138,51,10.2,51,25,5.0,25,76,15.2,76,26,5.2,26,5,1,3,NO
5,src/contrib/bookkeeper/src/java/org/apache/bookkeeper/client/LedgerEntry.java,58,0,0.0,0,5,5.0,5,5,5.0,5,5,5.0,5,1,0,1,NO
5,src/contrib/bookkeeper/src/java/org/apache/bookkeeper/client/LedgerHandle.java,844,583,83.28571,583,88,12.571428,88,671,95.85714,671,497,71.0,497,7,1,4,NO
5,src/contrib/bookkeeper/src/java/org/apache/bookkeeper/client/LedgerManagementProcessor.java,1272,1286,643.0,1286,14,7.0,14,1300,650.0,1300,1272,636.0,1272,2,0,2,NO
5,src/contrib/bookkeeper/src/java/org/apache/bookkeeper/client/LedgerRecoveryMonitor.java,245,50,8.333333,50,18,3.0,18,68,11.333333,68,40,6.6666665,40,6,2,4,NO
5,src/contrib/bookkeeper/src/java/org/apache/bookkeeper/client/LedgerSequence.java,65,0,0.0,0,0,0.0,0,0,0.0,0,0,0.0,0,0,0,0,NO
5,src/contrib/bookkeeper/src/java/org/apache/bookkeeper/client/QuorumEngine.java,299,124,24.8,124,90,18.0,90,214,42.8,214,52,10.4,52,5,0,3,NO
5,src/contrib/bookkeeper/src/java/org/apache/bookkeeper/client/QuorumOpMonitor.java,472,163,32.6,163,187,37.4,187,350,70.0,350,48,9.6,48,5,0,3,NO
5,src/contrib/bookkeeper/src/java/org/apache/bookkeeper/proto/BookieClient.java,441,200,50.0,200,101,25.25,101,301,75.25,301,109,27.25,109,4,1,3,NO
5,src/contrib/bookkeeper/src/java/org/apache/bookkeeper/proto/BookieProtocol.java,76,7,7.0,7,1,1.0,1,8,8.0,8,6,6.0,6,1,0,1,NO
5,src/contrib/bookkeeper/src/java/org/apache/bookkeeper/proto/BookieServer.java,199,24,8.0,24,4,1.3333334,4,28,9.333333,28,22,7.3333335,22,3,0,2,NO
5,src/contrib/bookkeeper/src/java/org/apache/bookkeeper/proto/NIOServerFactory.java,527,0,0.0,0,5,2.5,5,5,2.5,5,5,2.5,5,2,1,2,NO
5,src/contrib/bookkeeper/src/java/org/apache/bookkeeper/proto/ReadEntryCallback.java,35,0,0.0,0,0,0.0,0,0,0.0,0,0,0.0,0,0,0,0,NO
5,src/contrib/bookkeeper/src/java/org/apache/bookkeeper/proto/ServerStats.java,133,0,0.0,0,0,0.0,0,0,0.0,0,0,0.0,0,0,0,0,NO
5,src/contrib/bookkeeper/src/java/org/apache/bookkeeper/proto/WriteCallback.java,32,0,0.0,0,0,0.0,0,0,0.0,0,0,0.0,0,0,0,0,NO
5,src/contrib/bookkeeper/src/java/org/apache/bookkeeper/streaming/LedgerInputStream.java,164,164,164.0,164,0,0.0,0,164,164.0,164,164,164.0,164,1,0,1,NO
5,src/contrib/bookkeeper/src/java/org/apache/bookkeeper/streaming/LedgerOutputStream.java,148,148,74.0,148,0,0.0,0,148,74.0,148,148,74.0,148,2,0,2,NO
5,src/contrib/bookkeeper/src/java/org/apache/bookkeeper/util/ClientBase.java,343,0,0.0,0,0,0.0,0,0,0.0,0,0,0.0,0,0,0,0,NO
5,src/contrib/bookkeeper/src/java/org/apache/bookkeeper/util/LocalBookKeeper.java,164,10,10.0,10,10,10.0,10,20,20.0,20,0,0.0,0,1,1,1,NO
5,src/contrib/bookkeeper/src/java/org/apache/bookkeeper/util/Main.java,55,0,0.0,0,0,0.0,0,0,0.0,0,0,0.0,0,0,0,0,NO
5,src/contrib/fatjar/src/java/org/apache/zookeeper/util/FatJarMain.java,126,0,0.0,0,0,0.0,0,0,0.0,0,0,0.0,0,0,0,0,NO
5,src/contrib/rest/src/java/org/apache/zookeeper/server/jersey/RestMain.java,78,78,78.0,78,0,0.0,0,78,78.0,78,78,78.0,78,1,0,1,NO
5,src/contrib/rest/src/java/org/apache/zookeeper/server/jersey/ZooKeeperService.java,110,110,110.0,110,0,0.0,0,110,110.0,110,110,110.0,110,1,0,1,NO
5,src/contrib/rest/src/java/org/apache/zookeeper/server/jersey/jaxb/ZChildren.java,80,80,80.0,80,0,0.0,0,80,80.0,80,80,80.0,80,1,0,1,NO
5,src/contrib/rest/src/java/org/apache/zookeeper/server/jersey/jaxb/ZChildrenJSON.java,76,76,76.0,76,0,0.0,0,76,76.0,76,76,76.0,76,1,0,1,NO
5,src/contrib/rest/src/java/org/apache/zookeeper/server/jersey/jaxb/ZError.java,41,41,41.0,41,0,0.0,0,41,41.0,41,41,41.0,41,1,0,1,NO
5,src/contrib/rest/src/java/org/apache/zookeeper/server/jersey/jaxb/ZPath.java,63,63,63.0,63,0,0.0,0,63,63.0,63,63,63.0,63,1,0,1,NO
5,src/contrib/rest/src/java/org/apache/zookeeper/server/jersey/jaxb/ZStat.java,106,106,106.0,106,0,0.0,0,106,106.0,106,106,106.0,106,1,0,1,NO
5,src/contrib/rest/src/java/org/apache/zookeeper/server/jersey/resources/JAXBContextResolver.java,72,72,72.0,72,0,0.0,0,72,72.0,72,72,72.0,72,1,0,1,NO
5,src/contrib/rest/src/java/org/apache/zookeeper/server/jersey/resources/KeeperExceptionMapper.java,86,86,86.0,86,0,0.0,0,86,86.0,86,86,86.0,86,1,0,1,NO
5,src/contrib/rest/src/java/org/apache/zookeeper/server/jersey/resources/RuntimeExceptionMapper.java,48,48,48.0,48,0,0.0,0,48,48.0,48,48,48.0,48,1,0,1,NO
5,src/contrib/rest/src/java/org/apache/zookeeper/server/jersey/resources/ZErrorWriter.java,63,63,63.0,63,0,0.0,0,63,63.0,63,63,63.0,63,1,0,1,NO
5,src/contrib/rest/src/java/org/apache/zookeeper/server/jersey/resources/ZNodeResource.java,375,375,375.0,375,0,0.0,0,375,375.0,375,375,375.0,375,1,0,1,NO
5,src/java/main/org/apache/jute/BinaryInputArchive.java,131,2,1.0,2,3,1.5,3,5,2.5,5,1,0.5,1,2,0,2,NO
5,src/java/main/org/apache/jute/BinaryOutputArchive.java,146,3,3.0,3,6,6.0,6,9,9.0,9,3,3.0,3,1,0,1,NO
5,src/java/main/org/apache/jute/CsvInputArchive.java,208,2,2.0,2,4,4.0,4,6,6.0,6,2,2.0,2,1,0,1,NO
5,src/java/main/org/apache/jute/CsvOutputArchive.java,150,3,3.0,3,4,4.0,4,7,7.0,7,1,1.0,1,1,0,1,NO
5,src/java/main/org/apache/jute/Index.java,38,0,0.0,0,1,1.0,1,1,1.0,1,1,1.0,1,1,0,1,NO
5,src/java/main/org/apache/jute/InputArchive.java,43,0,0.0,0,2,2.0,2,2,2.0,2,2,2.0,2,1,0,1,NO
5,src/java/main/org/apache/jute/OutputArchive.java,47,0,0.0,0,1,1.0,1,1,1.0,1,1,1.0,1,1,0,1,NO
5,src/java/main/org/apache/jute/Record.java,32,0,0.0,0,1,1.0,1,1,1.0,1,1,1.0,1,1,0,1,NO
5,src/java/main/org/apache/jute/RecordReader.java,93,0,0.0,0,5,5.0,5,5,5.0,5,5,5.0,5,1,0,1,NO
5,src/java/main/org/apache/jute/RecordWriter.java,113,1,1.0,1,5,5.0,5,6,6.0,6,4,4.0,4,1,0,1,NO
5,src/java/main/org/apache/jute/Utils.java,282,0,0.0,0,1,1.0,1,1,1.0,1,1,1.0,1,1,0,1,NO
5,src/java/main/org/apache/jute/XmlInputArchive.java,251,14,14.0,14,14,14.0,14,28,28.0,28,0,0.0,0,1,0,1,NO
5,src/java/main/org/apache/jute/XmlOutputArchive.java,251,10,10.0,10,11,11.0,11,21,21.0,21,1,1.0,1,1,0,1,NO
5,src/java/main/org/apache/jute/compiler/CGenerator.java,91,15,15.0,15,12,12.0,12,27,27.0,27,3,3.0,3,1,0,1,NO
5,src/java/main/org/apache/jute/compiler/CppGenerator.java,86,15,15.0,15,12,12.0,12,27,27.0,27,3,3.0,3,1,0,1,NO
5,src/java/main/org/apache/jute/compiler/JBoolean.java,42,0,0.0,0,1,1.0,1,1,1.0,1,1,1.0,1,1,0,1,NO
5,src/java/main/org/apache/jute/compiler/JBuffer.java,106,1,1.0,1,2,2.0,2,3,3.0,3,1,1.0,1,1,0,1,NO
5,src/java/main/org/apache/jute/compiler/JByte.java,34,0,0.0,0,1,1.0,1,1,1.0,1,1,1.0,1,1,0,1,NO
5,src/java/main/org/apache/jute/compiler/JCompType.java,53,0,0.0,0,2,2.0,2,2,2.0,2,2,2.0,2,1,0,1,NO
5,src/java/main/org/apache/jute/compiler/JDouble.java,40,0,0.0,0,1,1.0,1,1,1.0,1,1,1.0,1,1,0,1,NO
5,src/java/main/org/apache/jute/compiler/JField.java,98,0,0.0,0,1,1.0,1,1,1.0,1,1,1.0,1,1,0,1,NO
5,src/java/main/org/apache/jute/compiler/JFile.java,80,15,15.0,15,10,10.0,10,25,25.0,25,5,5.0,5,1,0,1,NO
5,src/java/main/org/apache/jute/compiler/JFloat.java,39,0,0.0,0,1,1.0,1,1,1.0,1,1,1.0,1,1,0,1,NO
5,src/java/main/org/apache/jute/compiler/JInt.java,34,0,0.0,0,1,1.0,1,1,1.0,1,1,1.0,1,1,0,1,NO
5,src/java/main/org/apache/jute/compiler/JLong.java,38,0,0.0,0,1,1.0,1,1,1.0,1,1,1.0,1,1,0,1,NO
5,src/java/main/org/apache/jute/compiler/JMap.java,103,4,4.0,4,2,2.0,2,6,6.0,6,2,2.0,2,1,0,1,NO
5,src/java/main/org/apache/jute/compiler/JRecord.java,518,63,63.0,63,53,53.0,53,116,116.0,116,10,10.0,10,1,0,1,NO
5,src/java/main/org/apache/jute/compiler/JString.java,46,0,0.0,0,1,1.0,1,1,1.0,1,1,1.0,1,1,0,1,NO
5,src/java/main/org/apache/jute/compiler/JType.java,141,0,0.0,0,1,1.0,1,1,1.0,1,1,1.0,1,1,0,1,NO
5,src/java/main/org/apache/jute/compiler/JVector.java,106,2,2.0,2,2,2.0,2,4,4.0,4,0,0.0,0,1,0,1,NO
5,src/java/main/org/apache/jute/compiler/JavaGenerator.java,57,7,7.0,7,12,12.0,12,19,19.0,19,5,5.0,5,1,0,1,NO
5,src/java/main/org/apache/jute/compiler/generated/ParseException.java,210,0,0.0,0,0,0.0,0,0,0.0,0,0,0.0,0,0,0,0,NO
5,src/java/main/org/apache/jute/compiler/generated/Rcc.java,525,0,0.0,0,0,0.0,0,0,0.0,0,0,0.0,0,0,0,0,NO
5,src/java/main/org/apache/jute/compiler/generated/RccConstants.java,88,0,0.0,0,0,0.0,0,0,0.0,0,0,0.0,0,0,0,0,NO
5,src/java/main/org/apache/jute/compiler/generated/RccTokenManager.java,833,0,0.0,0,0,0.0,0,0,0.0,0,0,0.0,0,0,0,0,NO
5,src/java/main/org/apache/jute/compiler/generated/SimpleCharStream.java,457,0,0.0,0,0,0.0,0,0,0.0,0,0,0.0,0,0,0,0,NO
5,src/java/main/org/apache/jute/compiler/generated/Token.java,99,0,0.0,0,0,0.0,0,0,0.0,0,0,0.0,0,0,0,0,NO
5,src/java/main/org/apache/jute/compiler/generated/TokenMgrError.java,151,0,0.0,0,0,0.0,0,0,0.0,0,0,0.0,0,0,0,0,NO
5,src/java/main/org/apache/zookeeper/AsyncCallback.java,52,0,0.0,0,0,0.0,0,0,0.0,0,0,0.0,0,0,0,0,NO
5,src/java/main/org/apache/zookeeper/ClientCnxn.java,1141,113,18.833334,113,41,6.8333335,41,154,25.666666,154,72,12.0,72,6,1,2,NO
5,src/java/main/org/apache/zookeeper/ClientWatchManager.java,39,0,0.0,0,0,0.0,0,0,0.0,0,0,0.0,0,0,0,0,NO
5,src/java/main/org/apache/zookeeper/CreateMode.java,89,0,0.0,0,0,0.0,0,0,0.0,0,0,0.0,0,0,0,0,NO
5,src/java/main/org/apache/zookeeper/Environment.java,100,1,1.0,1,1,1.0,1,2,2.0,2,0,0.0,0,1,0,1,NO
5,src/java/main/org/apache/zookeeper/JLineZNodeCompletor.java,84,84,84.0,84,0,0.0,0,84,84.0,84,84,84.0,84,1,0,1,NO
5,src/java/main/org/apache/zookeeper/KeeperException.java,641,43,14.333333,43,24,8.0,24,67,22.333334,67,19,6.3333335,19,3,2,1,NO
5,src/java/main/org/apache/zookeeper/Quotas.java,68,0,0.0,0,0,0.0,0,0,0.0,0,0,0.0,0,0,0,0,NO
5,src/java/main/org/apache/zookeeper/ServerAdminClient.java,312,0,0.0,0,0,0.0,0,0,0.0,0,0,0.0,0,0,0,0,NO
5,src/java/main/org/apache/zookeeper/StatsTrack.java,101,0,0.0,0,0,0.0,0,0,0.0,0,0,0.0,0,0,0,0,NO
5,src/java/main/org/apache/zookeeper/Version.java,78,0,0.0,0,0,0.0,0,0,0.0,0,0,0.0,0,0,0,0,NO
5,src/java/main/org/apache/zookeeper/WatchedEvent.java,81,0,0.0,0,0,0.0,0,0,0.0,0,0,0.0,0,0,0,0,NO
5,src/java/main/org/apache/zookeeper/Watcher.java,125,0,0.0,0,0,0.0,0,0,0.0,0,0,0.0,0,0,0,0,NO
5,src/java/main/org/apache/zookeeper/ZooDefs.java,112,2,2.0,2,2,2.0,2,4,4.0,4,0,0.0,0,1,1,1,NO
5,src/java/main/org/apache/zookeeper/ZooKeeper.java,1270,342,57.0,342,251,41.833332,251,593,98.833336,593,217,36.166668,217,6,2,2,YES
5,src/java/main/org/apache/zookeeper/ZooKeeperMain.java,829,548,45.666668,548,224,18.666666,224,772,64.333336,772,330,27.5,330,12,1,2,YES
5,src/java/main/org/apache/zookeeper/common/PathTrie.java,280,0,0.0,0,0,0.0,0,0,0.0,0,0,0.0,0,0,0,0,YES
5,src/java/main/org/apache/zookeeper/common/PathUtils.java,103,103,103.0,103,0,0.0,0,103,103.0,103,103,103.0,103,1,1,1,NO
5,src/java/main/org/apache/zookeeper/jmx/CommonNames.java,29,0,0.0,0,0,0.0,0,0,0.0,0,0,0.0,0,0,0,0,NO
5,src/java/main/org/apache/zookeeper/jmx/MBeanRegistry.java,194,0,0.0,0,0,0.0,0,0,0.0,0,0,0.0,0,0,0,0,NO
5,src/java/main/org/apache/zookeeper/jmx/ManagedUtil.java,72,0,0.0,0,0,0.0,0,0,0.0,0,0,0.0,0,0,0,0,NO
5,src/java/main/org/apache/zookeeper/jmx/ZKMBeanInfo.java,36,0,0.0,0,0,0.0,0,0,0.0,0,0,0.0,0,0,0,0,NO
5,src/java/main/org/apache/zookeeper/server/ByteBufferInputStream.java,72,0,0.0,0,0,0.0,0,0,0.0,0,0,0.0,0,0,0,0,NO
5,src/java/main/org/apache/zookeeper/server/ConnectionBean.java,121,0,0.0,0,0,0.0,0,0,0.0,0,0,0.0,0,0,0,0,NO
5,src/java/main/org/apache/zookeeper/server/ConnectionMXBean.java,68,0,0.0,0,0,0.0,0,0,0.0,0,0,0.0,0,0,0,0,NO
5,src/java/main/org/apache/zookeeper/server/DataNode.java,133,19,6.3333335,19,17,5.6666665,17,36,12.0,36,6,2.0,6,3,0,2,NO
5,src/java/main/org/apache/zookeeper/server/DataTree.java,1112,111,22.2,111,68,13.6,68,179,35.8,179,115,23.0,115,5,1,2,NO
5,src/java/main/org/apache/zookeeper/server/DataTreeBean.java,70,0,0.0,0,0,0.0,0,0,0.0,0,0,0.0,0,0,0,0,NO
5,src/java/main/org/apache/zookeeper/server/DataTreeMXBean.java,47,0,0.0,0,0,0.0,0,0,0.0,0,0,0.0,0,0,0,0,NO
5,src/java/main/org/apache/zookeeper/server/FinalRequestProcessor.java,286,35,5.8333335,35,20,3.3333333,20,55,9.166667,55,31,5.1666665,31,6,1,2,NO
5,src/java/main/org/apache/zookeeper/server/LogFormatter.java,72,0,0.0,0,0,0.0,0,0,0.0,0,0,0.0,0,0,0,0,NO
5,src/java/main/org/apache/zookeeper/server/NIOServerCnxn.java,1049,117,16.714285,117,41,5.857143,41,158,22.571428,158,86,12.285714,86,7,3,2,YES
5,src/java/main/org/apache/zookeeper/server/PrepRequestProcessor.java,506,59,6.5555553,59,35,3.8888888,35,94,10.444445,94,42,4.6666665,42,9,3,2,YES
5,src/java/main/org/apache/zookeeper/server/PurgeTxnLog.java,132,0,0.0,0,0,0.0,0,0,0.0,0,0,0.0,0,0,0,0,NO
5,src/java/main/org/apache/zookeeper/server/Request.java,218,21,21.0,21,0,0.0,0,21,21.0,21,21,21.0,21,1,1,1,NO
5,src/java/main/org/apache/zookeeper/server/RequestProcessor.java,37,0,0.0,0,0,0.0,0,0,0.0,0,0,0.0,0,0,0,0,NO
5,src/java/main/org/apache/zookeeper/server/ServerCnxn.java,84,0,0.0,0,2,2.0,2,2,2.0,2,2,2.0,2,1,1,1,YES
5,src/java/main/org/apache/zookeeper/server/ServerConfig.java,94,73,24.333334,73,60,20.0,60,133,44.333332,133,15,5.0,15,3,0,2,NO
5,src/java/main/org/apache/zookeeper/server/ServerStats.java,132,0,0.0,0,0,0.0,0,0,0.0,0,0,0.0,0,0,0,0,NO
5,src/java/main/org/apache/zookeeper/server/SessionTracker.java,62,5,5.0,5,1,1.0,1,6,6.0,6,4,4.0,4,1,1,1,NO
5,src/java/main/org/apache/zookeeper/server/SessionTrackerImpl.java,242,52,10.4,52,28,5.6,28,80,16.0,80,34,6.8,34,5,2,3,NO
5,src/java/main/org/apache/zookeeper/server/SyncRequestProcessor.java,161,21,5.25,21,7,1.75,7,28,7.0,28,16,4.0,16,4,0,2,NO
5,src/java/main/org/apache/zookeeper/server/TraceFormatter.java,119,0,0.0,0,0,0.0,0,0,0.0,0,0,0.0,0,0,0,0,NO
5,src/java/main/org/apache/zookeeper/server/WatchManager.java,113,5,5.0,5,3,3.0,3,8,8.0,8,2,2.0,2,1,0,1,NO
5,src/java/main/org/apache/zookeeper/server/ZooKeeperServer.java,677,21,5.25,21,12,3.0,12,33,8.25,33,11,2.75,11,4,1,2,YES
5,src/java/main/org/apache/zookeeper/server/ZooKeeperServerBean.java,114,0,0.0,0,0,0.0,0,0,0.0,0,0,0.0,0,0,0,0,NO
5,src/java/main/org/apache/zookeeper/server/ZooKeeperServerMXBean.java,82,0,0.0,0,0,0.0,0,0,0.0,0,0,0.0,0,0,0,0,NO
5,src/java/main/org/apache/zookeeper/server/ZooKeeperServerMain.java,124,72,18.0,72,47,11.75,47,119,29.75,119,27,6.75,27,4,0,2,NO
5,src/java/main/org/apache/zookeeper/server/ZooTrace.java,92,0,0.0,0,0,0.0,0,0,0.0,0,0,0.0,0,0,0,0,NO
5,src/java/main/org/apache/zookeeper/server/auth/AuthenticationProvider.java,82,0,0.0,0,0,0.0,0,0,0.0,0,0,0.0,0,0,0,0,NO
5,src/java/main/org/apache/zookeeper/server/auth/DigestAuthenticationProvider.java,138,15,15.0,15,5,5.0,5,20,20.0,20,10,10.0,10,1,1,1,NO
5,src/java/main/org/apache/zookeeper/server/auth/IPAuthenticationProvider.java,117,0,0.0,0,0,0.0,0,0,0.0,0,0,0.0,0,0,0,0,NO
5,src/java/main/org/apache/zookeeper/server/auth/ProviderRegistry.java,76,0,0.0,0,2,2.0,2,2,2.0,2,2,2.0,2,1,1,1,NO
5,src/java/main/org/apache/zookeeper/server/persistence/FileSnap.java,236,77,77.0,77,27,27.0,27,104,104.0,104,50,50.0,50,1,0,1,NO
5,src/java/main/org/apache/zookeeper/server/persistence/FileTxnLog.java,504,273,91.0,273,267,89.0,267,540,180.0,540,18,6.0,18,3,0,2,YES
5,src/java/main/org/apache/zookeeper/server/persistence/FileTxnSnapLog.java,287,33,8.25,33,23,5.75,23,56,14.0,56,22,5.5,22,4,0,2,NO
5,src/java/main/org/apache/zookeeper/server/persistence/SnapShot.java,60,0,0.0,0,0,0.0,0,0,0.0,0,0,0.0,0,0,0,0,NO
5,src/java/main/org/apache/zookeeper/server/persistence/TxnLog.java,115,0,0.0,0,0,0.0,0,0,0.0,0,0,0.0,0,0,0,0,NO
5,src/java/main/org/apache/zookeeper/server/persistence/Util.java,325,36,12.0,36,21,7.0,21,57,19.0,57,45,15.0,45,3,0,2,NO
5,src/java/main/org/apache/zookeeper/server/quorum/AckRequestProcessor.java,53,10,5.0,10,2,1.0,2,12,6.0,12,8,4.0,8,2,0,2,NO
5,src/java/main/org/apache/zookeeper/server/quorum/AuthFastLeaderElection.java,957,213,71.0,213,148,49.333332,148,361,120.333336,361,71,23.666666,71,3,0,2,NO
5,src/java/main/org/apache/zookeeper/server/quorum/CommitProcessor.java,187,2,2.0,2,3,3.0,3,5,5.0,5,1,1.0,1,1,0,1,YES
5,src/java/main/org/apache/zookeeper/server/quorum/Election.java,26,0,0.0,0,0,0.0,0,0,0.0,0,0,0.0,0,0,0,0,NO
5,src/java/main/org/apache/zookeeper/server/quorum/FastLeaderElection.java,692,177,29.5,177,139,23.166666,139,316,52.666668,316,46,7.6666665,46,6,2,2,YES
5,src/java/main/org/apache/zookeeper/server/quorum/Follower.java,429,32,8.0,32,11,2.75,11,43,10.75,43,21,5.25,21,4,1,2,YES
5,src/java/main/org/apache/zookeeper/server/quorum/FollowerBean.java,50,0,0.0,0,0,0.0,0,0,0.0,0,0,0.0,0,0,0,0,NO
5,src/java/main/org/apache/zookeeper/server/quorum/FollowerHandler.java,448,60,8.571428,60,22,3.142857,22,82,11.714286,82,48,6.857143,48,7,1,2,YES
5,src/java/main/org/apache/zookeeper/server/quorum/FollowerMXBean.java,41,0,0.0,0,0,0.0,0,0,0.0,0,0,0.0,0,0,0,0,NO
5,src/java/main/org/apache/zookeeper/server/quorum/FollowerRequestProcessor.java,109,6,2.0,6,3,1.0,3,9,3.0,9,5,1.6666666,5,3,0,2,NO
5,src/java/main/org/apache/zookeeper/server/quorum/FollowerSessionTracker.java,89,5,5.0,5,1,1.0,1,6,6.0,6,4,4.0,4,1,1,1,NO
5,src/java/main/org/apache/zookeeper/server/quorum/FollowerSyncRequest.java,34,0,0.0,0,0,0.0,0,0,0.0,0,0,0.0,0,0,0,0,NO
5,src/java/main/org/apache/zookeeper/server/quorum/FollowerZooKeeperServer.java,248,3,1.5,3,0,0.0,0,3,1.5,3,3,1.5,3,2,0,1,NO
5,src/java/main/org/apache/zookeeper/server/quorum/Leader.java,672,49,24.5,49,25,12.5,25,74,37.0,74,24,12.0,24,2,0,2,YES
5,src/java/main/org/apache/zookeeper/server/quorum/LeaderBean.java,53,0,0.0,0,0,0.0,0,0,0.0,0,0,0.0,0,0,0,0,NO
5,src/java/main/org/apache/zookeeper/server/quorum/LeaderElection.java,230,115,38.333332,115,78,26.0,78,193,64.333336,193,37,12.333333,37,3,1,2,NO
5,src/java/main/org/apache/zookeeper/server/quorum/LeaderElectionBean.java,42,0,0.0,0,0,0.0,0,0,0.0,0,0,0.0,0,0,0,0,NO
5,src/java/main/org/apache/zookeeper/server/quorum/LeaderElectionMXBean.java,31,0,0.0,0,0,0.0,0,0,0.0,0,0,0.0,0,0,0,0,NO
5,src/java/main/org/apache/zookeeper/server/quorum/LeaderMXBean.java,36,0,0.0,0,0,0.0,0,0,0.0,0,0,0.0,0,0,0,0,NO
5,src/java/main/org/apache/zookeeper/server/quorum/LeaderZooKeeperServer.java,171,25,4.1666665,25,8,1.3333334,8,33,5.5,33,23,3.8333333,23,6,1,2,YES
5,src/java/main/org/apache/zookeeper/server/quorum/LocalPeerBean.java,68,0,0.0,0,0,0.0,0,0,0.0,0,0,0.0,0,0,0,0,NO
5,src/java/main/org/apache/zookeeper/server/quorum/LocalPeerMXBean.java,64,0,0.0,0,0,0.0,0,0,0.0,0,0,0.0,0,0,0,0,NO
5,src/java/main/org/apache/zookeeper/server/quorum/ProposalRequestProcessor.java,82,17,3.4,17,10,2.0,10,27,5.4,27,19,3.8,19,5,0,2,NO
5,src/java/main/org/apache/zookeeper/server/quorum/QuorumBean.java,44,0,0.0,0,0,0.0,0,0,0.0,0,0,0.0,0,0,0,0,NO
5,src/java/main/org/apache/zookeeper/server/quorum/QuorumCnxManager.java,576,125,15.625,125,133,16.625,133,258,32.25,258,78,9.75,78,8,4,2,YES
5,src/java/main/org/apache/zookeeper/server/quorum/QuorumMXBean.java,34,0,0.0,0,0,0.0,0,0,0.0,0,0,0.0,0,0,0,0,NO
5,src/java/main/org/apache/zookeeper/server/quorum/QuorumPeer.java,711,80,10.0,80,19,2.375,19,99,12.375,99,83,10.375,83,8,0,2,YES
5,src/java/main/org/apache/zookeeper/server/quorum/QuorumPeerConfig.java,279,154,30.8,154,95,19.0,95,249,49.8,249,83,16.6,83,5,0,2,NO
5,src/java/main/org/apache/zookeeper/server/quorum/QuorumPeerMain.java,148,115,28.75,115,90,22.5,90,205,51.25,205,25,6.25,25,4,0,2,NO
5,src/java/main/org/apache/zookeeper/server/quorum/QuorumStats.java,67,0,0.0,0,0,0.0,0,0,0.0,0,0,0.0,0,0,0,0,NO
5,src/java/main/org/apache/zookeeper/server/quorum/RemotePeerBean.java,45,0,0.0,0,0,0.0,0,0,0.0,0,0,0.0,0,0,0,0,NO
5,src/java/main/org/apache/zookeeper/server/quorum/RemotePeerMXBean.java,33,0,0.0,0,0,0.0,0,0,0.0,0,0,0.0,0,0,0,0,NO
5,src/java/main/org/apache/zookeeper/server/quorum/SendAckRequestProcessor.java,59,0,0.0,0,0,0.0,0,0,0.0,0,0,0.0,0,0,0,0,YES
5,src/java/main/org/apache/zookeeper/server/quorum/ServerBean.java,38,0,0.0,0,0,0.0,0,0,0.0,0,0,0.0,0,0,0,0,NO
5,src/java/main/org/apache/zookeeper/server/quorum/ServerMXBean.java,33,0,0.0,0,0,0.0,0,0,0.0,0,0,0.0,0,0,0,0,NO
5,src/java/main/org/apache/zookeeper/server/quorum/Vote.java,69,0,0.0,0,0,0.0,0,0,0.0,0,0,0.0,0,0,0,0,YES
5,src/java/main/org/apache/zookeeper/server/quorum/flexible/QuorumHierarchical.java,249,249,249.0,249,0,0.0,0,249,249.0,249,249,249.0,249,1,0,1,YES
5,src/java/main/org/apache/zookeeper/server/quorum/flexible/QuorumMaj.java,46,46,46.0,46,0,0.0,0,46,46.0,46,46,46.0,46,1,0,1,NO
5,src/java/main/org/apache/zookeeper/server/quorum/flexible/QuorumVerifier.java,32,32,32.0,32,0,0.0,0,32,32.0,32,32,32.0,32,1,0,1,NO
5,src/java/main/org/apache/zookeeper/server/upgrade/DataNodeV1.java,129,0,0.0,0,0,0.0,0,0,0.0,0,0,0.0,0,0,0,0,NO
5,src/java/main/org/apache/zookeeper/server/upgrade/DataTreeV1.java,583,0,0.0,0,0,0.0,0,0,0.0,0,0,0.0,0,0,0,0,NO
5,src/java/main/org/apache/zookeeper/server/upgrade/UpgradeMain.java,180,0,0.0,0,1,1.0,1,1,1.0,1,1,1.0,1,1,0,1,NO
5,src/java/main/org/apache/zookeeper/server/upgrade/UpgradeSnapShot.java,33,0,0.0,0,0,0.0,0,0,0.0,0,0,0.0,0,0,0,0,NO
5,src/java/main/org/apache/zookeeper/server/upgrade/UpgradeSnapShotV1.java,333,19,19.0,19,13,13.0,13,32,32.0,32,6,6.0,6,1,0,1,NO
5,src/java/main/org/apache/zookeeper/server/util/Profiler.java,40,0,0.0,0,0,0.0,0,0,0.0,0,0,0.0,0,0,0,0,NO
5,src/java/main/org/apache/zookeeper/server/util/SerializeUtils.java,107,15,7.5,15,21,10.5,21,36,18.0,36,10,5.0,10,2,0,2,NO
5,src/java/main/org/apache/zookeeper/version/util/VerGen.java,128,0,0.0,0,0,0.0,0,0,0.0,0,0,0.0,0,0,0,0,NO
5,src/recipes/lock/src/java/org/apache/zookeeper/recipes/lock/LockListener.java,38,38,38.0,38,0,0.0,0,38,38.0,38,38,38.0,38,1,0,1,NO
5,src/recipes/lock/src/java/org/apache/zookeeper/recipes/lock/ProtocolSupport.java,192,192,192.0,192,0,0.0,0,192,192.0,192,192,192.0,192,1,0,1,NO
5,src/recipes/lock/src/java/org/apache/zookeeper/recipes/lock/WriteLock.java,294,295,295.0,295,0,0.0,0,295,295.0,295,295,295.0,295,1,0,1,NO
5,src/recipes/lock/src/java/org/apache/zookeeper/recipes/lock/ZNodeName.java,109,109,109.0,109,0,0.0,0,109,109.0,109,109,109.0,109,1,0,1,NO
5,src/recipes/lock/src/java/org/apache/zookeeper/recipes/lock/ZooKeeperOperation.java,38,38,38.0,38,0,0.0,0,38,38.0,38,38,38.0,38,1,0,1,NO
6,src/contrib/bookkeeper/benchmark/org/apache/bookkeeper/benchmark/MySqlClient.java,137,0,0.0,0,0,0.0,0,0,0.0,0,0,0.0,0,0,0,0,NO
6,src/contrib/bookkeeper/benchmark/org/apache/bookkeeper/benchmark/TestClient.java,252,0,0.0,0,0,0.0,0,0,0.0,0,0,0.0,0,0,0,0,NO
6,src/contrib/bookkeeper/src/java/org/apache/bookkeeper/bookie/Bookie.java,362,0,0.0,0,0,0.0,0,0,0.0,0,0,0.0,0,0,0,0,NO
6,src/contrib/bookkeeper/src/java/org/apache/bookkeeper/bookie/BookieException.java,81,0,0.0,0,0,0.0,0,0,0.0,0,0,0.0,0,0,0,0,NO
6,src/contrib/bookkeeper/src/java/org/apache/bookkeeper/bookie/LedgerDescriptor.java,165,0,0.0,0,0,0.0,0,0,0.0,0,0,0.0,0,0,0,0,NO
6,src/contrib/bookkeeper/src/java/org/apache/bookkeeper/client/AsyncCallback.java,81,0,0.0,0,0,0.0,0,0,0.0,0,0,0.0,0,0,0,0,NO
6,src/contrib/bookkeeper/src/java/org/apache/bookkeeper/client/BKDefs.java,107,0,0.0,0,0,0.0,0,0,0.0,0,0,0.0,0,0,0,0,NO
6,src/contrib/bookkeeper/src/java/org/apache/bookkeeper/client/BKException.java,163,0,0.0,0,0,0.0,0,0,0.0,0,0,0.0,0,0,0,0,NO
6,src/contrib/bookkeeper/src/java/org/apache/bookkeeper/client/BookKeeper.java,616,0,0.0,0,0,0.0,0,0,0.0,0,0,0.0,0,0,0,0,NO
6,src/contrib/bookkeeper/src/java/org/apache/bookkeeper/client/BookieHandle.java,371,1,1.0,1,1,1.0,1,2,2.0,2,0,0.0,0,1,1,1,NO
6,src/contrib/bookkeeper/src/java/org/apache/bookkeeper/client/ClientCBWorker.java,138,0,0.0,0,0,0.0,0,0,0.0,0,0,0.0,0,0,0,0,NO
6,src/contrib/bookkeeper/src/java/org/apache/bookkeeper/client/LedgerEntry.java,58,0,0.0,0,0,0.0,0,0,0.0,0,0,0.0,0,0,0,0,NO
6,src/contrib/bookkeeper/src/java/org/apache/bookkeeper/client/LedgerHandle.java,844,0,0.0,0,0,0.0,0,0,0.0,0,0,0.0,0,0,0,0,NO
6,src/contrib/bookkeeper/src/java/org/apache/bookkeeper/client/LedgerManagementProcessor.java,1272,0,0.0,0,0,0.0,0,0,0.0,0,0,0.0,0,0,0,0,NO
6,src/contrib/bookkeeper/src/java/org/apache/bookkeeper/client/LedgerRecoveryMonitor.java,245,0,0.0,0,0,0.0,0,0,0.0,0,0,0.0,0,0,0,0,NO
6,src/contrib/bookkeeper/src/java/org/apache/bookkeeper/client/LedgerSequence.java,65,0,0.0,0,0,0.0,0,0,0.0,0,0,0.0,0,0,0,0,NO
6,src/contrib/bookkeeper/src/java/org/apache/bookkeeper/client/QuorumEngine.java,299,0,0.0,0,0,0.0,0,0,0.0,0,0,0.0,0,0,0,0,NO
6,src/contrib/bookkeeper/src/java/org/apache/bookkeeper/client/QuorumOpMonitor.java,472,0,0.0,0,0,0.0,0,0,0.0,0,0,0.0,0,0,0,0,NO
6,src/contrib/bookkeeper/src/java/org/apache/bookkeeper/proto/BookieClient.java,441,0,0.0,0,0,0.0,0,0,0.0,0,0,0.0,0,0,0,0,NO
6,src/contrib/bookkeeper/src/java/org/apache/bookkeeper/proto/BookieProtocol.java,76,0,0.0,0,0,0.0,0,0,0.0,0,0,0.0,0,0,0,0,NO
6,src/contrib/bookkeeper/src/java/org/apache/bookkeeper/proto/BookieServer.java,199,0,0.0,0,0,0.0,0,0,0.0,0,0,0.0,0,0,0,0,NO
6,src/contrib/bookkeeper/src/java/org/apache/bookkeeper/proto/NIOServerFactory.java,527,0,0.0,0,0,0.0,0,0,0.0,0,0,0.0,0,0,0,0,NO
6,src/contrib/bookkeeper/src/java/org/apache/bookkeeper/proto/ReadEntryCallback.java,35,0,0.0,0,0,0.0,0,0,0.0,0,0,0.0,0,0,0,0,NO
6,src/contrib/bookkeeper/src/java/org/apache/bookkeeper/proto/ServerStats.java,133,0,0.0,0,0,0.0,0,0,0.0,0,0,0.0,0,0,0,0,NO
6,src/contrib/bookkeeper/src/java/org/apache/bookkeeper/proto/WriteCallback.java,32,0,0.0,0,0,0.0,0,0,0.0,0,0,0.0,0,0,0,0,NO
6,src/contrib/bookkeeper/src/java/org/apache/bookkeeper/streaming/LedgerInputStream.java,164,0,0.0,0,0,0.0,0,0,0.0,0,0,0.0,0,0,0,0,YES
6,src/contrib/bookkeeper/src/java/org/apache/bookkeeper/streaming/LedgerOutputStream.java,148,0,0.0,0,0,0.0,0,0,0.0,0,0,0.0,0,0,0,0,NO
6,src/contrib/bookkeeper/src/java/org/apache/bookkeeper/util/ClientBase.java,343,0,0.0,0,0,0.0,0,0,0.0,0,0,0.0,0,0,0,0,NO
6,src/contrib/bookkeeper/src/java/org/apache/bookkeeper/util/LocalBookKeeper.java,164,0,0.0,0,0,0.0,0,0,0.0,0,0,0.0,0,0,0,0,YES
6,src/contrib/bookkeeper/src/java/org/apache/bookkeeper/util/Main.java,55,0,0.0,0,0,0.0,0,0,0.0,0,0,0.0,0,0,0,0,NO
6,src/contrib/fatjar/src/java/org/apache/zookeeper/util/FatJarMain.java,126,0,0.0,0,0,0.0,0,0,0.0,0,0,0.0,0,0,0,0,NO
6,src/contrib/rest/src/java/org/apache/zookeeper/server/jersey/RestMain.java,78,0,0.0,0,0,0.0,0,0,0.0,0,0,0.0,0,0,0,0,NO
6,src/contrib/rest/src/java/org/apache/zookeeper/server/jersey/ZooKeeperService.java,110,0,0.0,0,0,0.0,0,0,0.0,0,0,0.0,0,0,0,0,NO
6,src/contrib/rest/src/java/org/apache/zookeeper/server/jersey/jaxb/ZChildren.java,80,0,0.0,0,0,0.0,0,0,0.0,0,0,0.0,0,0,0,0,NO
6,src/contrib/rest/src/java/org/apache/zookeeper/server/jersey/jaxb/ZChildrenJSON.java,76,0,0.0,0,0,0.0,0,0,0.0,0,0,0.0,0,0,0,0,NO
6,src/contrib/rest/src/java/org/apache/zookeeper/server/jersey/jaxb/ZError.java,41,0,0.0,0,0,0.0,0,0,0.0,0,0,0.0,0,0,0,0,NO
6,src/contrib/rest/src/java/org/apache/zookeeper/server/jersey/jaxb/ZPath.java,63,0,0.0,0,0,0.0,0,0,0.0,0,0,0.0,0,0,0,0,NO
6,src/contrib/rest/src/java/org/apache/zookeeper/server/jersey/jaxb/ZStat.java,106,0,0.0,0,0,0.0,0,0,0.0,0,0,0.0,0,0,0,0,NO
6,src/contrib/rest/src/java/org/apache/zookeeper/server/jersey/resources/JAXBContextResolver.java,72,0,0.0,0,0,0.0,0,0,0.0,0,0,0.0,0,0,0,0,NO
6,src/contrib/rest/src/java/org/apache/zookeeper/server/jersey/resources/KeeperExceptionMapper.java,86,0,0.0,0,0,0.0,0,0,0.0,0,0,0.0,0,0,0,0,NO
6,src/contrib/rest/src/java/org/apache/zookeeper/server/jersey/resources/RuntimeExceptionMapper.java,48,0,0.0,0,0,0.0,0,0,0.0,0,0,0.0,0,0,0,0,NO
6,src/contrib/rest/src/java/org/apache/zookeeper/server/jersey/resources/ZErrorWriter.java,63,0,0.0,0,0,0.0,0,0,0.0,0,0,0.0,0,0,0,0,NO
6,src/contrib/rest/src/java/org/apache/zookeeper/server/jersey/resources/ZNodeResource.java,375,0,0.0,0,0,0.0,0,0,0.0,0,0,0.0,0,0,0,0,NO
6,src/java/main/org/apache/jute/BinaryInputArchive.java,131,0,0.0,0,0,0.0,0,0,0.0,0,0,0.0,0,0,0,0,NO
6,src/java/main/org/apache/jute/BinaryOutputArchive.java,146,0,0.0,0,0,0.0,0,0,0.0,0,0,0.0,0,0,0,0,NO
6,src/java/main/org/apache/jute/CsvInputArchive.java,208,0,0.0,0,0,0.0,0,0,0.0,0,0,0.0,0,0,0,0,NO
6,src/java/main/org/apache/jute/CsvOutputArchive.java,150,0,0.0,0,0,0.0,0,0,0.0,0,0,0.0,0,0,0,0,NO
6,src/java/main/org/apache/jute/Index.java,38,0,0.0,0,0,0.0,0,0,0.0,0,0,0.0,0,0,0,0,NO
6,src/java/main/org/apache/jute/InputArchive.java,43,0,0.0,0,0,0.0,0,0,0.0,0,0,0.0,0,0,0,0,NO
6,src/java/main/org/apache/jute/OutputArchive.java,47,0,0.0,0,0,0.0,0,0,0.0,0,0,0.0,0,0,0,0,NO
6,src/java/main/org/apache/jute/Record.java,32,0,0.0,0,0,0.0,0,0,0.0,0,0,0.0,0,0,0,0,NO
6,src/java/main/org/apache/jute/RecordReader.java,93,0,0.0,0,0,0.0,0,0,0.0,0,0,0.0,0,0,0,0,NO
6,src/java/main/org/apache/jute/RecordWriter.java,113,0,0.0,0,0,0.0,0,0,0.0,0,0,0.0,0,0,0,0,NO
6,src/java/main/org/apache/jute/Utils.java,282,0,0.0,0,0,0.0,0,0,0.0,0,0,0.0,0,0,0,0,NO
6,src/java/main/org/apache/jute/XmlInputArchive.java,251,0,0.0,0,0,0.0,0,0,0.0,0,0,0.0,0,0,0,0,NO
6,src/java/main/org/apache/jute/XmlOutputArchive.java,251,0,0.0,0,0,0.0,0,0,0.0,0,0,0.0,0,0,0,0,NO
6,src/java/main/org/apache/jute/compiler/CGenerator.java,91,0,0.0,0,0,0.0,0,0,0.0,0,0,0.0,0,0,0,0,NO
6,src/java/main/org/apache/jute/compiler/CppGenerator.java,86,0,0.0,0,0,0.0,0,0,0.0,0,0,0.0,0,0,0,0,NO
6,src/java/main/org/apache/jute/compiler/JBoolean.java,42,0,0.0,0,0,0.0,0,0,0.0,0,0,0.0,0,0,0,0,NO
6,src/java/main/org/apache/jute/compiler/JBuffer.java,106,0,0.0,0,0,0.0,0,0,0.0,0,0,0.0,0,0,0,0,NO
6,src/java/main/org/apache/jute/compiler/JByte.java,34,0,0.0,0,0,0.0,0,0,0.0,0,0,0.0,0,0,0,0,NO
6,src/java/main/org/apache/jute/compiler/JCompType.java,53,0,0.0,0,0,0.0,0,0,0.0,0,0,0.0,0,0,0,0,NO
6,src/java/main/org/apache/jute/compiler/JDouble.java,40,0,0.0,0,0,0.0,0,0,0.0,0,0,0.0,0,0,0,0,NO
6,src/java/main/org/apache/jute/compiler/JField.java,98,0,0.0,0,0,0.0,0,0,0.0,0,0,0.0,0,0,0,0,NO
6,src/java/main/org/apache/jute/compiler/JFile.java,80,0,0.0,0,0,0.0,0,0,0.0,0,0,0.0,0,0,0,0,NO
6,src/java/main/org/apache/jute/compiler/JFloat.java,39,0,0.0,0,0,0.0,0,0,0.0,0,0,0.0,0,0,0,0,NO
6,src/java/main/org/apache/jute/compiler/JInt.java,34,0,0.0,0,0,0.0,0,0,0.0,0,0,0.0,0,0,0,0,NO
6,src/java/main/org/apache/jute/compiler/JLong.java,38,0,0.0,0,0,0.0,0,0,0.0,0,0,0.0,0,0,0,0,NO
6,src/java/main/org/apache/jute/compiler/JMap.java,103,0,0.0,0,0,0.0,0,0,0.0,0,0,0.0,0,0,0,0,NO
6,src/java/main/org/apache/jute/compiler/JRecord.java,518,0,0.0,0,0,0.0,0,0,0.0,0,0,0.0,0,0,0,0,NO
6,src/java/main/org/apache/jute/compiler/JString.java,46,0,0.0,0,0,0.0,0,0,0.0,0,0,0.0,0,0,0,0,NO
6,src/java/main/org/apache/jute/compiler/JType.java,141,0,0.0,0,0,0.0,0,0,0.0,0,0,0.0,0,0,0,0,NO
6,src/java/main/org/apache/jute/compiler/JVector.java,106,0,0.0,0,0,0.0,0,0,0.0,0,0,0.0,0,0,0,0,NO
6,src/java/main/org/apache/jute/compiler/JavaGenerator.java,57,0,0.0,0,0,0.0,0,0,0.0,0,0,0.0,0,0,0,0,NO
6,src/java/main/org/apache/jute/compiler/generated/ParseException.java,210,0,0.0,0,0,0.0,0,0,0.0,0,0,0.0,0,0,0,0,NO
6,src/java/main/org/apache/jute/compiler/generated/Rcc.java,525,0,0.0,0,0,0.0,0,0,0.0,0,0,0.0,0,0,0,0,NO
6,src/java/main/org/apache/jute/compiler/generated/RccConstants.java,88,0,0.0,0,0,0.0,0,0,0.0,0,0,0.0,0,0,0,0,NO
6,src/java/main/org/apache/jute/compiler/generated/RccTokenManager.java,833,0,0.0,0,0,0.0,0,0,0.0,0,0,0.0,0,0,0,0,NO
6,src/java/main/org/apache/jute/compiler/generated/SimpleCharStream.java,457,0,0.0,0,0,0.0,0,0,0.0,0,0,0.0,0,0,0,0,NO
6,src/java/main/org/apache/jute/compiler/generated/Token.java,99,0,0.0,0,0,0.0,0,0,0.0,0,0,0.0,0,0,0,0,NO
6,src/java/main/org/apache/jute/compiler/generated/TokenMgrError.java,151,0,0.0,0,0,0.0,0,0,0.0,0,0,0.0,0,0,0,0,NO
6,src/java/main/org/apache/zookeeper/AsyncCallback.java,52,0,0.0,0,0,0.0,0,0,0.0,0,0,0.0,0,0,0,0,NO
6,src/java/main/org/apache/zookeeper/ClientCnxn.java,1143,27,27.0,27,25,25.0,25,52,52.0,52,2,2.0,2,1,0,1,YES
6,src/java/main/org/apache/zookeeper/ClientWatchManager.java,39,0,0.0,0,0,0.0,0,0,0.0,0,0,0.0,0,0,0,0,NO
6,src/java/main/org/apache/zookeeper/CreateMode.java,89,0,0.0,0,0,0.0,0,0,0.0,0,0,0.0,0,0,0,0,NO
6,src/java/main/org/apache/zookeeper/Environment.java,100,0,0.0,0,0,0.0,0,0,0.0,0,0,0.0,0,0,0,0,NO
6,src/java/main/org/apache/zookeeper/JLineZNodeCompletor.java,84,0,0.0,0,0,0.0,0,0,0.0,0,0,0.0,0,0,0,0,NO
6,src/java/main/org/apache/zookeeper/KeeperException.java,641,0,0.0,0,0,0.0,0,0,0.0,0,0,0.0,0,0,0,0,YES
6,src/java/main/org/apache/zookeeper/Quotas.java,68,0,0.0,0,0,0.0,0,0,0.0,0,0,0.0,0,0,0,0,NO
6,src/java/main/org/apache/zookeeper/ServerAdminClient.java,312,0,0.0,0,0,0.0,0,0,0.0,0,0,0.0,0,0,0,0,NO
6,src/java/main/org/apache/zookeeper/StatsTrack.java,101,0,0.0,0,0,0.0,0,0,0.0,0,0,0.0,0,0,0,0,NO
6,src/java/main/org/apache/zookeeper/Version.java,78,0,0.0,0,0,0.0,0,0,0.0,0,0,0.0,0,0,0,0,NO
6,src/java/main/org/apache/zookeeper/WatchedEvent.java,81,0,0.0,0,0,0.0,0,0,0.0,0,0,0.0,0,0,0,0,NO
6,src/java/main/org/apache/zookeeper/Watcher.java,125,0,0.0,0,0,0.0,0,0,0.0,0,0,0.0,0,0,0,0,NO
6,src/java/main/org/apache/zookeeper/ZooDefs.java,112,0,0.0,0,0,0.0,0,0,0.0,0,0,0.0,0,0,0,0,NO
6,src/java/main/org/apache/zookeeper/ZooKeeper.java,1311,53,53.0,53,12,12.0,12,65,65.0,65,41,41.0,41,1,1,1,YES
6,src/java/main/org/apache/zookeeper/ZooKeeperMain.java,826,26,13.0,26,29,14.5,29,55,27.5,55,5,2.5,5,2,2,1,YES
6,src/java/main/org/apache/zookeeper/common/PathTrie.java,283,3,3.0,3,0,0.0,0,3,3.0,3,3,3.0,3,1,1,1,NO
6,src/java/main/org/apache/zookeeper/common/PathUtils.java,103,0,0.0,0,0,0.0,0,0,0.0,0,0,0.0,0,0,0,0,NO
6,src/java/main/org/apache/zookeeper/jmx/CommonNames.java,29,0,0.0,0,0,0.0,0,0,0.0,0,0,0.0,0,0,0,0,NO
6,src/java/main/org/apache/zookeeper/jmx/MBeanRegistry.java,194,0,0.0,0,0,0.0,0,0,0.0,0,0,0.0,0,0,0,0,NO
6,src/java/main/org/apache/zookeeper/jmx/ManagedUtil.java,72,0,0.0,0,0,0.0,0,0,0.0,0,0,0.0,0,0,0,0,NO
6,src/java/main/org/apache/zookeeper/jmx/ZKMBeanInfo.java,36,0,0.0,0,0,0.0,0,0,0.0,0,0,0.0,0,0,0,0,NO
6,src/java/main/org/apache/zookeeper/server/ByteBufferInputStream.java,72,0,0.0,0,0,0.0,0,0,0.0,0,0,0.0,0,0,0,0,NO
6,src/java/main/org/apache/zookeeper/server/ConnectionBean.java,121,0,0.0,0,0,0.0,0,0,0.0,0,0,0.0,0,0,0,0,YES
6,src/java/main/org/apache/zookeeper/server/ConnectionMXBean.java,68,0,0.0,0,0,0.0,0,0,0.0,0,0,0.0,0,0,0,0,YES
6,src/java/main/org/apache/zookeeper/server/DataNode.java,133,0,0.0,0,0,0.0,0,0,0.0,0,0,0.0,0,0,0,0,NO
6,src/java/main/org/apache/zookeeper/server/DataTree.java,1112,0,0.0,0,0,0.0,0,0,0.0,0,0,0.0,0,0,0,0,NO
6,src/java/main/org/apache/zookeeper/server/DataTreeBean.java,70,0,0.0,0,0,0.0,0,0,0.0,0,0,0.0,0,0,0,0,NO
6,src/java/main/org/apache/zookeeper/server/DataTreeMXBean.java,47,0,0.0,0,0,0.0,0,0,0.0,0,0,0.0,0,0,0,0,NO
6,src/java/main/org/apache/zookeeper/server/FinalRequestProcessor.java,286,0,0.0,0,0,0.0,0,0,0.0,0,0,0.0,0,0,0,0,YES
6,src/java/main/org/apache/zookeeper/server/LogFormatter.java,72,0,0.0,0,0,0.0,0,0,0.0,0,0,0.0,0,0,0,0,NO
6,src/java/main/org/apache/zookeeper/server/NIOServerCnxn.java,1047,25,12.5,25,27,13.5,27,52,26.0,52,4,2.0,4,2,1,1,YES
6,src/java/main/org/apache/zookeeper/server/PrepRequestProcessor.java,506,1,1.0,1,1,1.0,1,2,2.0,2,0,0.0,0,1,1,1,YES
6,src/java/main/org/apache/zookeeper/server/PurgeTxnLog.java,132,0,0.0,0,0,0.0,0,0,0.0,0,0,0.0,0,0,0,0,NO
6,src/java/main/org/apache/zookeeper/server/Request.java,218,0,0.0,0,0,0.0,0,0,0.0,0,0,0.0,0,0,0,0,YES
6,src/java/main/org/apache/zookeeper/server/RequestProcessor.java,37,0,0.0,0,0,0.0,0,0,0.0,0,0,0.0,0,0,0,0,NO
6,src/java/main/org/apache/zookeeper/server/ServerCnxn.java,88,4,4.0,4,0,0.0,0,4,4.0,4,4,4.0,4,1,1,1,YES
6,src/java/main/org/apache/zookeeper/server/ServerConfig.java,94,0,0.0,0,0,0.0,0,0,0.0,0,0,0.0,0,0,0,0,NO
6,src/java/main/org/apache/zookeeper/server/ServerStats.java,132,0,0.0,0,0,0.0,0,0,0.0,0,0,0.0,0,0,0,0,NO
6,src/java/main/org/apache/zookeeper/server/SessionTracker.java,62,0,0.0,0,0,0.0,0,0,0.0,0,0,0.0,0,0,0,0,YES
6,src/java/main/org/apache/zookeeper/server/SessionTrackerImpl.java,242,0,0.0,0,0,0.0,0,0,0.0,0,0,0.0,0,0,0,0,YES
6,src/java/main/org/apache/zookeeper/server/SyncRequestProcessor.java,161,0,0.0,0,0,0.0,0,0,0.0,0,0,0.0,0,0,0,0,YES
6,src/java/main/org/apache/zookeeper/server/TraceFormatter.java,119,0,0.0,0,0,0.0,0,0,0.0,0,0,0.0,0,0,0,0,NO
6,src/java/main/org/apache/zookeeper/server/WatchManager.java,113,0,0.0,0,0,0.0,0,0,0.0,0,0,0.0,0,0,0,0,NO
6,src/java/main/org/apache/zookeeper/server/ZooKeeperServer.java,688,11,11.0,11,0,0.0,0,11,11.0,11,11,11.0,11,1,1,1,YES
6,src/java/main/org/apache/zookeeper/server/ZooKeeperServerBean.java,114,0,0.0,0,0,0.0,0,0,0.0,0,0,0.0,0,0,0,0,NO
6,src/java/main/org/apache/zookeeper/server/ZooKeeperServerMXBean.java,82,0,0.0,0,0,0.0,0,0,0.0,0,0,0.0,0,0,0,0,NO
6,src/java/main/org/apache/zookeeper/server/ZooKeeperServerMain.java,124,0,0.0,0,0,0.0,0,0,0.0,0,0,0.0,0,0,0,0,NO
6,src/java/main/org/apache/zookeeper/server/ZooTrace.java,92,0,0.0,0,0,0.0,0,0,0.0,0,0,0.0,0,0,0,0,NO
6,src/java/main/org/apache/zookeeper/server/auth/AuthenticationProvider.java,82,0,0.0,0,0,0.0,0,0,0.0,0,0,0.0,0,0,0,0,NO
6,src/java/main/org/apache/zookeeper/server/auth/DigestAuthenticationProvider.java,138,0,0.0,0,0,0.0,0,0,0.0,0,0,0.0,0,0,0,0,NO
6,src/java/main/org/apache/zookeeper/server/auth/IPAuthenticationProvider.java,117,0,0.0,0,0,0.0,0,0,0.0,0,0,0.0,0,0,0,0,NO
6,src/java/main/org/apache/zookeeper/server/auth/ProviderRegistry.java,76,0,0.0,0,0,0.0,0,0,0.0,0,0,0.0,0,0,0,0,NO
6,src/java/main/org/apache/zookeeper/server/persistence/FileSnap.java,236,0,0.0,0,0,0.0,0,0,0.0,0,0,0.0,0,0,0,0,YES
6,src/java/main/org/apache/zookeeper/server/persistence/FileTxnLog.java,548,50,50.0,50,6,6.0,6,56,56.0,56,44,44.0,44,1,1,1,YES
6,src/java/main/org/apache/zookeeper/server/persistence/FileTxnSnapLog.java,287,0,0.0,0,0,0.0,0,0,0.0,0,0,0.0,0,0,0,0,YES
6,src/java/main/org/apache/zookeeper/server/persistence/SnapShot.java,60,0,0.0,0,0,0.0,0,0,0.0,0,0,0.0,0,0,0,0,NO
6,src/java/main/org/apache/zookeeper/server/persistence/TxnLog.java,115,0,0.0,0,0,0.0,0,0,0.0,0,0,0.0,0,0,0,0,YES
6,src/java/main/org/apache/zookeeper/server/persistence/Util.java,325,0,0.0,0,0,0.0,0,0,0.0,0,0,0.0,0,0,0,0,NO
6,src/java/main/org/apache/zookeeper/server/quorum/AckRequestProcessor.java,53,0,0.0,0,0,0.0,0,0,0.0,0,0,0.0,0,0,0,0,NO
6,src/java/main/org/apache/zookeeper/server/quorum/AuthFastLeaderElection.java,957,0,0.0,0,0,0.0,0,0,0.0,0,0,0.0,0,0,0,0,NO
6,src/java/main/org/apache/zookeeper/server/quorum/CommitProcessor.java,187,0,0.0,0,0,0.0,0,0,0.0,0,0,0.0,0,0,0,0,YES
6,src/java/main/org/apache/zookeeper/server/quorum/Election.java,26,0,0.0,0,0,0.0,0,0,0.0,0,0,0.0,0,0,0,0,NO
6,src/java/main/org/apache/zookeeper/server/quorum/FastLeaderElection.java,744,82,27.333334,82,30,10.0,30,112,37.333332,112,52,17.333334,52,3,3,1,YES
6,src/java/main/org/apache/zookeeper/server/quorum/Follower.java,429,1,1.0,1,1,1.0,1,2,2.0,2,0,0.0,0,1,1,1,YES
6,src/java/main/org/apache/zookeeper/server/quorum/FollowerBean.java,50,0,0.0,0,0,0.0,0,0,0.0,0,0,0.0,0,0,0,0,NO
6,src/java/main/org/apache/zookeeper/server/quorum/FollowerHandler.java,470,40,20.0,40,18,9.0,18,58,29.0,58,22,11.0,22,2,2,1,NO
6,src/java/main/org/apache/zookeeper/server/quorum/FollowerMXBean.java,41,0,0.0,0,0,0.0,0,0,0.0,0,0,0.0,0,0,0,0,NO
6,src/java/main/org/apache/zookeeper/server/quorum/FollowerRequestProcessor.java,109,0,0.0,0,0,0.0,0,0,0.0,0,0,0.0,0,0,0,0,NO
6,src/java/main/org/apache/zookeeper/server/quorum/FollowerSessionTracker.java,89,0,0.0,0,0,0.0,0,0,0.0,0,0,0.0,0,0,0,0,NO
6,src/java/main/org/apache/zookeeper/server/quorum/FollowerSyncRequest.java,34,0,0.0,0,0,0.0,0,0,0.0,0,0,0.0,0,0,0,0,NO
6,src/java/main/org/apache/zookeeper/server/quorum/FollowerZooKeeperServer.java,248,0,0.0,0,0,0.0,0,0,0.0,0,0,0.0,0,0,0,0,YES
6,src/java/main/org/apache/zookeeper/server/quorum/Leader.java,671,5,2.5,5,6,3.0,6,11,5.5,11,1,0.5,1,2,1,2,YES
6,src/java/main/org/apache/zookeeper/server/quorum/LeaderBean.java,53,0,0.0,0,0,0.0,0,0,0.0,0,0,0.0,0,0,0,0,NO
6,src/java/main/org/apache/zookeeper/server/quorum/LeaderElection.java,230,0,0.0,0,0,0.0,0,0,0.0,0,0,0.0,0,0,0,0,YES
6,src/java/main/org/apache/zookeeper/server/quorum/LeaderElectionBean.java,42,0,0.0,0,0,0.0,0,0,0.0,0,0,0.0,0,0,0,0,NO
6,src/java/main/org/apache/zookeeper/server/quorum/LeaderElectionMXBean.java,31,0,0.0,0,0,0.0,0,0,0.0,0,0,0.0,0,0,0,0,NO
6,src/java/main/org/apache/zookeeper/server/quorum/LeaderMXBean.java,36,0,0.0,0,0,0.0,0,0,0.0,0,0,0.0,0,0,0,0,NO
6,src/java/main/org/apache/zookeeper/server/quorum/LeaderZooKeeperServer.java,169,3,3.0,3,5,5.0,5,8,8.0,8,2,2.0,2,1,1,1,YES
6,src/java/main/org/apache/zookeeper/server/quorum/LocalPeerBean.java,68,0,0.0,0,0,0.0,0,0,0.0,0,0,0.0,0,0,0,0,NO
6,src/java/main/org/apache/zookeeper/server/quorum/LocalPeerMXBean.java,64,0,0.0,0,0,0.0,0,0,0.0,0,0,0.0,0,0,0,0,NO
6,src/java/main/org/apache/zookeeper/server/quorum/ProposalRequestProcessor.java,82,0,0.0,0,0,0.0,0,0,0.0,0,0,0.0,0,0,0,0,NO
6,src/java/main/org/apache/zookeeper/server/quorum/QuorumBean.java,44,0,0.0,0,0,0.0,0,0,0.0,0,0,0.0,0,0,0,0,NO
6,src/java/main/org/apache/zookeeper/server/quorum/QuorumCnxManager.java,628,153,38.25,153,101,25.25,101,254,63.5,254,52,13.0,52,4,4,1,YES
6,src/java/main/org/apache/zookeeper/server/quorum/QuorumMXBean.java,34,0,0.0,0,0,0.0,0,0,0.0,0,0,0.0,0,0,0,0,NO
6,src/java/main/org/apache/zookeeper/server/quorum/QuorumPeer.java,711,0,0.0,0,0,0.0,0,0,0.0,0,0,0.0,0,0,0,0,YES
6,src/java/main/org/apache/zookeeper/server/quorum/QuorumPeerConfig.java,279,2,2.0,2,2,2.0,2,4,4.0,4,0,0.0,0,1,1,1,NO
6,src/java/main/org/apache/zookeeper/server/quorum/QuorumPeerMain.java,148,0,0.0,0,0,0.0,0,0,0.0,0,0,0.0,0,0,0,0,YES
6,src/java/main/org/apache/zookeeper/server/quorum/QuorumStats.java,67,0,0.0,0,0,0.0,0,0,0.0,0,0,0.0,0,0,0,0,NO
6,src/java/main/org/apache/zookeeper/server/quorum/RemotePeerBean.java,45,0,0.0,0,0,0.0,0,0,0.0,0,0,0.0,0,0,0,0,NO
6,src/java/main/org/apache/zookeeper/server/quorum/RemotePeerMXBean.java,33,0,0.0,0,0,0.0,0,0,0.0,0,0,0.0,0,0,0,0,NO
6,src/java/main/org/apache/zookeeper/server/quorum/SendAckRequestProcessor.java,79,46,15.333333,46,26,8.666667,26,72,24.0,72,60,20.0,60,3,3,2,NO
6,src/java/main/org/apache/zookeeper/server/quorum/ServerBean.java,38,0,0.0,0,0,0.0,0,0,0.0,0,0,0.0,0,0,0,0,NO
6,src/java/main/org/apache/zookeeper/server/quorum/ServerMXBean.java,33,0,0.0,0,0,0.0,0,0,0.0,0,0,0.0,0,0,0,0,NO
6,src/java/main/org/apache/zookeeper/server/quorum/Vote.java,69,0,0.0,0,0,0.0,0,0,0.0,0,0,0.0,0,0,0,0,YES
6,src/java/main/org/apache/zookeeper/server/quorum/flexible/QuorumHierarchical.java,272,42,21.0,42,19,9.5,19,61,30.5,61,23,11.5,23,2,2,1,NO
6,src/java/main/org/apache/zookeeper/server/quorum/flexible/QuorumMaj.java,57,11,11.0,11,0,0.0,0,11,11.0,11,11,11.0,11,1,1,1,NO
6,src/java/main/org/apache/zookeeper/server/quorum/flexible/QuorumVerifier.java,33,1,1.0,1,0,0.0,0,1,1.0,1,1,1.0,1,1,1,1,NO
6,src/java/main/org/apache/zookeeper/server/upgrade/DataNodeV1.java,129,0,0.0,0,0,0.0,0,0,0.0,0,0,0.0,0,0,0,0,NO
6,src/java/main/org/apache/zookeeper/server/upgrade/DataTreeV1.java,583,0,0.0,0,0,0.0,0,0,0.0,0,0,0.0,0,0,0,0,NO
6,src/java/main/org/apache/zookeeper/server/upgrade/UpgradeMain.java,180,0,0.0,0,0,0.0,0,0,0.0,0,0,0.0,0,0,0,0,NO
6,src/java/main/org/apache/zookeeper/server/upgrade/UpgradeSnapShot.java,33,0,0.0,0,0,0.0,0,0,0.0,0,0,0.0,0,0,0,0,NO
6,src/java/main/org/apache/zookeeper/server/upgrade/UpgradeSnapShotV1.java,333,0,0.0,0,0,0.0,0,0,0.0,0,0,0.0,0,0,0,0,NO
6,src/java/main/org/apache/zookeeper/server/util/Profiler.java,40,0,0.0,0,0,0.0,0,0,0.0,0,0,0.0,0,0,0,0,NO
6,src/java/main/org/apache/zookeeper/server/util/SerializeUtils.java,107,0,0.0,0,0,0.0,0,0,0.0,0,0,0.0,0,0,0,0,NO
6,src/java/main/org/apache/zookeeper/version/util/VerGen.java,128,0,0.0,0,0,0.0,0,0,0.0,0,0,0.0,0,0,0,0,NO
6,src/recipes/lock/src/java/org/apache/zookeeper/recipes/lock/LockListener.java,38,0,0.0,0,0,0.0,0,0,0.0,0,0,0.0,0,0,0,0,NO
6,src/recipes/lock/src/java/org/apache/zookeeper/recipes/lock/ProtocolSupport.java,192,0,0.0,0,0,0.0,0,0,0.0,0,0,0.0,0,0,0,0,NO
6,src/recipes/lock/src/java/org/apache/zookeeper/recipes/lock/WriteLock.java,294,0,0.0,0,0,0.0,0,0,0.0,0,0,0.0,0,0,0,0,NO
6,src/recipes/lock/src/java/org/apache/zookeeper/recipes/lock/ZNodeName.java,109,0,0.0,0,0,0.0,0,0,0.0,0,0,0.0,0,0,0,0,NO
6,src/recipes/lock/src/java/org/apache/zookeeper/recipes/lock/ZooKeeperOperation.java,38,0,0.0,0,0,0.0,0,0,0.0,0,0,0.0,0,0,0,0,NO
7,src/contrib/bookkeeper/benchmark/org/apache/bookkeeper/benchmark/MySqlClient.java,137,0,0.0,0,0,0.0,0,0,0.0,0,0,0.0,0,0,0,0,NO
7,src/contrib/bookkeeper/benchmark/org/apache/bookkeeper/benchmark/TestClient.java,252,0,0.0,0,0,0.0,0,0,0.0,0,0,0.0,0,0,0,0,NO
7,src/contrib/bookkeeper/src/java/org/apache/bookkeeper/bookie/Bookie.java,362,0,0.0,0,0,0.0,0,0,0.0,0,0,0.0,0,0,0,0,NO
7,src/contrib/bookkeeper/src/java/org/apache/bookkeeper/bookie/BookieException.java,81,0,0.0,0,0,0.0,0,0,0.0,0,0,0.0,0,0,0,0,NO
7,src/contrib/bookkeeper/src/java/org/apache/bookkeeper/bookie/LedgerDescriptor.java,165,0,0.0,0,0,0.0,0,0,0.0,0,0,0.0,0,0,0,0,NO
7,src/contrib/bookkeeper/src/java/org/apache/bookkeeper/client/AsyncCallback.java,81,0,0.0,0,0,0.0,0,0,0.0,0,0,0.0,0,0,0,0,NO
7,src/contrib/bookkeeper/src/java/org/apache/bookkeeper/client/BKDefs.java,107,0,0.0,0,0,0.0,0,0,0.0,0,0,0.0,0,0,0,0,NO
7,src/contrib/bookkeeper/src/java/org/apache/bookkeeper/client/BKException.java,163,0,0.0,0,0,0.0,0,0,0.0,0,0,0.0,0,0,0,0,NO
7,src/contrib/bookkeeper/src/java/org/apache/bookkeeper/client/BookKeeper.java,616,0,0.0,0,0,0.0,0,0,0.0,0,0,0.0,0,0,0,0,NO
7,src/contrib/bookkeeper/src/java/org/apache/bookkeeper/client/BookieHandle.java,371,0,0.0,0,0,0.0,0,0,0.0,0,0,0.0,0,0,0,0,NO
7,src/contrib/bookkeeper/src/java/org/apache/bookkeeper/client/ClientCBWorker.java,138,0,0.0,0,0,0.0,0,0,0.0,0,0,0.0,0,0,0,0,NO
7,src/contrib/bookkeeper/src/java/org/apache/bookkeeper/client/LedgerEntry.java,58,0,0.0,0,0,0.0,0,0,0.0,0,0,0.0,0,0,0,0,NO
7,src/contrib/bookkeeper/src/java/org/apache/bookkeeper/client/LedgerHandle.java,844,0,0.0,0,0,0.0,0,0,0.0,0,0,0.0,0,0,0,0,NO
7,src/contrib/bookkeeper/src/java/org/apache/bookkeeper/client/LedgerManagementProcessor.java,1272,0,0.0,0,0,0.0,0,0,0.0,0,0,0.0,0,0,0,0,NO
7,src/contrib/bookkeeper/src/java/org/apache/bookkeeper/client/LedgerRecoveryMonitor.java,245,0,0.0,0,0,0.0,0,0,0.0,0,0,0.0,0,0,0,0,NO
7,src/contrib/bookkeeper/src/java/org/apache/bookkeeper/client/LedgerSequence.java,65,0,0.0,0,0,0.0,0,0,0.0,0,0,0.0,0,0,0,0,NO
7,src/contrib/bookkeeper/src/java/org/apache/bookkeeper/client/QuorumEngine.java,299,0,0.0,0,0,0.0,0,0,0.0,0,0,0.0,0,0,0,0,NO
7,src/contrib/bookkeeper/src/java/org/apache/bookkeeper/client/QuorumOpMonitor.java,472,0,0.0,0,0,0.0,0,0,0.0,0,0,0.0,0,0,0,0,NO
7,src/contrib/bookkeeper/src/java/org/apache/bookkeeper/proto/BookieClient.java,441,0,0.0,0,0,0.0,0,0,0.0,0,0,0.0,0,0,0,0,NO
7,src/contrib/bookkeeper/src/java/org/apache/bookkeeper/proto/BookieProtocol.java,76,0,0.0,0,0,0.0,0,0,0.0,0,0,0.0,0,0,0,0,NO
7,src/contrib/bookkeeper/src/java/org/apache/bookkeeper/proto/BookieServer.java,199,0,0.0,0,0,0.0,0,0,0.0,0,0,0.0,0,0,0,0,NO
7,src/contrib/bookkeeper/src/java/org/apache/bookkeeper/proto/NIOServerFactory.java,527,0,0.0,0,0,0.0,0,0,0.0,0,0,0.0,0,0,0,0,NO
7,src/contrib/bookkeeper/src/java/org/apache/bookkeeper/proto/ReadEntryCallback.java,35,0,0.0,0,0,0.0,0,0,0.0,0,0,0.0,0,0,0,0,NO
7,src/contrib/bookkeeper/src/java/org/apache/bookkeeper/proto/ServerStats.java,133,0,0.0,0,0,0.0,0,0,0.0,0,0,0.0,0,0,0,0,NO
7,src/contrib/bookkeeper/src/java/org/apache/bookkeeper/proto/WriteCallback.java,32,0,0.0,0,0,0.0,0,0,0.0,0,0,0.0,0,0,0,0,NO
7,src/contrib/bookkeeper/src/java/org/apache/bookkeeper/streaming/LedgerInputStream.java,164,0,0.0,0,0,0.0,0,0,0.0,0,0,0.0,0,0,0,0,YES
7,src/contrib/bookkeeper/src/java/org/apache/bookkeeper/streaming/LedgerOutputStream.java,148,0,0.0,0,0,0.0,0,0,0.0,0,0,0.0,0,0,0,0,NO
7,src/contrib/bookkeeper/src/java/org/apache/bookkeeper/util/ClientBase.java,343,0,0.0,0,0,0.0,0,0,0.0,0,0,0.0,0,0,0,0,NO
7,src/contrib/bookkeeper/src/java/org/apache/bookkeeper/util/LocalBookKeeper.java,164,0,0.0,0,0,0.0,0,0,0.0,0,0,0.0,0,0,0,0,YES
7,src/contrib/bookkeeper/src/java/org/apache/bookkeeper/util/Main.java,55,0,0.0,0,0,0.0,0,0,0.0,0,0,0.0,0,0,0,0,NO
7,src/contrib/fatjar/src/java/org/apache/zookeeper/util/FatJarMain.java,126,0,0.0,0,0,0.0,0,0,0.0,0,0,0.0,0,0,0,0,NO
7,src/contrib/rest/src/java/org/apache/zookeeper/server/jersey/RestMain.java,78,0,0.0,0,0,0.0,0,0,0.0,0,0,0.0,0,0,0,0,NO
7,src/contrib/rest/src/java/org/apache/zookeeper/server/jersey/ZooKeeperService.java,110,0,0.0,0,0,0.0,0,0,0.0,0,0,0.0,0,0,0,0,NO
7,src/contrib/rest/src/java/org/apache/zookeeper/server/jersey/jaxb/ZChildren.java,80,0,0.0,0,0,0.0,0,0,0.0,0,0,0.0,0,0,0,0,NO
7,src/contrib/rest/src/java/org/apache/zookeeper/server/jersey/jaxb/ZChildrenJSON.java,76,0,0.0,0,0,0.0,0,0,0.0,0,0,0.0,0,0,0,0,NO
7,src/contrib/rest/src/java/org/apache/zookeeper/server/jersey/jaxb/ZError.java,41,0,0.0,0,0,0.0,0,0,0.0,0,0,0.0,0,0,0,0,NO
7,src/contrib/rest/src/java/org/apache/zookeeper/server/jersey/jaxb/ZPath.java,63,0,0.0,0,0,0.0,0,0,0.0,0,0,0.0,0,0,0,0,NO
7,src/contrib/rest/src/java/org/apache/zookeeper/server/jersey/jaxb/ZStat.java,106,0,0.0,0,0,0.0,0,0,0.0,0,0,0.0,0,0,0,0,NO
7,src/contrib/rest/src/java/org/apache/zookeeper/server/jersey/resources/JAXBContextResolver.java,72,0,0.0,0,0,0.0,0,0,0.0,0,0,0.0,0,0,0,0,NO
7,src/contrib/rest/src/java/org/apache/zookeeper/server/jersey/resources/KeeperExceptionMapper.java,86,0,0.0,0,0,0.0,0,0,0.0,0,0,0.0,0,0,0,0,NO
7,src/contrib/rest/src/java/org/apache/zookeeper/server/jersey/resources/RuntimeExceptionMapper.java,48,0,0.0,0,0,0.0,0,0,0.0,0,0,0.0,0,0,0,0,NO
7,src/contrib/rest/src/java/org/apache/zookeeper/server/jersey/resources/ZErrorWriter.java,63,0,0.0,0,0,0.0,0,0,0.0,0,0,0.0,0,0,0,0,NO
7,src/contrib/rest/src/java/org/apache/zookeeper/server/jersey/resources/ZNodeResource.java,375,0,0.0,0,0,0.0,0,0,0.0,0,0,0.0,0,0,0,0,NO
7,src/java/main/org/apache/jute/BinaryInputArchive.java,131,0,0.0,0,0,0.0,0,0,0.0,0,0,0.0,0,0,0,0,NO
7,src/java/main/org/apache/jute/BinaryOutputArchive.java,146,0,0.0,0,0,0.0,0,0,0.0,0,0,0.0,0,0,0,0,NO
7,src/java/main/org/apache/jute/CsvInputArchive.java,208,0,0.0,0,0,0.0,0,0,0.0,0,0,0.0,0,0,0,0,NO
7,src/java/main/org/apache/jute/CsvOutputArchive.java,150,0,0.0,0,0,0.0,0,0,0.0,0,0,0.0,0,0,0,0,NO
7,src/java/main/org/apache/jute/Index.java,38,0,0.0,0,0,0.0,0,0,0.0,0,0,0.0,0,0,0,0,NO
7,src/java/main/org/apache/jute/InputArchive.java,43,0,0.0,0,0,0.0,0,0,0.0,0,0,0.0,0,0,0,0,NO
7,src/java/main/org/apache/jute/OutputArchive.java,47,0,0.0,0,0,0.0,0,0,0.0,0,0,0.0,0,0,0,0,NO
7,src/java/main/org/apache/jute/Record.java,32,0,0.0,0,0,0.0,0,0,0.0,0,0,0.0,0,0,0,0,NO
7,src/java/main/org/apache/jute/RecordReader.java,93,0,0.0,0,0,0.0,0,0,0.0,0,0,0.0,0,0,0,0,NO
7,src/java/main/org/apache/jute/RecordWriter.java,113,0,0.0,0,0,0.0,0,0,0.0,0,0,0.0,0,0,0,0,NO
7,src/java/main/org/apache/jute/Utils.java,282,0,0.0,0,0,0.0,0,0,0.0,0,0,0.0,0,0,0,0,NO
7,src/java/main/org/apache/jute/XmlInputArchive.java,251,0,0.0,0,0,0.0,0,0,0.0,0,0,0.0,0,0,0,0,NO
7,src/java/main/org/apache/jute/XmlOutputArchive.java,251,0,0.0,0,0,0.0,0,0,0.0,0,0,0.0,0,0,0,0,NO
7,src/java/main/org/apache/jute/compiler/CGenerator.java,91,0,0.0,0,0,0.0,0,0,0.0,0,0,0.0,0,0,0,0,NO
7,src/java/main/org/apache/jute/compiler/CppGenerator.java,86,0,0.0,0,0,0.0,0,0,0.0,0,0,0.0,0,0,0,0,NO
7,src/java/main/org/apache/jute/compiler/JBoolean.java,42,0,0.0,0,0,0.0,0,0,0.0,0,0,0.0,0,0,0,0,NO
7,src/java/main/org/apache/jute/compiler/JBuffer.java,106,0,0.0,0,0,0.0,0,0,0.0,0,0,0.0,0,0,0,0,NO
7,src/java/main/org/apache/jute/compiler/JByte.java,34,0,0.0,0,0,0.0,0,0,0.0,0,0,0.0,0,0,0,0,NO
7,src/java/main/org/apache/jute/compiler/JCompType.java,53,0,0.0,0,0,0.0,0,0,0.0,0,0,0.0,0,0,0,0,NO
7,src/java/main/org/apache/jute/compiler/JDouble.java,40,0,0.0,0,0,0.0,0,0,0.0,0,0,0.0,0,0,0,0,NO
7,src/java/main/org/apache/jute/compiler/JField.java,98,0,0.0,0,0,0.0,0,0,0.0,0,0,0.0,0,0,0,0,NO
7,src/java/main/org/apache/jute/compiler/JFile.java,80,0,0.0,0,0,0.0,0,0,0.0,0,0,0.0,0,0,0,0,NO
7,src/java/main/org/apache/jute/compiler/JFloat.java,39,0,0.0,0,0,0.0,0,0,0.0,0,0,0.0,0,0,0,0,NO
7,src/java/main/org/apache/jute/compiler/JInt.java,34,0,0.0,0,0,0.0,0,0,0.0,0,0,0.0,0,0,0,0,NO
7,src/java/main/org/apache/jute/compiler/JLong.java,38,0,0.0,0,0,0.0,0,0,0.0,0,0,0.0,0,0,0,0,NO
7,src/java/main/org/apache/jute/compiler/JMap.java,103,0,0.0,0,0,0.0,0,0,0.0,0,0,0.0,0,0,0,0,NO
7,src/java/main/org/apache/jute/compiler/JRecord.java,518,0,0.0,0,0,0.0,0,0,0.0,0,0,0.0,0,0,0,0,NO
7,src/java/main/org/apache/jute/compiler/JString.java,46,0,0.0,0,0,0.0,0,0,0.0,0,0,0.0,0,0,0,0,NO
7,src/java/main/org/apache/jute/compiler/JType.java,141,0,0.0,0,0,0.0,0,0,0.0,0,0,0.0,0,0,0,0,NO
7,src/java/main/org/apache/jute/compiler/JVector.java,106,0,0.0,0,0,0.0,0,0,0.0,0,0,0.0,0,0,0,0,NO
7,src/java/main/org/apache/jute/compiler/JavaGenerator.java,57,0,0.0,0,0,0.0,0,0,0.0,0,0,0.0,0,0,0,0,NO
7,src/java/main/org/apache/jute/compiler/generated/ParseException.java,210,0,0.0,0,0,0.0,0,0,0.0,0,0,0.0,0,0,0,0,NO
7,src/java/main/org/apache/jute/compiler/generated/Rcc.java,525,0,0.0,0,0,0.0,0,0,0.0,0,0,0.0,0,0,0,0,NO
7,src/java/main/org/apache/jute/compiler/generated/RccConstants.java,88,0,0.0,0,0,0.0,0,0,0.0,0,0,0.0,0,0,0,0,NO
7,src/java/main/org/apache/jute/compiler/generated/RccTokenManager.java,833,0,0.0,0,0,0.0,0,0,0.0,0,0,0.0,0,0,0,0,NO
7,src/java/main/org/apache/jute/compiler/generated/SimpleCharStream.java,457,0,0.0,0,0,0.0,0,0,0.0,0,0,0.0,0,0,0,0,NO
7,src/java/main/org/apache/jute/compiler/generated/Token.java,99,0,0.0,0,0,0.0,0,0,0.0,0,0,0.0,0,0,0,0,NO
7,src/java/main/org/apache/jute/compiler/generated/TokenMgrError.java,151,0,0.0,0,0,0.0,0,0,0.0,0,0,0.0,0,0,0,0,NO
7,src/java/main/org/apache/zookeeper/AsyncCallback.java,57,5,5.0,5,0,0.0,0,5,5.0,5,5,5.0,5,1,0,1,NO
7,src/java/main/org/apache/zookeeper/ClientCnxn.java,1254,150,30.0,150,39,7.8,39,189,37.8,189,111,22.2,111,5,3,4,YES
7,src/java/main/org/apache/zookeeper/ClientWatchManager.java,39,0,0.0,0,0,0.0,0,0,0.0,0,0,0.0,0,0,0,0,NO
7,src/java/main/org/apache/zookeeper/CreateMode.java,89,0,0.0,0,0,0.0,0,0,0.0,0,0,0.0,0,0,0,0,NO
7,src/java/main/org/apache/zookeeper/Environment.java,100,0,0.0,0,0,0.0,0,0,0.0,0,0,0.0,0,0,0,0,NO
7,src/java/main/org/apache/zookeeper/JLineZNodeCompletor.java,84,0,0.0,0,0,0.0,0,0,0.0,0,0,0.0,0,0,0,0,NO
7,src/java/main/org/apache/zookeeper/KeeperException.java,662,21,21.0,21,0,0.0,0,21,21.0,21,21,21.0,21,1,1,1,NO
7,src/java/main/org/apache/zookeeper/Quotas.java,68,0,0.0,0,0,0.0,0,0,0.0,0,0,0.0,0,0,0,0,NO
7,src/java/main/org/apache/zookeeper/ServerAdminClient.java,312,0,0.0,0,0,0.0,0,0,0.0,0,0,0.0,0,0,0,0,NO
7,src/java/main/org/apache/zookeeper/StatsTrack.java,101,0,0.0,0,0,0.0,0,0,0.0,0,0,0.0,0,0,0,0,NO
7,src/java/main/org/apache/zookeeper/Version.java,78,0,0.0,0,0,0.0,0,0,0.0,0,0,0.0,0,0,0,0,NO
7,src/java/main/org/apache/zookeeper/WatchedEvent.java,81,0,0.0,0,0,0.0,0,0,0.0,0,0,0.0,0,0,0,0,YES
7,src/java/main/org/apache/zookeeper/Watcher.java,125,0,0.0,0,0,0.0,0,0,0.0,0,0,0.0,0,0,0,0,NO
7,src/java/main/org/apache/zookeeper/ZooDefs.java,114,3,3.0,3,1,1.0,1,4,4.0,4,2,2.0,2,1,0,1,NO
7,src/java/main/org/apache/zookeeper/ZooKeeper.java,1481,185,46.25,185,15,3.75,15,200,50.0,200,170,42.5,170,4,3,2,YES
7,src/java/main/org/apache/zookeeper/ZooKeeperMain.java,832,6,6.0,6,0,0.0,0,6,6.0,6,6,6.0,6,1,0,1,YES
7,src/java/main/org/apache/zookeeper/common/PathTrie.java,283,2,2.0,2,2,2.0,2,4,4.0,4,0,0.0,0,1,0,1,NO
7,src/java/main/org/apache/zookeeper/common/PathUtils.java,103,0,0.0,0,0,0.0,0,0,0.0,0,0,0.0,0,0,0,0,NO
7,src/java/main/org/apache/zookeeper/jmx/CommonNames.java,29,0,0.0,0,0,0.0,0,0,0.0,0,0,0.0,0,0,0,0,NO
7,src/java/main/org/apache/zookeeper/jmx/MBeanRegistry.java,194,0,0.0,0,0,0.0,0,0,0.0,0,0,0.0,0,0,0,0,NO
7,src/java/main/org/apache/zookeeper/jmx/ManagedUtil.java,72,0,0.0,0,0,0.0,0,0,0.0,0,0,0.0,0,0,0,0,NO
7,src/java/main/org/apache/zookeeper/jmx/ZKMBeanInfo.java,36,0,0.0,0,0,0.0,0,0,0.0,0,0,0.0,0,0,0,0,NO
7,src/java/main/org/apache/zookeeper/server/ByteBufferInputStream.java,72,0,0.0,0,0,0.0,0,0,0.0,0,0,0.0,0,0,0,0,NO
7,src/java/main/org/apache/zookeeper/server/ConnectionBean.java,159,50,25.0,50,12,6.0,12,62,31.0,62,38,19.0,38,2,2,1,YES
7,src/java/main/org/apache/zookeeper/server/ConnectionMXBean.java,98,30,30.0,30,0,0.0,0,30,30.0,30,30,30.0,30,1,1,1,NO
7,src/java/main/org/apache/zookeeper/server/DataNode.java,170,71,71.0,71,34,34.0,34,105,105.0,105,37,37.0,37,1,0,1,NO
7,src/java/main/org/apache/zookeeper/server/DataTree.java,1164,333,111.0,333,281,93.666664,281,614,204.66667,614,52,17.333334,52,3,0,2,NO
7,src/java/main/org/apache/zookeeper/server/DataTreeBean.java,70,0,0.0,0,0,0.0,0,0,0.0,0,0,0.0,0,0,0,0,NO
7,src/java/main/org/apache/zookeeper/server/DataTreeMXBean.java,47,0,0.0,0,0,0.0,0,0,0.0,0,0,0.0,0,0,0,0,NO
7,src/java/main/org/apache/zookeeper/server/FinalRequestProcessor.java,368,113,37.666668,113,31,10.333333,31,144,48.0,144,82,27.333334,82,3,2,2,YES
7,src/java/main/org/apache/zookeeper/server/LogFormatter.java,72,0,0.0,0,0,0.0,0,0,0.0,0,0,0.0,0,0,0,0,NO
7,src/java/main/org/apache/zookeeper/server/NIOServerCnxn.java,1362,655,65.5,655,340,34.0,340,995,99.5,995,341,34.1,341,10,9,3,YES
7,src/java/main/org/apache/zookeeper/server/ObserverBean.java,45,45,45.0,45,0,0.0,0,45,45.0,45,45,45.0,45,1,0,1,NO
7,src/java/main/org/apache/zookeeper/server/PrepRequestProcessor.java,512,35,8.75,35,29,7.25,29,64,16.0,64,6,1.5,6,4,2,2,YES
7,src/java/main/org/apache/zookeeper/server/PurgeTxnLog.java,132,0,0.0,0,0,0.0,0,0,0.0,0,0,0.0,0,0,0,0,NO
7,src/java/main/org/apache/zookeeper/server/Request.java,232,39,19.5,39,25,12.5,25,64,32.0,64,14,7.0,14,2,1,2,NO
7,src/java/main/org/apache/zookeeper/server/RequestProcessor.java,37,0,0.0,0,0,0.0,0,0,0.0,0,0,0.0,0,0,0,0,NO
7,src/java/main/org/apache/zookeeper/server/ServerCnxn.java,137,82,41.0,82,33,16.5,33,115,57.5,115,49,24.5,49,2,2,1,NO
7,src/java/main/org/apache/zookeeper/server/ServerConfig.java,94,0,0.0,0,0,0.0,0,0,0.0,0,0,0.0,0,0,0,0,NO
7,src/java/main/org/apache/zookeeper/server/ServerStats.java,132,0,0.0,0,0,0.0,0,0,0.0,0,0,0.0,0,0,0,0,NO
7,src/java/main/org/apache/zookeeper/server/SessionTracker.java,66,6,6.0,6,2,2.0,2,8,8.0,8,4,4.0,4,1,1,1,NO
7,src/java/main/org/apache/zookeeper/server/SessionTrackerImpl.java,244,24,12.0,24,22,11.0,22,46,23.0,46,2,1.0,2,2,2,1,NO
7,src/java/main/org/apache/zookeeper/server/SyncRequestProcessor.java,178,44,44.0,44,27,27.0,27,71,71.0,71,17,17.0,17,1,1,1,YES
7,src/java/main/org/apache/zookeeper/server/TraceFormatter.java,121,2,2.0,2,0,0.0,0,2,2.0,2,2,2.0,2,1,0,1,NO
7,src/java/main/org/apache/zookeeper/server/WatchManager.java,113,0,0.0,0,0,0.0,0,0,0.0,0,0,0.0,0,0,0,0,NO
7,src/java/main/org/apache/zookeeper/server/ZooKeeperServer.java,703,26,13.0,26,11,5.5,11,37,18.5,37,15,7.5,15,2,1,2,YES
7,src/java/main/org/apache/zookeeper/server/ZooKeeperServerBean.java,114,0,0.0,0,0,0.0,0,0,0.0,0,0,0.0,0,0,0,0,NO
7,src/java/main/org/apache/zookeeper/server/ZooKeeperServerMXBean.java,82,0,0.0,0,0,0.0,0,0,0.0,0,0,0.0,0,0,0,0,NO
7,src/java/main/org/apache/zookeeper/server/ZooKeeperServerMain.java,124,0,0.0,0,0,0.0,0,0,0.0,0,0,0.0,0,0,0,0,NO
7,src/java/main/org/apache/zookeeper/server/ZooTrace.java,92,0,0.0,0,0,0.0,0,0,0.0,0,0,0.0,0,0,0,0,NO
7,src/java/main/org/apache/zookeeper/server/auth/AuthenticationProvider.java,82,0,0.0,0,0,0.0,0,0,0.0,0,0,0.0,0,0,0,0,NO
7,src/java/main/org/apache/zookeeper/server/auth/DigestAuthenticationProvider.java,138,0,0.0,0,0,0.0,0,0,0.0,0,0,0.0,0,0,0,0,NO
7,src/java/main/org/apache/zookeeper/server/auth/IPAuthenticationProvider.java,117,0,0.0,0,0,0.0,0,0,0.0,0,0,0.0,0,0,0,0,NO
7,src/java/main/org/apache/zookeeper/server/auth/ProviderRegistry.java,76,0,0.0,0,0,0.0,0,0,0.0,0,0,0.0,0,0,0,0,NO
7,src/java/main/org/apache/zookeeper/server/persistence/FileSnap.java,236,0,0.0,0,0,0.0,0,0,0.0,0,0,0.0,0,0,0,0,YES
7,src/java/main/org/apache/zookeeper/server/persistence/FileTxnLog.java,553,7,7.0,7,2,2.0,2,9,9.0,9,5,5.0,5,1,1,1,NO
7,src/java/main/org/apache/zookeeper/server/persistence/FileTxnSnapLog.java,288,3,3.0,3,2,2.0,2,5,5.0,5,1,1.0,1,1,1,1,NO
7,src/java/main/org/apache/zookeeper/server/persistence/SnapShot.java,60,0,0.0,0,0,0.0,0,0,0.0,0,0,0.0,0,0,0,0,NO
7,src/java/main/org/apache/zookeeper/server/persistence/TxnLog.java,116,2,2.0,2,1,1.0,1,3,3.0,3,1,1.0,1,1,1,1,NO
7,src/java/main/org/apache/zookeeper/server/persistence/Util.java,325,0,0.0,0,0,0.0,0,0,0.0,0,0,0.0,0,0,0,0,NO
7,src/java/main/org/apache/zookeeper/server/quorum/AckRequestProcessor.java,53,0,0.0,0,0,0.0,0,0,0.0,0,0,0.0,0,0,0,0,NO
7,src/java/main/org/apache/zookeeper/server/quorum/AuthFastLeaderElection.java,957,15,7.5,15,15,7.5,15,30,15.0,30,0,0.0,0,2,0,2,NO
7,src/java/main/org/apache/zookeeper/server/quorum/CommitProcessor.java,189,2,2.0,2,0,0.0,0,2,2.0,2,2,2.0,2,1,1,1,NO
7,src/java/main/org/apache/zookeeper/server/quorum/Election.java,26,0,0.0,0,0,0.0,0,0,0.0,0,0,0.0,0,0,0,0,NO
7,src/java/main/org/apache/zookeeper/server/quorum/FastLeaderElection.java,744,1,1.0,1,1,1.0,1,2,2.0,2,0,0.0,0,1,0,1,YES
7,src/java/main/org/apache/zookeeper/server/quorum/Follower.java,169,72,24.0,72,332,110.666664,332,404,134.66667,404,276,92.0,276,3,1,2,YES
7,src/java/main/org/apache/zookeeper/server/quorum/FollowerBean.java,50,0,0.0,0,0,0.0,0,0,0.0,0,0,0.0,0,0,0,0,NO
7,src/java/main/org/apache/zookeeper/server/quorum/FollowerMXBean.java,41,0,0.0,0,0,0.0,0,0,0.0,0,0,0.0,0,0,0,0,NO
7,src/java/main/org/apache/zookeeper/server/quorum/FollowerRequestProcessor.java,109,0,0.0,0,0,0.0,0,0,0.0,0,0,0.0,0,0,0,0,NO
7,src/java/main/org/apache/zookeeper/server/quorum/FollowerZooKeeperServer.java,160,17,17.0,17,105,105.0,105,122,122.0,122,88,88.0,88,1,0,1,YES
7,src/java/main/org/apache/zookeeper/server/quorum/Leader.java,719,104,34.666668,104,56,18.666666,56,160,53.333332,160,48,16.0,48,3,0,2,YES
7,src/java/main/org/apache/zookeeper/server/quorum/LeaderBean.java,53,2,2.0,2,2,2.0,2,4,4.0,4,0,0.0,0,1,0,1,NO
7,src/java/main/org/apache/zookeeper/server/quorum/LeaderElection.java,253,31,31.0,31,8,8.0,8,39,39.0,39,23,23.0,23,1,0,1,YES
7,src/java/main/org/apache/zookeeper/server/quorum/LeaderElectionBean.java,42,0,0.0,0,0,0.0,0,0,0.0,0,0,0.0,0,0,0,0,NO
7,src/java/main/org/apache/zookeeper/server/quorum/LeaderElectionMXBean.java,31,0,0.0,0,0,0.0,0,0,0.0,0,0,0.0,0,0,0,0,NO
7,src/java/main/org/apache/zookeeper/server/quorum/LeaderMXBean.java,36,0,0.0,0,0,0.0,0,0,0.0,0,0,0.0,0,0,0,0,NO
7,src/java/main/org/apache/zookeeper/server/quorum/LeaderZooKeeperServer.java,169,0,0.0,0,0,0.0,0,0,0.0,0,0,0.0,0,0,0,0,YES
7,src/java/main/org/apache/zookeeper/server/quorum/Learner.java,375,375,375.0,375,0,0.0,0,375,375.0,375,375,375.0,375,1,0,1,YES
7,src/java/main/org/apache/zookeeper/server/quorum/LearnerHandler.java,494,500,125.0,500,6,1.5,6,506,126.5,506,494,123.5,494,4,2,3,YES
7,src/java/main/org/apache/zookeeper/server/quorum/LearnerSessionTracker.java,89,89,89.0,89,0,0.0,0,89,89.0,89,89,89.0,89,1,0,1,NO
7,src/java/main/org/apache/zookeeper/server/quorum/LearnerSyncRequest.java,34,34,34.0,34,0,0.0,0,34,34.0,34,34,34.0,34,1,0,1,NO
7,src/java/main/org/apache/zookeeper/server/quorum/LearnerZooKeeperServer.java,149,149,149.0,149,0,0.0,0,149,149.0,149,149,149.0,149,1,0,1,YES
7,src/java/main/org/apache/zookeeper/server/quorum/LocalPeerBean.java,68,0,0.0,0,0,0.0,0,0,0.0,0,0,0.0,0,0,0,0,NO
7,src/java/main/org/apache/zookeeper/server/quorum/LocalPeerMXBean.java,64,0,0.0,0,0,0.0,0,0,0.0,0,0,0.0,0,0,0,0,NO
7,src/java/main/org/apache/zookeeper/server/quorum/Observer.java,146,147,147.0,147,0,0.0,0,147,147.0,147,147,147.0,147,1,0,1,YES
7,src/java/main/org/apache/zookeeper/server/quorum/ObserverMXBean.java,37,37,37.0,37,0,0.0,0,37,37.0,37,37,37.0,37,1,0,1,NO
7,src/java/main/org/apache/zookeeper/server/quorum/ObserverRequestProcessor.java,123,123,123.0,123,0,0.0,0,123,123.0,123,123,123.0,123,1,0,1,NO
7,src/java/main/org/apache/zookeeper/server/quorum/ObserverZooKeeperServer.java,114,114,114.0,114,0,0.0,0,114,114.0,114,114,114.0,114,1,0,1,YES
7,src/java/main/org/apache/zookeeper/server/quorum/ProposalRequestProcessor.java,82,2,2.0,2,2,2.0,2,4,4.0,4,0,0.0,0,1,0,1,NO
7,src/java/main/org/apache/zookeeper/server/quorum/QuorumBean.java,44,0,0.0,0,0,0.0,0,0,0.0,0,0,0.0,0,0,0,0,NO
7,src/java/main/org/apache/zookeeper/server/quorum/QuorumCnxManager.java,652,63,15.75,63,39,9.75,39,102,25.5,102,24,6.0,24,4,2,3,YES
7,src/java/main/org/apache/zookeeper/server/quorum/QuorumMXBean.java,34,0,0.0,0,0,0.0,0,0,0.0,0,0,0.0,0,0,0,0,NO
7,src/java/main/org/apache/zookeeper/server/quorum/QuorumPeer.java,873,187,46.75,187,25,6.25,25,212,53.0,212,166,41.5,166,4,1,2,YES
7,src/java/main/org/apache/zookeeper/server/quorum/QuorumPeerConfig.java,321,44,44.0,44,2,2.0,2,46,46.0,46,42,42.0,42,1,0,1,NO
7,src/java/main/org/apache/zookeeper/server/quorum/QuorumPeerMain.java,149,1,1.0,1,0,0.0,0,1,1.0,1,1,1.0,1,1,0,1,YES
7,src/java/main/org/apache/zookeeper/server/quorum/QuorumStats.java,68,3,3.0,3,2,2.0,2,5,5.0,5,1,1.0,1,1,0,1,NO
7,src/java/main/org/apache/zookeeper/server/quorum/RemotePeerBean.java,45,0,0.0,0,0,0.0,0,0,0.0,0,0,0.0,0,0,0,0,NO
7,src/java/main/org/apache/zookeeper/server/quorum/RemotePeerMXBean.java,33,0,0.0,0,0,0.0,0,0,0.0,0,0,0.0,0,0,0,0,NO
7,src/java/main/org/apache/zookeeper/server/quorum/SendAckRequestProcessor.java,79,9,9.0,9,9,9.0,9,18,18.0,18,0,0.0,0,1,0,1,NO
7,src/java/main/org/apache/zookeeper/server/quorum/ServerBean.java,38,0,0.0,0,0,0.0,0,0,0.0,0,0,0.0,0,0,0,0,NO
7,src/java/main/org/apache/zookeeper/server/quorum/ServerMXBean.java,33,0,0.0,0,0,0.0,0,0,0.0,0,0,0.0,0,0,0,0,NO
7,src/java/main/org/apache/zookeeper/server/quorum/Vote.java,69,0,0.0,0,0,0.0,0,0,0.0,0,0,0.0,0,0,0,0,YES
7,src/java/main/org/apache/zookeeper/server/quorum/flexible/QuorumHierarchical.java,272,0,0.0,0,0,0.0,0,0,0.0,0,0,0.0,0,0,0,0,NO
7,src/java/main/org/apache/zookeeper/server/quorum/flexible/QuorumMaj.java,57,0,0.0,0,0,0.0,0,0,0.0,0,0,0.0,0,0,0,0,NO
7,src/java/main/org/apache/zookeeper/server/quorum/flexible/QuorumVerifier.java,33,0,0.0,0,0,0.0,0,0,0.0,0,0,0.0,0,0,0,0,NO
7,src/java/main/org/apache/zookeeper/server/upgrade/DataNodeV1.java,129,0,0.0,0,0,0.0,0,0,0.0,0,0,0.0,0,0,0,0,NO
7,src/java/main/org/apache/zookeeper/server/upgrade/DataTreeV1.java,583,0,0.0,0,0,0.0,0,0,0.0,0,0,0.0,0,0,0,0,NO
7,src/java/main/org/apache/zookeeper/server/upgrade/UpgradeMain.java,180,0,0.0,0,0,0.0,0,0,0.0,0,0,0.0,0,0,0,0,NO
7,src/java/main/org/apache/zookeeper/server/upgrade/UpgradeSnapShot.java,33,0,0.0,0,0,0.0,0,0,0.0,0,0,0.0,0,0,0,0,NO
7,src/java/main/org/apache/zookeeper/server/upgrade/UpgradeSnapShotV1.java,333,0,0.0,0,0,0.0,0,0,0.0,0,0,0.0,0,0,0,0,NO
7,src/java/main/org/apache/zookeeper/server/util/Profiler.java,40,0,0.0,0,0,0.0,0,0,0.0,0,0,0.0,0,0,0,0,NO
7,src/java/main/org/apache/zookeeper/server/util/SerializeUtils.java,107,0,0.0,0,0,0.0,0,0,0.0,0,0,0.0,0,0,0,0,NO
7,src/java/main/org/apache/zookeeper/version/util/VerGen.java,128,0,0.0,0,0,0.0,0,0,0.0,0,0,0.0,0,0,0,0,NO
7,src/recipes/lock/src/java/org/apache/zookeeper/recipes/lock/LockListener.java,38,0,0.0,0,0,0.0,0,0,0.0,0,0,0.0,0,0,0,0,NO
7,src/recipes/lock/src/java/org/apache/zookeeper/recipes/lock/ProtocolSupport.java,192,0,0.0,0,0,0.0,0,0,0.0,0,0,0.0,0,0,0,0,NO
7,src/recipes/lock/src/java/org/apache/zookeeper/recipes/lock/WriteLock.java,294,0,0.0,0,0,0.0,0,0,0.0,0,0,0.0,0,0,0,0,NO
7,src/recipes/lock/src/java/org/apache/zookeeper/recipes/lock/ZNodeName.java,109,0,0.0,0,0,0.0,0,0,0.0,0,0,0.0,0,0,0,0,NO
7,src/recipes/lock/src/java/org/apache/zookeeper/recipes/lock/ZooKeeperOperation.java,38,0,0.0,0,0,0.0,0,0,0.0,0,0,0.0,0,0,0,0,NO
7,src/recipes/queue/src/java/org/apache/zookeeper/recipes/queue/DistributedQueue.java,312,312,312.0,312,0,0.0,0,312,312.0,312,312,312.0,312,1,0,1,NO
8,src/contrib/bookkeeper/benchmark/org/apache/bookkeeper/benchmark/MySqlClient.java,137,1,1.0,1,1,1.0,1,2,2.0,2,0,0.0,0,1,0,1,NO
8,src/contrib/bookkeeper/benchmark/org/apache/bookkeeper/benchmark/TestClient.java,252,2,2.0,2,2,2.0,2,4,4.0,4,0,0.0,0,1,0,1,NO
8,src/contrib/bookkeeper/src/java/org/apache/bookkeeper/bookie/Bookie.java,532,267,133.5,267,97,48.5,97,364,182.0,364,170,85.0,170,2,0,2,NO
8,src/contrib/bookkeeper/src/java/org/apache/bookkeeper/bookie/BookieException.java,81,0,0.0,0,0,0.0,0,0,0.0,0,0,0.0,0,0,0,0,NO
8,src/contrib/bookkeeper/src/java/org/apache/bookkeeper/bookie/BufferedChannel.java,157,157,157.0,157,0,0.0,0,157,157.0,157,157,157.0,157,1,0,1,NO
8,src/contrib/bookkeeper/src/java/org/apache/bookkeeper/bookie/EntryLogger.java,264,264,264.0,264,0,0.0,0,264,264.0,264,264,264.0,264,1,0,1,NO
8,src/contrib/bookkeeper/src/java/org/apache/bookkeeper/bookie/FileInfo.java,113,113,113.0,113,0,0.0,0,113,113.0,113,113,113.0,113,1,0,1,NO
8,src/contrib/bookkeeper/src/java/org/apache/bookkeeper/bookie/LedgerCache.java,454,454,454.0,454,0,0.0,0,454,454.0,454,454,454.0,454,1,0,1,NO
8,src/contrib/bookkeeper/src/java/org/apache/bookkeeper/bookie/LedgerDescriptor.java,133,47,47.0,47,79,79.0,79,126,126.0,126,32,32.0,32,1,0,1,NO
8,src/contrib/bookkeeper/src/java/org/apache/bookkeeper/bookie/LedgerEntryPage.java,151,151,151.0,151,0,0.0,0,151,151.0,151,151,151.0,151,1,0,1,NO
8,src/contrib/bookkeeper/src/java/org/apache/bookkeeper/bookie/MarkerFileChannel.java,147,147,147.0,147,0,0.0,0,147,147.0,147,147,147.0,147,1,0,1,NO
8,src/contrib/bookkeeper/src/java/org/apache/bookkeeper/client/AsyncCallback.java,101,93,93.0,93,73,73.0,73,166,166.0,166,20,20.0,20,1,0,1,NO
8,src/contrib/bookkeeper/src/java/org/apache/bookkeeper/client/BKException.java,227,107,107.0,107,43,43.0,43,150,150.0,150,64,64.0,64,1,0,1,NO
8,src/contrib/bookkeeper/src/java/org/apache/bookkeeper/client/BookKeeper.java,352,299,299.0,299,563,563.0,563,862,862.0,862,264,264.0,264,1,0,1,NO
8,src/contrib/bookkeeper/src/java/org/apache/bookkeeper/client/BookieWatcher.java,204,204,204.0,204,0,0.0,0,204,204.0,204,204,204.0,204,1,0,1,NO
8,src/contrib/bookkeeper/src/java/org/apache/bookkeeper/client/CRC32DigestManager.java,50,50,50.0,50,0,0.0,0,50,50.0,50,50,50.0,50,1,0,1,NO
8,src/contrib/bookkeeper/src/java/org/apache/bookkeeper/client/DigestManager.java,162,162,162.0,162,0,0.0,0,162,162.0,162,162,162.0,162,1,0,1,NO
8,src/contrib/bookkeeper/src/java/org/apache/bookkeeper/client/DistributionSchedule.java,61,61,61.0,61,0,0.0,0,61,61.0,61,61,61.0,61,1,0,1,NO
8,src/contrib/bookkeeper/src/java/org/apache/bookkeeper/client/LedgerCreateOp.java,163,163,163.0,163,0,0.0,0,163,163.0,163,163,163.0,163,1,0,1,NO
8,src/contrib/bookkeeper/src/java/org/apache/bookkeeper/client/LedgerEntry.java,78,46,46.0,46,26,26.0,26,72,72.0,72,20,20.0,20,1,0,1,NO
8,src/contrib/bookkeeper/src/java/org/apache/bookkeeper/client/LedgerHandle.java,448,401,401.0,401,797,797.0,797,1198,1198.0,1198,396,396.0,396,1,0,1,NO
8,src/contrib/bookkeeper/src/java/org/apache/bookkeeper/client/LedgerMetadata.java,179,179,179.0,179,0,0.0,0,179,179.0,179,179,179.0,179,1,0,1,NO
8,src/contrib/bookkeeper/src/java/org/apache/bookkeeper/client/LedgerOpenOp.java,136,136,136.0,136,0,0.0,0,136,136.0,136,136,136.0,136,1,0,1,NO
8,src/contrib/bookkeeper/src/java/org/apache/bookkeeper/client/LedgerRecoveryOp.java,167,167,167.0,167,0,0.0,0,167,167.0,167,167,167.0,167,1,0,1,NO
8,src/contrib/bookkeeper/src/java/org/apache/bookkeeper/client/MacDigestManager.java,67,67,67.0,67,0,0.0,0,67,67.0,67,67,67.0,67,1,0,1,NO
8,src/contrib/bookkeeper/src/java/org/apache/bookkeeper/client/PendingAddOp.java,137,137,137.0,137,0,0.0,0,137,137.0,137,137,137.0,137,1,0,1,NO
8,src/contrib/bookkeeper/src/java/org/apache/bookkeeper/client/PendingReadOp.java,145,145,145.0,145,0,0.0,0,145,145.0,145,145,145.0,145,1,0,1,NO
8,src/contrib/bookkeeper/src/java/org/apache/bookkeeper/client/RoundRobinDistributionSchedule.java,87,87,87.0,87,0,0.0,0,87,87.0,87,87,87.0,87,1,0,1,NO
8,src/contrib/bookkeeper/src/java/org/apache/bookkeeper/client/SyncCounter.java,85,85,85.0,85,0,0.0,0,85,85.0,85,85,85.0,85,1,0,1,NO
8,src/contrib/bookkeeper/src/java/org/apache/bookkeeper/proto/BookieClient.java,178,86,86.0,86,349,349.0,349,435,435.0,435,263,263.0,263,1,0,1,NO
8,src/contrib/bookkeeper/src/java/org/apache/bookkeeper/proto/BookieProtocol.java,75,19,19.0,19,20,20.0,20,39,39.0,39,1,1.0,1,1,0,1,NO
8,src/contrib/bookkeeper/src/java/org/apache/bookkeeper/proto/BookieServer.java,208,63,31.5,63,54,27.0,54,117,58.5,117,9,4.5,9,2,0,2,NO
8,src/contrib/bookkeeper/src/java/org/apache/bookkeeper/proto/BookkeeperInternalCallbacks.java,57,57,57.0,57,0,0.0,0,57,57.0,57,57,57.0,57,1,0,1,NO
8,src/contrib/bookkeeper/src/java/org/apache/bookkeeper/proto/NIOServerFactory.java,517,28,28.0,28,38,38.0,38,66,66.0,66,10,10.0,10,1,0,1,NO
8,src/contrib/bookkeeper/src/java/org/apache/bookkeeper/proto/PerChannelBookieClient.java,570,570,570.0,570,0,0.0,0,570,570.0,570,570,570.0,570,1,0,1,NO
8,src/contrib/bookkeeper/src/java/org/apache/bookkeeper/proto/ServerStats.java,148,51,51.0,51,36,36.0,36,87,87.0,87,15,15.0,15,1,0,1,NO
8,src/contrib/bookkeeper/src/java/org/apache/bookkeeper/streaming/LedgerInputStream.java,173,37,18.5,37,28,14.0,28,65,32.5,65,9,4.5,9,2,1,1,NO
8,src/contrib/bookkeeper/src/java/org/apache/bookkeeper/streaming/LedgerOutputStream.java,147,32,32.0,32,33,33.0,33,65,65.0,65,1,1.0,1,1,0,1,NO
8,src/contrib/bookkeeper/src/java/org/apache/bookkeeper/util/LocalBookKeeper.java,208,62,15.5,62,18,4.5,18,80,20.0,80,58,14.5,58,4,2,2,NO
8,src/contrib/bookkeeper/src/java/org/apache/bookkeeper/util/Main.java,54,6,6.0,6,7,7.0,7,13,13.0,13,1,1.0,1,1,0,1,NO
8,src/contrib/bookkeeper/src/java/org/apache/bookkeeper/util/MathUtils.java,38,38,38.0,38,0,0.0,0,38,38.0,38,38,38.0,38,1,0,1,NO
8,src/contrib/bookkeeper/src/java/org/apache/bookkeeper/util/OrderedSafeExecutor.java,98,98,98.0,98,0,0.0,0,98,98.0,98,98,98.0,98,1,0,1,NO
8,src/contrib/bookkeeper/src/java/org/apache/bookkeeper/util/SafeRunnable.java,38,38,38.0,38,0,0.0,0,38,38.0,38,38,38.0,38,1,0,1,NO
8,src/contrib/bookkeeper/src/java/org/apache/bookkeeper/util/StringUtils.java,94,94,94.0,94,0,0.0,0,94,94.0,94,94,94.0,94,1,0,1,NO
8,src/contrib/fatjar/src/java/org/apache/zookeeper/util/FatJarMain.java,126,0,0.0,0,0,0.0,0,0,0.0,0,0,0.0,0,0,0,0,NO
8,src/contrib/rest/src/java/org/apache/zookeeper/server/jersey/RestMain.java,78,0,0.0,0,0,0.0,0,0,0.0,0,0,0.0,0,0,0,0,NO
8,src/contrib/rest/src/java/org/apache/zookeeper/server/jersey/ZooKeeperService.java,110,0,0.0,0,0,0.0,0,0,0.0,0,0,0.0,0,0,0,0,NO
8,src/contrib/rest/src/java/org/apache/zookeeper/server/jersey/jaxb/ZChildren.java,80,0,0.0,0,0,0.0,0,0,0.0,0,0,0.0,0,0,0,0,NO
8,src/contrib/rest/src/java/org/apache/zookeeper/server/jersey/jaxb/ZChildrenJSON.java,76,0,0.0,0,0,0.0,0,0,0.0,0,0,0.0,0,0,0,0,NO
8,src/contrib/rest/src/java/org/apache/zookeeper/server/jersey/jaxb/ZError.java,41,0,0.0,0,0,0.0,0,0,0.0,0,0,0.0,0,0,0,0,NO
8,src/contrib/rest/src/java/org/apache/zookeeper/server/jersey/jaxb/ZPath.java,63,0,0.0,0,0,0.0,0,0,0.0,0,0,0.0,0,0,0,0,NO
8,src/contrib/rest/src/java/org/apache/zookeeper/server/jersey/jaxb/ZStat.java,106,0,0.0,0,0,0.0,0,0,0.0,0,0,0.0,0,0,0,0,NO
8,src/contrib/rest/src/java/org/apache/zookeeper/server/jersey/resources/JAXBContextResolver.java,72,0,0.0,0,0,0.0,0,0,0.0,0,0,0.0,0,0,0,0,NO
8,src/contrib/rest/src/java/org/apache/zookeeper/server/jersey/resources/KeeperExceptionMapper.java,86,0,0.0,0,0,0.0,0,0,0.0,0,0,0.0,0,0,0,0,NO
8,src/contrib/rest/src/java/org/apache/zookeeper/server/jersey/resources/RuntimeExceptionMapper.java,48,0,0.0,0,0,0.0,0,0,0.0,0,0,0.0,0,0,0,0,YES
8,src/contrib/rest/src/java/org/apache/zookeeper/server/jersey/resources/ZErrorWriter.java,63,0,0.0,0,0,0.0,0,0,0.0,0,0,0.0,0,0,0,0,NO
8,src/contrib/rest/src/java/org/apache/zookeeper/server/jersey/resources/ZNodeResource.java,375,0,0.0,0,0,0.0,0,0,0.0,0,0,0.0,0,0,0,0,YES
8,src/contrib/zooinspector/src/java/org/apache/zookeeper/inspector/ZooInspector.java,66,66,66.0,66,0,0.0,0,66,66.0,66,66,66.0,66,1,0,1,NO
8,src/contrib/zooinspector/src/java/org/apache/zookeeper/inspector/encryption/BasicDataEncryptionManager.java,50,50,50.0,50,0,0.0,0,50,50.0,50,50,50.0,50,1,0,1,NO
8,src/contrib/zooinspector/src/java/org/apache/zookeeper/inspector/encryption/DataEncryptionManager.java,39,39,39.0,39,0,0.0,0,39,39.0,39,39,39.0,39,1,0,1,NO
8,src/contrib/zooinspector/src/java/org/apache/zookeeper/inspector/gui/NodeViewersChangeListener.java,37,37,37.0,37,0,0.0,0,37,37.0,37,37,37.0,37,1,0,1,NO
8,src/contrib/zooinspector/src/java/org/apache/zookeeper/inspector/gui/ZooInspectorAboutDialog.java,80,80,80.0,80,0,0.0,0,80,80.0,80,80,80.0,80,1,0,1,NO
8,src/contrib/zooinspector/src/java/org/apache/zookeeper/inspector/gui/ZooInspectorConnectionPropertiesDialog.java,321,321,321.0,321,0,0.0,0,321,321.0,321,321,321.0,321,1,0,1,NO
8,src/contrib/zooinspector/src/java/org/apache/zookeeper/inspector/gui/ZooInspectorIconResources.java,118,118,118.0,118,0,0.0,0,118,118.0,118,118,118.0,118,1,0,1,NO
8,src/contrib/zooinspector/src/java/org/apache/zookeeper/inspector/gui/ZooInspectorNodeViewersDialog.java,605,605,605.0,605,0,0.0,0,605,605.0,605,605,605.0,605,1,0,1,NO
8,src/contrib/zooinspector/src/java/org/apache/zookeeper/inspector/gui/ZooInspectorNodeViewersPanel.java,140,140,140.0,140,0,0.0,0,140,140.0,140,140,140.0,140,1,0,1,NO
8,src/contrib/zooinspector/src/java/org/apache/zookeeper/inspector/gui/ZooInspectorPanel.java,361,361,361.0,361,0,0.0,0,361,361.0,361,361,361.0,361,1,0,1,NO
8,src/contrib/zooinspector/src/java/org/apache/zookeeper/inspector/gui/ZooInspectorTreeViewer.java,362,362,362.0,362,0,0.0,0,362,362.0,362,362,362.0,362,1,0,1,NO
8,src/contrib/zooinspector/src/java/org/apache/zookeeper/inspector/gui/nodeviewer/NodeViewerACL.java,187,187,187.0,187,0,0.0,0,187,187.0,187,187,187.0,187,1,0,1,NO
8,src/contrib/zooinspector/src/java/org/apache/zookeeper/inspector/gui/nodeviewer/NodeViewerData.java,146,146,146.0,146,0,0.0,0,146,146.0,146,146,146.0,146,1,0,1,NO
8,src/contrib/zooinspector/src/java/org/apache/zookeeper/inspector/gui/nodeviewer/NodeViewerMetaData.java,186,186,186.0,186,0,0.0,0,186,186.0,186,186,186.0,186,1,0,1,NO
8,src/contrib/zooinspector/src/java/org/apache/zookeeper/inspector/gui/nodeviewer/ZooInspectorNodeViewer.java,138,138,138.0,138,0,0.0,0,138,138.0,138,138,138.0,138,1,0,1,NO
8,src/contrib/zooinspector/src/java/org/apache/zookeeper/inspector/logger/LoggerFactory.java,38,38,38.0,38,0,0.0,0,38,38.0,38,38,38.0,38,1,0,1,NO
8,src/contrib/zooinspector/src/java/org/apache/zookeeper/inspector/manager/NodeListener.java,37,37,37.0,37,0,0.0,0,37,37.0,37,37,37.0,37,1,0,1,NO
8,src/contrib/zooinspector/src/java/org/apache/zookeeper/inspector/manager/Pair.java,120,120,120.0,120,0,0.0,0,120,120.0,120,120,120.0,120,1,0,1,NO
8,src/contrib/zooinspector/src/java/org/apache/zookeeper/inspector/manager/ZooInspectorManager.java,139,139,139.0,139,0,0.0,0,139,139.0,139,139,139.0,139,1,0,1,NO
8,src/contrib/zooinspector/src/java/org/apache/zookeeper/inspector/manager/ZooInspectorManagerImpl.java,852,852,852.0,852,0,0.0,0,852,852.0,852,852,852.0,852,1,0,1,NO
8,src/contrib/zooinspector/src/java/org/apache/zookeeper/inspector/manager/ZooInspectorNodeManager.java,33,33,33.0,33,0,0.0,0,33,33.0,33,33,33.0,33,1,0,1,NO
8,src/contrib/zooinspector/src/java/org/apache/zookeeper/inspector/manager/ZooInspectorNodeTreeManager.java,43,43,43.0,43,0,0.0,0,43,43.0,43,43,43.0,43,1,0,1,NO
8,src/contrib/zooinspector/src/java/org/apache/zookeeper/inspector/manager/ZooInspectorReadOnlyManager.java,99,99,99.0,99,0,0.0,0,99,99.0,99,99,99.0,99,1,0,1,NO
8,src/contrib/zooinspector/src/java/org/apache/zookeeper/retry/ZooKeeperRetry.java,288,288,288.0,288,0,0.0,0,288,288.0,288,288,288.0,288,1,0,1,NO
8,src/java/main/org/apache/jute/BinaryInputArchive.java,131,0,0.0,0,0,0.0,0,0,0.0,0,0,0.0,0,0,0,0,NO
8,src/java/main/org/apache/jute/BinaryOutputArchive.java,146,0,0.0,0,0,0.0,0,0,0.0,0,0,0.0,0,0,0,0,NO
8,src/java/main/org/apache/jute/CsvInputArchive.java,208,1,1.0,1,1,1.0,1,2,2.0,2,0,0.0,0,1,0,1,NO
8,src/java/main/org/apache/jute/CsvOutputArchive.java,150,0,0.0,0,0,0.0,0,0,0.0,0,0,0.0,0,0,0,0,NO
8,src/java/main/org/apache/jute/Index.java,38,0,0.0,0,0,0.0,0,0,0.0,0,0,0.0,0,0,0,0,NO
8,src/java/main/org/apache/jute/InputArchive.java,43,0,0.0,0,0,0.0,0,0,0.0,0,0,0.0,0,0,0,0,NO
8,src/java/main/org/apache/jute/OutputArchive.java,47,0,0.0,0,0,0.0,0,0,0.0,0,0,0.0,0,0,0,0,NO
8,src/java/main/org/apache/jute/Record.java,32,0,0.0,0,0,0.0,0,0,0.0,0,0,0.0,0,0,0,0,NO
8,src/java/main/org/apache/jute/RecordReader.java,93,0,0.0,0,0,0.0,0,0,0.0,0,0,0.0,0,0,0,0,NO
8,src/java/main/org/apache/jute/RecordWriter.java,113,0,0.0,0,0,0.0,0,0,0.0,0,0,0.0,0,0,0,0,NO
8,src/java/main/org/apache/jute/Utils.java,282,6,6.0,6,6,6.0,6,12,12.0,12,0,0.0,0,1,0,1,NO
8,src/java/main/org/apache/jute/XmlInputArchive.java,251,0,0.0,0,0,0.0,0,0,0.0,0,0,0.0,0,0,0,0,NO
8,src/java/main/org/apache/jute/XmlOutputArchive.java,251,1,1.0,1,1,1.0,1,2,2.0,2,0,0.0,0,1,0,1,NO
8,src/java/main/org/apache/jute/compiler/CGenerator.java,130,46,46.0,46,7,7.0,7,53,53.0,53,39,39.0,39,1,0,1,NO
8,src/java/main/org/apache/jute/compiler/CppGenerator.java,125,46,46.0,46,7,7.0,7,53,53.0,53,39,39.0,39,1,0,1,NO
8,src/java/main/org/apache/jute/compiler/JBoolean.java,42,0,0.0,0,0,0.0,0,0,0.0,0,0,0.0,0,0,0,0,NO
8,src/java/main/org/apache/jute/compiler/JBuffer.java,106,3,3.0,3,3,3.0,3,6,6.0,6,0,0.0,0,1,0,1,NO
8,src/java/main/org/apache/jute/compiler/JByte.java,34,0,0.0,0,0,0.0,0,0,0.0,0,0,0.0,0,0,0,0,NO
8,src/java/main/org/apache/jute/compiler/JCompType.java,53,0,0.0,0,0,0.0,0,0,0.0,0,0,0.0,0,0,0,0,NO
8,src/java/main/org/apache/jute/compiler/JDouble.java,40,0,0.0,0,0,0.0,0,0,0.0,0,0,0.0,0,0,0,0,NO
8,src/java/main/org/apache/jute/compiler/JField.java,98,0,0.0,0,0,0.0,0,0,0.0,0,0,0.0,0,0,0,0,NO
8,src/java/main/org/apache/jute/compiler/JFile.java,80,0,0.0,0,0,0.0,0,0,0.0,0,0,0.0,0,0,0,0,NO
8,src/java/main/org/apache/jute/compiler/JFloat.java,39,0,0.0,0,0,0.0,0,0,0.0,0,0,0.0,0,0,0,0,NO
8,src/java/main/org/apache/jute/compiler/JInt.java,34,0,0.0,0,0,0.0,0,0,0.0,0,0,0.0,0,0,0,0,NO
8,src/java/main/org/apache/jute/compiler/JLong.java,38,0,0.0,0,0,0.0,0,0,0.0,0,0,0.0,0,0,0,0,NO
8,src/java/main/org/apache/jute/compiler/JMap.java,103,2,2.0,2,2,2.0,2,4,4.0,4,0,0.0,0,1,0,1,NO
8,src/java/main/org/apache/jute/compiler/JRecord.java,536,187,93.5,187,169,84.5,169,356,178.0,356,18,9.0,18,2,0,1,YES
8,src/java/main/org/apache/jute/compiler/JString.java,46,0,0.0,0,0,0.0,0,0,0.0,0,0,0.0,0,0,0,0,NO
8,src/java/main/org/apache/jute/compiler/JType.java,141,0,0.0,0,0,0.0,0,0,0.0,0,0,0.0,0,0,0,0,NO
8,src/java/main/org/apache/jute/compiler/JVector.java,106,2,2.0,2,2,2.0,2,4,4.0,4,0,0.0,0,1,0,1,NO
8,src/java/main/org/apache/jute/compiler/JavaGenerator.java,57,0,0.0,0,0,0.0,0,0,0.0,0,0,0.0,0,0,0,0,NO
8,src/java/main/org/apache/jute/compiler/generated/ParseException.java,210,0,0.0,0,0,0.0,0,0,0.0,0,0,0.0,0,0,0,0,NO
8,src/java/main/org/apache/jute/compiler/generated/Rcc.java,525,0,0.0,0,0,0.0,0,0,0.0,0,0,0.0,0,0,0,0,NO
8,src/java/main/org/apache/jute/compiler/generated/RccConstants.java,88,0,0.0,0,0,0.0,0,0,0.0,0,0,0.0,0,0,0,0,NO
8,src/java/main/org/apache/jute/compiler/generated/RccTokenManager.java,833,0,0.0,0,0,0.0,0,0,0.0,0,0,0.0,0,0,0,0,NO
8,src/java/main/org/apache/jute/compiler/generated/SimpleCharStream.java,457,0,0.0,0,0,0.0,0,0,0.0,0,0,0.0,0,0,0,0,NO
8,src/java/main/org/apache/jute/compiler/generated/Token.java,99,0,0.0,0,0,0.0,0,0,0.0,0,0,0.0,0,0,0,0,NO
8,src/java/main/org/apache/jute/compiler/generated/TokenMgrError.java,151,0,0.0,0,0,0.0,0,0,0.0,0,0,0.0,0,0,0,0,NO
8,src/java/main/org/apache/zookeeper/AsyncCallback.java,57,0,0.0,0,0,0.0,0,0,0.0,0,0,0.0,0,0,0,0,NO
8,src/java/main/org/apache/zookeeper/ClientCnxn.java,1320,93,18.6,93,27,5.4,27,120,24.0,120,66,13.2,66,5,2,3,YES
8,src/java/main/org/apache/zookeeper/ClientWatchManager.java,39,0,0.0,0,0,0.0,0,0,0.0,0,0,0.0,0,0,0,0,NO
8,src/java/main/org/apache/zookeeper/CreateMode.java,89,0,0.0,0,0,0.0,0,0,0.0,0,0,0.0,0,0,0,0,NO
8,src/java/main/org/apache/zookeeper/Environment.java,100,0,0.0,0,0,0.0,0,0,0.0,0,0,0.0,0,0,0,0,NO
8,src/java/main/org/apache/zookeeper/JLineZNodeCompletor.java,84,0,0.0,0,0,0.0,0,0,0.0,0,0,0.0,0,0,0,0,NO
8,src/java/main/org/apache/zookeeper/KeeperException.java,662,0,0.0,0,0,0.0,0,0,0.0,0,0,0.0,0,0,0,0,NO
8,src/java/main/org/apache/zookeeper/Quotas.java,68,0,0.0,0,0,0.0,0,0,0.0,0,0,0.0,0,0,0,0,NO
8,src/java/main/org/apache/zookeeper/ServerAdminClient.java,312,0,0.0,0,0,0.0,0,0,0.0,0,0,0.0,0,0,0,0,NO
8,src/java/main/org/apache/zookeeper/StatsTrack.java,101,0,0.0,0,0,0.0,0,0,0.0,0,0,0.0,0,0,0,0,NO
8,src/java/main/org/apache/zookeeper/Version.java,78,0,0.0,0,0,0.0,0,0,0.0,0,0,0.0,0,0,0,0,NO
8,src/java/main/org/apache/zookeeper/WatchedEvent.java,79,2,2.0,2,4,4.0,4,6,6.0,6,2,2.0,2,1,1,1,NO
8,src/java/main/org/apache/zookeeper/Watcher.java,125,0,0.0,0,0,0.0,0,0,0.0,0,0,0.0,0,0,0,0,NO
8,src/java/main/org/apache/zookeeper/ZooDefs.java,113,3,3.0,3,4,4.0,4,7,7.0,7,1,1.0,1,1,0,1,NO
8,src/java/main/org/apache/zookeeper/ZooKeeper.java,1546,68,22.666666,68,3,1.0,3,71,23.666666,71,65,21.666666,65,3,1,2,YES
8,src/java/main/org/apache/zookeeper/ZooKeeperMain.java,833,7,3.5,7,6,3.0,6,13,6.5,13,1,0.5,1,2,1,2,NO
8,src/java/main/org/apache/zookeeper/common/PathTrie.java,283,2,2.0,2,2,2.0,2,4,4.0,4,0,0.0,0,1,0,1,NO
8,src/java/main/org/apache/zookeeper/common/PathUtils.java,103,0,0.0,0,0,0.0,0,0,0.0,0,0,0.0,0,0,0,0,NO
8,src/java/main/org/apache/zookeeper/jmx/CommonNames.java,29,0,0.0,0,0,0.0,0,0,0.0,0,0,0.0,0,0,0,0,NO
8,src/java/main/org/apache/zookeeper/jmx/MBeanRegistry.java,194,0,0.0,0,0,0.0,0,0,0.0,0,0,0.0,0,0,0,0,NO
8,src/java/main/org/apache/zookeeper/jmx/ManagedUtil.java,72,0,0.0,0,0,0.0,0,0,0.0,0,0,0.0,0,0,0,0,NO
8,src/java/main/org/apache/zookeeper/jmx/ZKMBeanInfo.java,36,0,0.0,0,0,0.0,0,0,0.0,0,0,0.0,0,0,0,0,NO
8,src/java/main/org/apache/zookeeper/server/ByteBufferInputStream.java,72,0,0.0,0,0,0.0,0,0,0.0,0,0,0.0,0,0,0,0,NO
8,src/java/main/org/apache/zookeeper/server/ConnectionBean.java,173,25,12.5,25,11,5.5,11,36,18.0,36,14,7.0,14,2,2,1,NO
8,src/java/main/org/apache/zookeeper/server/ConnectionMXBean.java,98,0,0.0,0,0,0.0,0,0,0.0,0,0,0.0,0,0,0,0,NO
8,src/java/main/org/apache/zookeeper/server/DataNode.java,170,0,0.0,0,0,0.0,0,0,0.0,0,0,0.0,0,0,0,0,NO
8,src/java/main/org/apache/zookeeper/server/DataTree.java,1185,29,14.5,29,8,4.0,8,37,18.5,37,21,10.5,21,2,0,2,NO
8,src/java/main/org/apache/zookeeper/server/DataTreeBean.java,70,0,0.0,0,0,0.0,0,0,0.0,0,0,0.0,0,0,0,0,NO
8,src/java/main/org/apache/zookeeper/server/DataTreeMXBean.java,47,0,0.0,0,0,0.0,0,0,0.0,0,0,0.0,0,0,0,0,NO
8,src/java/main/org/apache/zookeeper/server/FinalRequestProcessor.java,381,30,7.5,30,17,4.25,17,47,11.75,47,13,3.25,13,4,2,3,NO
8,src/java/main/org/apache/zookeeper/server/LogFormatter.java,107,44,44.0,44,9,9.0,9,53,53.0,53,35,35.0,35,1,1,1,NO
8,src/java/main/org/apache/zookeeper/server/NIOServerCnxn.java,1668,573,81.85714,573,267,38.142857,267,840,120.0,840,306,43.714287,306,7,2,3,YES
8,src/java/main/org/apache/zookeeper/server/ObserverBean.java,45,0,0.0,0,0,0.0,0,0,0.0,0,0,0.0,0,0,0,0,NO
8,src/java/main/org/apache/zookeeper/server/PrepRequestProcessor.java,512,9,3.0,9,9,3.0,9,18,6.0,18,0,0.0,0,3,1,2,NO
8,src/java/main/org/apache/zookeeper/server/PurgeTxnLog.java,132,0,0.0,0,0,0.0,0,0,0.0,0,0,0.0,0,0,0,0,NO
8,src/java/main/org/apache/zookeeper/server/Request.java,232,1,1.0,1,1,1.0,1,2,2.0,2,0,0.0,0,1,0,1,NO
8,src/java/main/org/apache/zookeeper/server/RequestProcessor.java,37,0,0.0,0,0,0.0,0,0,0.0,0,0,0.0,0,0,0,0,NO
8,src/java/main/org/apache/zookeeper/server/ServerCnxn.java,108,0,0.0,0,29,29.0,29,29,29.0,29,29,29.0,29,1,0,1,NO
8,src/java/main/org/apache/zookeeper/server/ServerConfig.java,111,22,11.0,22,5,2.5,5,27,13.5,27,17,8.5,17,2,0,2,NO
8,src/java/main/org/apache/zookeeper/server/ServerStats.java,132,0,0.0,0,0,0.0,0,0,0.0,0,0,0.0,0,0,0,0,NO
8,src/java/main/org/apache/zookeeper/server/SessionTracker.java,74,8,8.0,8,0,0.0,0,8,8.0,8,8,8.0,8,1,0,1,NO
8,src/java/main/org/apache/zookeeper/server/SessionTrackerImpl.java,257,37,18.5,37,24,12.0,24,61,30.5,61,13,6.5,13,2,0,2,NO
8,src/java/main/org/apache/zookeeper/server/SyncRequestProcessor.java,183,15,3.75,15,10,2.5,10,25,6.25,25,15,3.75,15,4,1,2,YES
8,src/java/main/org/apache/zookeeper/server/TraceFormatter.java,121,0,0.0,0,0,0.0,0,0,0.0,0,0,0.0,0,0,0,0,NO
8,src/java/main/org/apache/zookeeper/server/WatchManager.java,166,57,57.0,57,4,4.0,4,61,61.0,61,53,53.0,53,1,0,1,NO
8,src/java/main/org/apache/zookeeper/server/ZKDatabase.java,461,466,155.33333,466,5,1.6666666,5,471,157.0,471,461,153.66667,461,3,1,1,NO
8,src/java/main/org/apache/zookeeper/server/ZooKeeperServer.java,702,132,44.0,132,133,44.333332,133,265,88.333336,265,109,36.333332,109,3,1,1,YES
8,src/java/main/org/apache/zookeeper/server/ZooKeeperServerBean.java,143,29,29.0,29,0,0.0,0,29,29.0,29,29,29.0,29,1,0,1,NO
8,src/java/main/org/apache/zookeeper/server/ZooKeeperServerMXBean.java,106,26,26.0,26,2,2.0,2,28,28.0,28,24,24.0,24,1,0,1,NO
8,src/java/main/org/apache/zookeeper/server/ZooKeeperServerMain.java,127,6,3.0,6,3,1.5,3,9,4.5,9,3,1.5,3,2,0,2,NO
8,src/java/main/org/apache/zookeeper/server/ZooTrace.java,92,0,0.0,0,0,0.0,0,0,0.0,0,0,0.0,0,0,0,0,NO
8,src/java/main/org/apache/zookeeper/server/auth/AuthenticationProvider.java,82,0,0.0,0,0,0.0,0,0,0.0,0,0,0.0,0,0,0,0,NO
8,src/java/main/org/apache/zookeeper/server/auth/DigestAuthenticationProvider.java,138,1,1.0,1,1,1.0,1,2,2.0,2,0,0.0,0,1,0,1,NO
8,src/java/main/org/apache/zookeeper/server/auth/IPAuthenticationProvider.java,117,0,0.0,0,0,0.0,0,0,0.0,0,0,0.0,0,0,0,0,NO
8,src/java/main/org/apache/zookeeper/server/auth/ProviderRegistry.java,76,0,0.0,0,0,0.0,0,0,0.0,0,0,0.0,0,0,0,0,NO
8,src/java/main/org/apache/zookeeper/server/persistence/FileSnap.java,249,27,13.5,27,14,7.0,14,41,20.5,41,13,6.5,13,2,1,1,NO
8,src/java/main/org/apache/zookeeper/server/persistence/FileTxnLog.java,604,55,13.75,55,4,1.0,4,59,14.75,59,51,12.75,51,4,1,3,NO
8,src/java/main/org/apache/zookeeper/server/persistence/FileTxnSnapLog.java,296,9,4.5,9,1,0.5,1,10,5.0,10,8,4.0,8,2,0,2,NO
8,src/java/main/org/apache/zookeeper/server/persistence/SnapShot.java,66,6,6.0,6,0,0.0,0,6,6.0,6,6,6.0,6,1,0,1,NO
8,src/java/main/org/apache/zookeeper/server/persistence/TxnLog.java,120,4,4.0,4,0,0.0,0,4,4.0,4,4,4.0,4,1,0,1,NO
8,src/java/main/org/apache/zookeeper/server/persistence/Util.java,325,0,0.0,0,0,0.0,0,0,0.0,0,0,0.0,0,0,0,0,NO
8,src/java/main/org/apache/zookeeper/server/quorum/AckRequestProcessor.java,53,0,0.0,0,0,0.0,0,0,0.0,0,0,0.0,0,0,0,0,NO
8,src/java/main/org/apache/zookeeper/server/quorum/AuthFastLeaderElection.java,968,11,11.0,11,0,0.0,0,11,11.0,11,11,11.0,11,1,0,1,NO
8,src/java/main/org/apache/zookeeper/server/quorum/CommitProcessor.java,189,0,0.0,0,0,0.0,0,0,0.0,0,0,0.0,0,0,0,0,NO
8,src/java/main/org/apache/zookeeper/server/quorum/Election.java,27,1,1.0,1,0,0.0,0,1,1.0,1,1,1.0,1,1,0,1,NO
8,src/java/main/org/apache/zookeeper/server/quorum/FastLeaderElection.java,837,207,103.5,207,114,57.0,114,321,160.5,321,93,46.5,93,2,1,2,YES
8,src/java/main/org/apache/zookeeper/server/quorum/Follower.java,169,2,1.0,2,2,1.0,2,4,2.0,4,0,0.0,0,2,1,2,YES
8,src/java/main/org/apache/zookeeper/server/quorum/FollowerBean.java,50,0,0.0,0,0,0.0,0,0,0.0,0,0,0.0,0,0,0,0,NO
8,src/java/main/org/apache/zookeeper/server/quorum/FollowerMXBean.java,41,0,0.0,0,0,0.0,0,0,0.0,0,0,0.0,0,0,0,0,NO
8,src/java/main/org/apache/zookeeper/server/quorum/FollowerRequestProcessor.java,109,0,0.0,0,0,0.0,0,0,0.0,0,0,0.0,0,0,0,0,NO
8,src/java/main/org/apache/zookeeper/server/quorum/FollowerZooKeeperServer.java,162,7,3.5,7,5,2.5,5,12,6.0,12,2,1.0,2,2,1,1,NO
8,src/java/main/org/apache/zookeeper/server/quorum/Leader.java,718,7,2.3333333,7,8,2.6666667,8,15,5.0,15,1,0.33333334,1,3,2,2,YES
8,src/java/main/org/apache/zookeeper/server/quorum/LeaderBean.java,53,1,1.0,1,1,1.0,1,2,2.0,2,0,0.0,0,1,0,1,NO
8,src/java/main/org/apache/zookeeper/server/quorum/LeaderElection.java,274,56,18.666666,56,35,11.666667,35,91,30.333334,91,21,7.0,21,3,2,3,YES
8,src/java/main/org/apache/zookeeper/server/quorum/LeaderElectionBean.java,42,0,0.0,0,0,0.0,0,0,0.0,0,0,0.0,0,0,0,0,NO
8,src/java/main/org/apache/zookeeper/server/quorum/LeaderElectionMXBean.java,31,0,0.0,0,0,0.0,0,0,0.0,0,0,0.0,0,0,0,0,NO
8,src/java/main/org/apache/zookeeper/server/quorum/LeaderMXBean.java,36,0,0.0,0,0,0.0,0,0,0.0,0,0,0.0,0,0,0,0,NO
8,src/java/main/org/apache/zookeeper/server/quorum/LeaderZooKeeperServer.java,176,19,9.5,19,12,6.0,12,31,15.5,31,7,3.5,7,2,1,1,NO
8,src/java/main/org/apache/zookeeper/server/quorum/Learner.java,375,5,5.0,5,5,5.0,5,10,10.0,10,0,0.0,0,1,1,1,YES
8,src/java/main/org/apache/zookeeper/server/quorum/LearnerHandler.java,506,25,6.25,25,13,3.25,13,38,9.5,38,12,3.0,12,4,2,3,YES
8,src/java/main/org/apache/zookeeper/server/quorum/LearnerSessionTracker.java,92,7,7.0,7,4,4.0,4,11,11.0,11,3,3.0,3,1,0,1,NO
8,src/java/main/org/apache/zookeeper/server/quorum/LearnerSyncRequest.java,34,0,0.0,0,0,0.0,0,0,0.0,0,0,0.0,0,0,0,0,NO
8,src/java/main/org/apache/zookeeper/server/quorum/LearnerZooKeeperServer.java,142,13,6.5,13,20,10.0,20,33,16.5,33,7,3.5,7,2,1,1,NO
8,src/java/main/org/apache/zookeeper/server/quorum/LocalPeerBean.java,85,17,17.0,17,0,0.0,0,17,17.0,17,17,17.0,17,1,0,1,NO
8,src/java/main/org/apache/zookeeper/server/quorum/LocalPeerMXBean.java,77,13,13.0,13,0,0.0,0,13,13.0,13,13,13.0,13,1,0,1,NO
8,src/java/main/org/apache/zookeeper/server/quorum/Observer.java,146,2,1.0,2,2,1.0,2,4,2.0,4,0,0.0,0,2,1,2,NO
8,src/java/main/org/apache/zookeeper/server/quorum/ObserverMXBean.java,37,0,0.0,0,0,0.0,0,0,0.0,0,0,0.0,0,0,0,0,NO
8,src/java/main/org/apache/zookeeper/server/quorum/ObserverRequestProcessor.java,123,0,0.0,0,0,0.0,0,0,0.0,0,0,0.0,0,0,0,0,NO
8,src/java/main/org/apache/zookeeper/server/quorum/ObserverZooKeeperServer.java,116,7,3.5,7,5,2.5,5,12,6.0,12,2,1.0,2,2,1,1,NO
8,src/java/main/org/apache/zookeeper/server/quorum/ProposalRequestProcessor.java,82,0,0.0,0,0,0.0,0,0,0.0,0,0,0.0,0,0,0,0,NO
8,src/java/main/org/apache/zookeeper/server/quorum/QuorumBean.java,44,0,0.0,0,0,0.0,0,0,0.0,0,0,0.0,0,0,0,0,NO
8,src/java/main/org/apache/zookeeper/server/quorum/QuorumCnxManager.java,668,42,14.0,42,26,8.666667,26,68,22.666666,68,18,6.0,18,3,1,3,YES
8,src/java/main/org/apache/zookeeper/server/quorum/QuorumMXBean.java,34,0,0.0,0,0,0.0,0,0,0.0,0,0,0.0,0,0,0,0,NO
8,src/java/main/org/apache/zookeeper/server/quorum/QuorumPeer.java,947,124,13.777778,124,50,5.5555553,50,174,19.333334,174,76,8.444445,76,9,3,4,YES
8,src/java/main/org/apache/zookeeper/server/quorum/QuorumPeerConfig.java,344,73,24.333334,73,50,16.666666,50,123,41.0,123,29,9.666667,29,3,0,2,YES
8,src/java/main/org/apache/zookeeper/server/quorum/QuorumPeerMain.java,150,8,2.0,8,7,1.75,7,15,3.75,15,9,2.25,9,4,2,3,YES
8,src/java/main/org/apache/zookeeper/server/quorum/QuorumStats.java,68,0,0.0,0,0,0.0,0,0,0.0,0,0,0.0,0,0,0,0,NO
8,src/java/main/org/apache/zookeeper/server/quorum/QuorumZooKeeperServer.java,62,62,62.0,62,0,0.0,0,62,62.0,62,62,62.0,62,1,0,1,YES
8,src/java/main/org/apache/zookeeper/server/quorum/RemotePeerBean.java,45,0,0.0,0,0,0.0,0,0,0.0,0,0,0.0,0,0,0,0,NO
8,src/java/main/org/apache/zookeeper/server/quorum/RemotePeerMXBean.java,33,0,0.0,0,0,0.0,0,0,0.0,0,0,0.0,0,0,0,0,NO
8,src/java/main/org/apache/zookeeper/server/quorum/SendAckRequestProcessor.java,79,0,0.0,0,0,0.0,0,0,0.0,0,0,0.0,0,0,0,0,NO
8,src/java/main/org/apache/zookeeper/server/quorum/ServerBean.java,38,0,0.0,0,0,0.0,0,0,0.0,0,0,0.0,0,0,0,0,NO
8,src/java/main/org/apache/zookeeper/server/quorum/ServerMXBean.java,33,0,0.0,0,0,0.0,0,0,0.0,0,0,0.0,0,0,0,0,NO
8,src/java/main/org/apache/zookeeper/server/quorum/Vote.java,69,0,0.0,0,0,0.0,0,0,0.0,0,0,0.0,0,0,0,0,YES
8,src/java/main/org/apache/zookeeper/server/quorum/flexible/QuorumHierarchical.java,272,0,0.0,0,0,0.0,0,0,0.0,0,0,0.0,0,0,0,0,NO
8,src/java/main/org/apache/zookeeper/server/quorum/flexible/QuorumMaj.java,57,0,0.0,0,0,0.0,0,0,0.0,0,0,0.0,0,0,0,0,NO
8,src/java/main/org/apache/zookeeper/server/quorum/flexible/QuorumVerifier.java,33,0,0.0,0,0,0.0,0,0,0.0,0,0,0.0,0,0,0,0,NO
8,src/java/main/org/apache/zookeeper/server/upgrade/DataNodeV1.java,129,0,0.0,0,0,0.0,0,0,0.0,0,0,0.0,0,0,0,0,NO
8,src/java/main/org/apache/zookeeper/server/upgrade/DataTreeV1.java,583,1,1.0,1,1,1.0,1,2,2.0,2,0,0.0,0,1,0,1,NO
8,src/java/main/org/apache/zookeeper/server/upgrade/UpgradeMain.java,180,0,0.0,0,0,0.0,0,0,0.0,0,0,0.0,0,0,0,0,NO
8,src/java/main/org/apache/zookeeper/server/upgrade/UpgradeSnapShot.java,33,0,0.0,0,0,0.0,0,0,0.0,0,0,0.0,0,0,0,0,NO
8,src/java/main/org/apache/zookeeper/server/upgrade/UpgradeSnapShotV1.java,333,0,0.0,0,0,0.0,0,0,0.0,0,0,0.0,0,0,0,0,NO
8,src/java/main/org/apache/zookeeper/server/util/Profiler.java,40,0,0.0,0,0,0.0,0,0,0.0,0,0,0.0,0,0,0,0,NO
8,src/java/main/org/apache/zookeeper/server/util/SerializeUtils.java,107,0,0.0,0,0,0.0,0,0,0.0,0,0,0.0,0,0,0,0,NO
8,src/java/main/org/apache/zookeeper/version/util/VerGen.java,146,18,18.0,18,0,0.0,0,18,18.0,18,18,18.0,18,1,0,1,NO
8,src/recipes/lock/src/java/org/apache/zookeeper/recipes/lock/LockListener.java,38,0,0.0,0,0,0.0,0,0,0.0,0,0,0.0,0,0,0,0,NO
8,src/recipes/lock/src/java/org/apache/zookeeper/recipes/lock/ProtocolSupport.java,192,0,0.0,0,0,0.0,0,0,0.0,0,0,0.0,0,0,0,0,NO
8,src/recipes/lock/src/java/org/apache/zookeeper/recipes/lock/WriteLock.java,294,0,0.0,0,0,0.0,0,0,0.0,0,0,0.0,0,0,0,0,NO
8,src/recipes/lock/src/java/org/apache/zookeeper/recipes/lock/ZNodeName.java,109,0,0.0,0,0,0.0,0,0,0.0,0,0,0.0,0,0,0,0,NO
8,src/recipes/lock/src/java/org/apache/zookeeper/recipes/lock/ZooKeeperOperation.java,38,0,0.0,0,0,0.0,0,0,0.0,0,0,0.0,0,0,0,0,NO
8,src/recipes/queue/src/java/org/apache/zookeeper/recipes/queue/DistributedQueue.java,312,0,0.0,0,0,0.0,0,0,0.0,0,0,0.0,0,0,0,0,NO
9,src/contrib/bookkeeper/benchmark/org/apache/bookkeeper/benchmark/MySqlClient.java,137,0,0.0,0,0,0.0,0,0,0.0,0,0,0.0,0,0,0,0,NO
9,src/contrib/bookkeeper/benchmark/org/apache/bookkeeper/benchmark/TestClient.java,252,0,0.0,0,0,0.0,0,0,0.0,0,0,0.0,0,0,0,0,YES
9,src/contrib/bookkeeper/src/java/org/apache/bookkeeper/bookie/Bookie.java,536,8,8.0,8,4,4.0,4,12,12.0,12,4,4.0,4,1,0,1,YES
9,src/contrib/bookkeeper/src/java/org/apache/bookkeeper/bookie/BookieException.java,81,0,0.0,0,0,0.0,0,0,0.0,0,0,0.0,0,0,0,0,NO
9,src/contrib/bookkeeper/src/java/org/apache/bookkeeper/bookie/BufferedChannel.java,168,11,11.0,11,0,0.0,0,11,11.0,11,11,11.0,11,1,0,1,NO
9,src/contrib/bookkeeper/src/java/org/apache/bookkeeper/bookie/EntryLogger.java,487,237,237.0,237,14,14.0,14,251,251.0,251,223,223.0,223,1,0,1,NO
9,src/contrib/bookkeeper/src/java/org/apache/bookkeeper/bookie/FileInfo.java,124,11,11.0,11,0,0.0,0,11,11.0,11,11,11.0,11,1,0,1,NO
9,src/contrib/bookkeeper/src/java/org/apache/bookkeeper/bookie/LedgerCache.java,536,82,82.0,82,0,0.0,0,82,82.0,82,82,82.0,82,1,0,1,NO
9,src/contrib/bookkeeper/src/java/org/apache/bookkeeper/bookie/LedgerDescriptor.java,133,0,0.0,0,0,0.0,0,0,0.0,0,0,0.0,0,0,0,0,NO
9,src/contrib/bookkeeper/src/java/org/apache/bookkeeper/bookie/LedgerEntryPage.java,151,0,0.0,0,0,0.0,0,0,0.0,0,0,0.0,0,0,0,0,NO
9,src/contrib/bookkeeper/src/java/org/apache/bookkeeper/bookie/MarkerFileChannel.java,147,0,0.0,0,0,0.0,0,0,0.0,0,0,0.0,0,0,0,0,NO
9,src/contrib/bookkeeper/src/java/org/apache/bookkeeper/client/AsyncCallback.java,114,13,13.0,13,0,0.0,0,13,13.0,13,13,13.0,13,1,0,1,NO
9,src/contrib/bookkeeper/src/java/org/apache/bookkeeper/client/BKException.java,227,0,0.0,0,0,0.0,0,0,0.0,0,0,0.0,0,0,0,0,NO
9,src/contrib/bookkeeper/src/java/org/apache/bookkeeper/client/BookKeeper.java,401,57,57.0,57,8,8.0,8,65,65.0,65,49,49.0,49,1,0,1,NO
9,src/contrib/bookkeeper/src/java/org/apache/bookkeeper/client/BookieWatcher.java,204,0,0.0,0,0,0.0,0,0,0.0,0,0,0.0,0,0,0,0,NO
9,src/contrib/bookkeeper/src/java/org/apache/bookkeeper/client/CRC32DigestManager.java,50,0,0.0,0,0,0.0,0,0,0.0,0,0,0.0,0,0,0,0,NO
9,src/contrib/bookkeeper/src/java/org/apache/bookkeeper/client/DigestManager.java,162,0,0.0,0,0,0.0,0,0,0.0,0,0,0.0,0,0,0,0,NO
9,src/contrib/bookkeeper/src/java/org/apache/bookkeeper/client/DistributionSchedule.java,61,0,0.0,0,0,0.0,0,0,0.0,0,0,0.0,0,0,0,0,NO
9,src/contrib/bookkeeper/src/java/org/apache/bookkeeper/client/LedgerCreateOp.java,163,0,0.0,0,0,0.0,0,0,0.0,0,0,0.0,0,0,0,0,NO
9,src/contrib/bookkeeper/src/java/org/apache/bookkeeper/client/LedgerDeleteOp.java,80,80,80.0,80,0,0.0,0,80,80.0,80,80,80.0,80,1,0,1,NO
9,src/contrib/bookkeeper/src/java/org/apache/bookkeeper/client/LedgerEntry.java,78,0,0.0,0,0,0.0,0,0,0.0,0,0,0.0,0,0,0,0,NO
9,src/contrib/bookkeeper/src/java/org/apache/bookkeeper/client/LedgerHandle.java,448,0,0.0,0,0,0.0,0,0,0.0,0,0,0.0,0,0,0,0,YES
9,src/contrib/bookkeeper/src/java/org/apache/bookkeeper/client/LedgerMetadata.java,179,0,0.0,0,0,0.0,0,0,0.0,0,0,0.0,0,0,0,0,NO
9,src/contrib/bookkeeper/src/java/org/apache/bookkeeper/client/LedgerOpenOp.java,136,0,0.0,0,0,0.0,0,0,0.0,0,0,0.0,0,0,0,0,NO
9,src/contrib/bookkeeper/src/java/org/apache/bookkeeper/client/LedgerRecoveryOp.java,167,0,0.0,0,0,0.0,0,0,0.0,0,0,0.0,0,0,0,0,NO
9,src/contrib/bookkeeper/src/java/org/apache/bookkeeper/client/MacDigestManager.java,67,0,0.0,0,0,0.0,0,0,0.0,0,0,0.0,0,0,0,0,NO
9,src/contrib/bookkeeper/src/java/org/apache/bookkeeper/client/PendingAddOp.java,137,0,0.0,0,0,0.0,0,0,0.0,0,0,0.0,0,0,0,0,NO
9,src/contrib/bookkeeper/src/java/org/apache/bookkeeper/client/PendingReadOp.java,145,0,0.0,0,0,0.0,0,0,0.0,0,0,0.0,0,0,0,0,YES
9,src/contrib/bookkeeper/src/java/org/apache/bookkeeper/client/RoundRobinDistributionSchedule.java,87,0,0.0,0,0,0.0,0,0,0.0,0,0,0.0,0,0,0,0,NO
9,src/contrib/bookkeeper/src/java/org/apache/bookkeeper/client/SyncCounter.java,85,0,0.0,0,0,0.0,0,0,0.0,0,0,0.0,0,0,0,0,NO
9,src/contrib/bookkeeper/src/java/org/apache/bookkeeper/proto/BookieClient.java,178,0,0.0,0,0,0.0,0,0,0.0,0,0,0.0,0,0,0,0,NO
9,src/contrib/bookkeeper/src/java/org/apache/bookkeeper/proto/BookieProtocol.java,75,0,0.0,0,0,0.0,0,0,0.0,0,0,0.0,0,0,0,0,NO
9,src/contrib/bookkeeper/src/java/org/apache/bookkeeper/proto/BookieServer.java,208,0,0.0,0,0,0.0,0,0,0.0,0,0,0.0,0,0,0,0,YES
9,src/contrib/bookkeeper/src/java/org/apache/bookkeeper/proto/BookkeeperInternalCallbacks.java,57,0,0.0,0,0,0.0,0,0,0.0,0,0,0.0,0,0,0,0,NO
9,src/contrib/bookkeeper/src/java/org/apache/bookkeeper/proto/NIOServerFactory.java,517,0,0.0,0,0,0.0,0,0,0.0,0,0,0.0,0,0,0,0,YES
9,src/contrib/bookkeeper/src/java/org/apache/bookkeeper/proto/PerChannelBookieClient.java,570,0,0.0,0,0,0.0,0,0,0.0,0,0,0.0,0,0,0,0,NO
9,src/contrib/bookkeeper/src/java/org/apache/bookkeeper/proto/ServerStats.java,148,0,0.0,0,0,0.0,0,0,0.0,0,0,0.0,0,0,0,0,NO
9,src/contrib/bookkeeper/src/java/org/apache/bookkeeper/streaming/LedgerInputStream.java,173,0,0.0,0,0,0.0,0,0,0.0,0,0,0.0,0,0,0,0,NO
9,src/contrib/bookkeeper/src/java/org/apache/bookkeeper/streaming/LedgerOutputStream.java,147,0,0.0,0,0,0.0,0,0,0.0,0,0,0.0,0,0,0,0,NO
9,src/contrib/bookkeeper/src/java/org/apache/bookkeeper/util/LocalBookKeeper.java,208,0,0.0,0,0,0.0,0,0,0.0,0,0,0.0,0,0,0,0,YES
9,src/contrib/bookkeeper/src/java/org/apache/bookkeeper/util/Main.java,54,0,0.0,0,0,0.0,0,0,0.0,0,0,0.0,0,0,0,0,NO
9,src/contrib/bookkeeper/src/java/org/apache/bookkeeper/util/MathUtils.java,38,0,0.0,0,0,0.0,0,0,0.0,0,0,0.0,0,0,0,0,NO
9,src/contrib/bookkeeper/src/java/org/apache/bookkeeper/util/OrderedSafeExecutor.java,98,0,0.0,0,0,0.0,0,0,0.0,0,0,0.0,0,0,0,0,NO
9,src/contrib/bookkeeper/src/java/org/apache/bookkeeper/util/SafeRunnable.java,38,0,0.0,0,0,0.0,0,0,0.0,0,0,0.0,0,0,0,0,NO
9,src/contrib/bookkeeper/src/java/org/apache/bookkeeper/util/StringUtils.java,94,0,0.0,0,0,0.0,0,0,0.0,0,0,0.0,0,0,0,0,NO
9,src/contrib/fatjar/src/java/org/apache/zookeeper/util/FatJarMain.java,126,0,0.0,0,0,0.0,0,0,0.0,0,0,0.0,0,0,0,0,NO
9,src/contrib/rest/src/java/org/apache/zookeeper/server/jersey/RestMain.java,78,0,0.0,0,0,0.0,0,0,0.0,0,0,0.0,0,0,0,0,NO
9,src/contrib/rest/src/java/org/apache/zookeeper/server/jersey/ZooKeeperService.java,110,0,0.0,0,0,0.0,0,0,0.0,0,0,0.0,0,0,0,0,NO
9,src/contrib/rest/src/java/org/apache/zookeeper/server/jersey/jaxb/ZChildren.java,80,0,0.0,0,0,0.0,0,0,0.0,0,0,0.0,0,0,0,0,NO
9,src/contrib/rest/src/java/org/apache/zookeeper/server/jersey/jaxb/ZChildrenJSON.java,76,0,0.0,0,0,0.0,0,0,0.0,0,0,0.0,0,0,0,0,NO
9,src/contrib/rest/src/java/org/apache/zookeeper/server/jersey/jaxb/ZError.java,41,0,0.0,0,0,0.0,0,0,0.0,0,0,0.0,0,0,0,0,NO
9,src/contrib/rest/src/java/org/apache/zookeeper/server/jersey/jaxb/ZPath.java,63,0,0.0,0,0,0.0,0,0,0.0,0,0,0.0,0,0,0,0,NO
9,src/contrib/rest/src/java/org/apache/zookeeper/server/jersey/jaxb/ZStat.java,106,0,0.0,0,0,0.0,0,0,0.0,0,0,0.0,0,0,0,0,NO
9,src/contrib/rest/src/java/org/apache/zookeeper/server/jersey/resources/JAXBContextResolver.java,72,0,0.0,0,0,0.0,0,0,0.0,0,0,0.0,0,0,0,0,NO
9,src/contrib/rest/src/java/org/apache/zookeeper/server/jersey/resources/KeeperExceptionMapper.java,86,0,0.0,0,0,0.0,0,0,0.0,0,0,0.0,0,0,0,0,NO
9,src/contrib/rest/src/java/org/apache/zookeeper/server/jersey/resources/RuntimeExceptionMapper.java,55,8,8.0,8,1,1.0,1,9,9.0,9,7,7.0,7,1,1,1,NO
9,src/contrib/rest/src/java/org/apache/zookeeper/server/jersey/resources/ZErrorWriter.java,63,0,0.0,0,0,0.0,0,0,0.0,0,0,0.0,0,0,0,0,NO
9,src/contrib/rest/src/java/org/apache/zookeeper/server/jersey/resources/ZNodeResource.java,409,45,45.0,45,11,11.0,11,56,56.0,56,34,34.0,34,1,1,1,NO
9,src/contrib/zooinspector/src/java/org/apache/zookeeper/inspector/ZooInspector.java,66,0,0.0,0,0,0.0,0,0,0.0,0,0,0.0,0,0,0,0,NO
9,src/contrib/zooinspector/src/java/org/apache/zookeeper/inspector/encryption/BasicDataEncryptionManager.java,50,0,0.0,0,0,0.0,0,0,0.0,0,0,0.0,0,0,0,0,NO
9,src/contrib/zooinspector/src/java/org/apache/zookeeper/inspector/encryption/DataEncryptionManager.java,39,0,0.0,0,0,0.0,0,0,0.0,0,0,0.0,0,0,0,0,NO
9,src/contrib/zooinspector/src/java/org/apache/zookeeper/inspector/gui/NodeViewersChangeListener.java,37,0,0.0,0,0,0.0,0,0,0.0,0,0,0.0,0,0,0,0,NO
9,src/contrib/zooinspector/src/java/org/apache/zookeeper/inspector/gui/ZooInspectorAboutDialog.java,80,0,0.0,0,0,0.0,0,0,0.0,0,0,0.0,0,0,0,0,NO
9,src/contrib/zooinspector/src/java/org/apache/zookeeper/inspector/gui/ZooInspectorConnectionPropertiesDialog.java,321,0,0.0,0,0,0.0,0,0,0.0,0,0,0.0,0,0,0,0,NO
9,src/contrib/zooinspector/src/java/org/apache/zookeeper/inspector/gui/ZooInspectorIconResources.java,118,0,0.0,0,0,0.0,0,0,0.0,0,0,0.0,0,0,0,0,NO
9,src/contrib/zooinspector/src/java/org/apache/zookeeper/inspector/gui/ZooInspectorNodeViewersDialog.java,605,0,0.0,0,0,0.0,0,0,0.0,0,0,0.0,0,0,0,0,NO
9,src/contrib/zooinspector/src/java/org/apache/zookeeper/inspector/gui/ZooInspectorNodeViewersPanel.java,140,0,0.0,0,0,0.0,0,0,0.0,0,0,0.0,0,0,0,0,NO
9,src/contrib/zooinspector/src/java/org/apache/zookeeper/inspector/gui/ZooInspectorPanel.java,361,0,0.0,0,0,0.0,0,0,0.0,0,0,0.0,0,0,0,0,NO
9,src/contrib/zooinspector/src/java/org/apache/zookeeper/inspector/gui/ZooInspectorTreeViewer.java,362,0,0.0,0,0,0.0,0,0,0.0,0,0,0.0,0,0,0,0,NO
9,src/contrib/zooinspector/src/java/org/apache/zookeeper/inspector/gui/nodeviewer/NodeViewerACL.java,187,0,0.0,0,0,0.0,0,0,0.0,0,0,0.0,0,0,0,0,NO
9,src/contrib/zooinspector/src/java/org/apache/zookeeper/inspector/gui/nodeviewer/NodeViewerData.java,146,0,0.0,0,0,0.0,0,0,0.0,0,0,0.0,0,0,0,0,NO
9,src/contrib/zooinspector/src/java/org/apache/zookeeper/inspector/gui/nodeviewer/NodeViewerMetaData.java,186,0,0.0,0,0,0.0,0,0,0.0,0,0,0.0,0,0,0,0,NO
9,src/contrib/zooinspector/src/java/org/apache/zookeeper/inspector/gui/nodeviewer/ZooInspectorNodeViewer.java,138,0,0.0,0,0,0.0,0,0,0.0,0,0,0.0,0,0,0,0,NO
9,src/contrib/zooinspector/src/java/org/apache/zookeeper/inspector/logger/LoggerFactory.java,38,0,0.0,0,0,0.0,0,0,0.0,0,0,0.0,0,0,0,0,NO
9,src/contrib/zooinspector/src/java/org/apache/zookeeper/inspector/manager/NodeListener.java,37,0,0.0,0,0,0.0,0,0,0.0,0,0,0.0,0,0,0,0,NO
9,src/contrib/zooinspector/src/java/org/apache/zookeeper/inspector/manager/Pair.java,120,0,0.0,0,0,0.0,0,0,0.0,0,0,0.0,0,0,0,0,NO
9,src/contrib/zooinspector/src/java/org/apache/zookeeper/inspector/manager/ZooInspectorManager.java,139,0,0.0,0,0,0.0,0,0,0.0,0,0,0.0,0,0,0,0,NO
9,src/contrib/zooinspector/src/java/org/apache/zookeeper/inspector/manager/ZooInspectorManagerImpl.java,852,0,0.0,0,0,0.0,0,0,0.0,0,0,0.0,0,0,0,0,NO
9,src/contrib/zooinspector/src/java/org/apache/zookeeper/inspector/manager/ZooInspectorNodeManager.java,33,0,0.0,0,0,0.0,0,0,0.0,0,0,0.0,0,0,0,0,NO
9,src/contrib/zooinspector/src/java/org/apache/zookeeper/inspector/manager/ZooInspectorNodeTreeManager.java,43,0,0.0,0,0,0.0,0,0,0.0,0,0,0.0,0,0,0,0,NO
9,src/contrib/zooinspector/src/java/org/apache/zookeeper/inspector/manager/ZooInspectorReadOnlyManager.java,99,0,0.0,0,0,0.0,0,0,0.0,0,0,0.0,0,0,0,0,NO
9,src/contrib/zooinspector/src/java/org/apache/zookeeper/retry/ZooKeeperRetry.java,288,0,0.0,0,0,0.0,0,0,0.0,0,0,0.0,0,0,0,0,NO
9,src/java/main/org/apache/jute/BinaryInputArchive.java,131,0,0.0,0,0,0.0,0,0,0.0,0,0,0.0,0,0,0,0,NO
9,src/java/main/org/apache/jute/BinaryOutputArchive.java,146,0,0.0,0,0,0.0,0,0,0.0,0,0,0.0,0,0,0,0,NO
9,src/java/main/org/apache/jute/CsvInputArchive.java,208,0,0.0,0,0,0.0,0,0,0.0,0,0,0.0,0,0,0,0,NO
9,src/java/main/org/apache/jute/CsvOutputArchive.java,150,0,0.0,0,0,0.0,0,0,0.0,0,0,0.0,0,0,0,0,NO
9,src/java/main/org/apache/jute/Index.java,38,0,0.0,0,0,0.0,0,0,0.0,0,0,0.0,0,0,0,0,NO
9,src/java/main/org/apache/jute/InputArchive.java,43,0,0.0,0,0,0.0,0,0,0.0,0,0,0.0,0,0,0,0,NO
9,src/java/main/org/apache/jute/OutputArchive.java,47,0,0.0,0,0,0.0,0,0,0.0,0,0,0.0,0,0,0,0,NO
9,src/java/main/org/apache/jute/Record.java,32,0,0.0,0,0,0.0,0,0,0.0,0,0,0.0,0,0,0,0,NO
9,src/java/main/org/apache/jute/RecordReader.java,93,0,0.0,0,0,0.0,0,0,0.0,0,0,0.0,0,0,0,0,NO
9,src/java/main/org/apache/jute/RecordWriter.java,113,0,0.0,0,0,0.0,0,0,0.0,0,0,0.0,0,0,0,0,NO
9,src/java/main/org/apache/jute/Utils.java,282,0,0.0,0,0,0.0,0,0,0.0,0,0,0.0,0,0,0,0,NO
9,src/java/main/org/apache/jute/XmlInputArchive.java,251,0,0.0,0,0,0.0,0,0,0.0,0,0,0.0,0,0,0,0,NO
9,src/java/main/org/apache/jute/XmlOutputArchive.java,251,0,0.0,0,0,0.0,0,0,0.0,0,0,0.0,0,0,0,0,NO
9,src/java/main/org/apache/jute/compiler/CGenerator.java,130,0,0.0,0,0,0.0,0,0,0.0,0,0,0.0,0,0,0,0,NO
9,src/java/main/org/apache/jute/compiler/CSharpGenerator.java,53,53,53.0,53,0,0.0,0,53,53.0,53,53,53.0,53,1,0,1,NO
9,src/java/main/org/apache/jute/compiler/CppGenerator.java,125,0,0.0,0,0,0.0,0,0,0.0,0,0,0.0,0,0,0,0,NO
9,src/java/main/org/apache/jute/compiler/JBoolean.java,50,9,9.0,9,1,1.0,1,10,10.0,10,8,8.0,8,1,0,1,NO
9,src/java/main/org/apache/jute/compiler/JBuffer.java,106,1,1.0,1,1,1.0,1,2,2.0,2,0,0.0,0,1,0,1,NO
9,src/java/main/org/apache/jute/compiler/JByte.java,34,1,1.0,1,1,1.0,1,2,2.0,2,0,0.0,0,1,0,1,NO
9,src/java/main/org/apache/jute/compiler/JCompType.java,66,15,15.0,15,2,2.0,2,17,17.0,17,13,13.0,13,1,0,1,NO
9,src/java/main/org/apache/jute/compiler/JDouble.java,40,1,1.0,1,1,1.0,1,2,2.0,2,0,0.0,0,1,0,1,NO
9,src/java/main/org/apache/jute/compiler/JField.java,140,42,42.0,42,0,0.0,0,42,42.0,42,42,42.0,42,1,0,1,NO
9,src/java/main/org/apache/jute/compiler/JFile.java,84,4,4.0,4,0,0.0,0,4,4.0,4,4,4.0,4,1,0,1,NO
9,src/java/main/org/apache/jute/compiler/JFloat.java,39,1,1.0,1,1,1.0,1,2,2.0,2,0,0.0,0,1,0,1,NO
9,src/java/main/org/apache/jute/compiler/JInt.java,34,1,1.0,1,1,1.0,1,2,2.0,2,0,0.0,0,1,0,1,NO
9,src/java/main/org/apache/jute/compiler/JLong.java,38,1,1.0,1,1,1.0,1,2,2.0,2,0,0.0,0,1,0,1,NO
9,src/java/main/org/apache/jute/compiler/JMap.java,149,49,49.0,49,3,3.0,3,52,52.0,52,46,46.0,46,1,0,1,NO
9,src/java/main/org/apache/jute/compiler/JRecord.java,762,228,114.0,228,2,1.0,2,230,115.0,230,226,113.0,226,2,1,1,NO
9,src/java/main/org/apache/jute/compiler/JString.java,46,1,1.0,1,1,1.0,1,2,2.0,2,0,0.0,0,1,0,1,NO
9,src/java/main/org/apache/jute/compiler/JType.java,204,66,66.0,66,3,3.0,3,69,69.0,69,63,63.0,63,1,0,1,NO
9,src/java/main/org/apache/jute/compiler/JVector.java,153,49,49.0,49,2,2.0,2,51,51.0,51,47,47.0,47,1,0,1,NO
9,src/java/main/org/apache/jute/compiler/JavaGenerator.java,57,0,0.0,0,0,0.0,0,0,0.0,0,0,0.0,0,0,0,0,NO
9,src/java/main/org/apache/jute/compiler/generated/ParseException.java,210,0,0.0,0,0,0.0,0,0,0.0,0,0,0.0,0,0,0,0,NO
9,src/java/main/org/apache/jute/compiler/generated/Rcc.java,525,0,0.0,0,0,0.0,0,0,0.0,0,0,0.0,0,0,0,0,NO
9,src/java/main/org/apache/jute/compiler/generated/RccConstants.java,88,0,0.0,0,0,0.0,0,0,0.0,0,0,0.0,0,0,0,0,NO
9,src/java/main/org/apache/jute/compiler/generated/RccTokenManager.java,833,0,0.0,0,0,0.0,0,0,0.0,0,0,0.0,0,0,0,0,NO
9,src/java/main/org/apache/jute/compiler/generated/SimpleCharStream.java,457,0,0.0,0,0,0.0,0,0,0.0,0,0,0.0,0,0,0,0,NO
9,src/java/main/org/apache/jute/compiler/generated/Token.java,99,0,0.0,0,0,0.0,0,0,0.0,0,0,0.0,0,0,0,0,NO
9,src/java/main/org/apache/jute/compiler/generated/TokenMgrError.java,151,0,0.0,0,0,0.0,0,0,0.0,0,0,0.0,0,0,0,0,NO
9,src/java/main/org/apache/zookeeper/AsyncCallback.java,57,0,0.0,0,0,0.0,0,0,0.0,0,0,0.0,0,0,0,0,NO
9,src/java/main/org/apache/zookeeper/ClientCnxn.java,1320,0,0.0,0,0,0.0,0,0,0.0,0,0,0.0,0,0,0,0,YES
9,src/java/main/org/apache/zookeeper/ClientWatchManager.java,39,0,0.0,0,0,0.0,0,0,0.0,0,0,0.0,0,0,0,0,NO
9,src/java/main/org/apache/zookeeper/CreateMode.java,89,0,0.0,0,0,0.0,0,0,0.0,0,0,0.0,0,0,0,0,NO
9,src/java/main/org/apache/zookeeper/Environment.java,100,0,0.0,0,0,0.0,0,0,0.0,0,0,0.0,0,0,0,0,NO
9,src/java/main/org/apache/zookeeper/JLineZNodeCompletor.java,84,0,0.0,0,0,0.0,0,0,0.0,0,0,0.0,0,0,0,0,NO
9,src/java/main/org/apache/zookeeper/KeeperException.java,662,0,0.0,0,0,0.0,0,0,0.0,0,0,0.0,0,0,0,0,NO
9,src/java/main/org/apache/zookeeper/Quotas.java,68,0,0.0,0,0,0.0,0,0,0.0,0,0,0.0,0,0,0,0,NO
9,src/java/main/org/apache/zookeeper/ServerAdminClient.java,312,0,0.0,0,0,0.0,0,0,0.0,0,0,0.0,0,0,0,0,NO
9,src/java/main/org/apache/zookeeper/StatsTrack.java,101,0,0.0,0,0,0.0,0,0,0.0,0,0,0.0,0,0,0,0,NO
9,src/java/main/org/apache/zookeeper/Version.java,78,0,0.0,0,0,0.0,0,0,0.0,0,0,0.0,0,0,0,0,YES
9,src/java/main/org/apache/zookeeper/WatchedEvent.java,79,0,0.0,0,0,0.0,0,0,0.0,0,0,0.0,0,0,0,0,NO
9,src/java/main/org/apache/zookeeper/Watcher.java,125,0,0.0,0,0,0.0,0,0,0.0,0,0,0.0,0,0,0,0,YES
9,src/java/main/org/apache/zookeeper/ZooDefs.java,113,0,0.0,0,0,0.0,0,0,0.0,0,0,0.0,0,0,0,0,NO
9,src/java/main/org/apache/zookeeper/ZooKeeper.java,1635,89,89.0,89,0,0.0,0,89,89.0,89,89,89.0,89,1,0,1,YES
9,src/java/main/org/apache/zookeeper/ZooKeeperMain.java,837,4,4.0,4,0,0.0,0,4,4.0,4,4,4.0,4,1,0,1,YES
9,src/java/main/org/apache/zookeeper/common/PathTrie.java,283,0,0.0,0,0,0.0,0,0,0.0,0,0,0.0,0,0,0,0,NO
9,src/java/main/org/apache/zookeeper/common/PathUtils.java,103,0,0.0,0,0,0.0,0,0,0.0,0,0,0.0,0,0,0,0,NO
9,src/java/main/org/apache/zookeeper/jmx/CommonNames.java,29,0,0.0,0,0,0.0,0,0,0.0,0,0,0.0,0,0,0,0,NO
9,src/java/main/org/apache/zookeeper/jmx/MBeanRegistry.java,194,0,0.0,0,0,0.0,0,0,0.0,0,0,0.0,0,0,0,0,NO
9,src/java/main/org/apache/zookeeper/jmx/ManagedUtil.java,72,0,0.0,0,0,0.0,0,0,0.0,0,0,0.0,0,0,0,0,NO
9,src/java/main/org/apache/zookeeper/jmx/ZKMBeanInfo.java,36,0,0.0,0,0,0.0,0,0,0.0,0,0,0.0,0,0,0,0,NO
9,src/java/main/org/apache/zookeeper/server/ByteBufferInputStream.java,72,0,0.0,0,0,0.0,0,0,0.0,0,0,0.0,0,0,0,0,NO
9,src/java/main/org/apache/zookeeper/server/ConnectionBean.java,173,0,0.0,0,0,0.0,0,0,0.0,0,0,0.0,0,0,0,0,NO
9,src/java/main/org/apache/zookeeper/server/ConnectionMXBean.java,98,0,0.0,0,0,0.0,0,0,0.0,0,0,0.0,0,0,0,0,NO
9,src/java/main/org/apache/zookeeper/server/DataNode.java,170,0,0.0,0,0,0.0,0,0,0.0,0,0,0.0,0,0,0,0,NO
9,src/java/main/org/apache/zookeeper/server/DataTree.java,1185,0,0.0,0,0,0.0,0,0,0.0,0,0,0.0,0,0,0,0,NO
9,src/java/main/org/apache/zookeeper/server/DataTreeBean.java,70,0,0.0,0,0,0.0,0,0,0.0,0,0,0.0,0,0,0,0,NO
9,src/java/main/org/apache/zookeeper/server/DataTreeMXBean.java,47,0,0.0,0,0,0.0,0,0,0.0,0,0,0.0,0,0,0,0,NO
9,src/java/main/org/apache/zookeeper/server/FinalRequestProcessor.java,381,0,0.0,0,0,0.0,0,0,0.0,0,0,0.0,0,0,0,0,NO
9,src/java/main/org/apache/zookeeper/server/LogFormatter.java,107,0,0.0,0,0,0.0,0,0,0.0,0,0,0.0,0,0,0,0,NO
9,src/java/main/org/apache/zookeeper/server/NIOServerCnxn.java,1817,369,369.0,369,220,220.0,220,589,589.0,589,149,149.0,149,1,1,1,YES
9,src/java/main/org/apache/zookeeper/server/ObserverBean.java,45,0,0.0,0,0,0.0,0,0,0.0,0,0,0.0,0,0,0,0,NO
9,src/java/main/org/apache/zookeeper/server/PrepRequestProcessor.java,512,0,0.0,0,0,0.0,0,0,0.0,0,0,0.0,0,0,0,0,NO
9,src/java/main/org/apache/zookeeper/server/PurgeTxnLog.java,132,0,0.0,0,0,0.0,0,0,0.0,0,0,0.0,0,0,0,0,NO
9,src/java/main/org/apache/zookeeper/server/Request.java,232,0,0.0,0,0,0.0,0,0,0.0,0,0,0.0,0,0,0,0,NO
9,src/java/main/org/apache/zookeeper/server/RequestProcessor.java,37,0,0.0,0,0,0.0,0,0,0.0,0,0,0.0,0,0,0,0,NO
9,src/java/main/org/apache/zookeeper/server/ServerCnxn.java,108,0,0.0,0,0,0.0,0,0,0.0,0,0,0.0,0,0,0,0,NO
9,src/java/main/org/apache/zookeeper/server/ServerConfig.java,111,0,0.0,0,0,0.0,0,0,0.0,0,0,0.0,0,0,0,0,NO
9,src/java/main/org/apache/zookeeper/server/ServerStats.java,132,0,0.0,0,0,0.0,0,0,0.0,0,0,0.0,0,0,0,0,NO
9,src/java/main/org/apache/zookeeper/server/SessionTracker.java,74,0,0.0,0,0,0.0,0,0,0.0,0,0,0.0,0,0,0,0,NO
9,src/java/main/org/apache/zookeeper/server/SessionTrackerImpl.java,257,0,0.0,0,0,0.0,0,0,0.0,0,0,0.0,0,0,0,0,NO
9,src/java/main/org/apache/zookeeper/server/SyncRequestProcessor.java,183,0,0.0,0,0,0.0,0,0,0.0,0,0,0.0,0,0,0,0,YES
9,src/java/main/org/apache/zookeeper/server/TraceFormatter.java,121,0,0.0,0,0,0.0,0,0,0.0,0,0,0.0,0,0,0,0,NO
9,src/java/main/org/apache/zookeeper/server/WatchManager.java,166,0,0.0,0,0,0.0,0,0,0.0,0,0,0.0,0,0,0,0,NO
9,src/java/main/org/apache/zookeeper/server/ZKDatabase.java,461,0,0.0,0,0,0.0,0,0,0.0,0,0,0.0,0,0,0,0,NO
9,src/java/main/org/apache/zookeeper/server/ZooKeeperServer.java,702,0,0.0,0,0,0.0,0,0,0.0,0,0,0.0,0,0,0,0,YES
9,src/java/main/org/apache/zookeeper/server/ZooKeeperServerBean.java,143,0,0.0,0,0,0.0,0,0,0.0,0,0,0.0,0,0,0,0,NO
9,src/java/main/org/apache/zookeeper/server/ZooKeeperServerMXBean.java,106,0,0.0,0,0,0.0,0,0,0.0,0,0,0.0,0,0,0,0,NO
9,src/java/main/org/apache/zookeeper/server/ZooKeeperServerMain.java,127,0,0.0,0,0,0.0,0,0,0.0,0,0,0.0,0,0,0,0,NO
9,src/java/main/org/apache/zookeeper/server/ZooTrace.java,92,0,0.0,0,0,0.0,0,0,0.0,0,0,0.0,0,0,0,0,NO
9,src/java/main/org/apache/zookeeper/server/auth/AuthenticationProvider.java,82,0,0.0,0,0,0.0,0,0,0.0,0,0,0.0,0,0,0,0,NO
9,src/java/main/org/apache/zookeeper/server/auth/DigestAuthenticationProvider.java,138,0,0.0,0,0,0.0,0,0,0.0,0,0,0.0,0,0,0,0,NO
9,src/java/main/org/apache/zookeeper/server/auth/IPAuthenticationProvider.java,117,0,0.0,0,0,0.0,0,0,0.0,0,0,0.0,0,0,0,0,NO
9,src/java/main/org/apache/zookeeper/server/auth/ProviderRegistry.java,76,0,0.0,0,0,0.0,0,0,0.0,0,0,0.0,0,0,0,0,NO
9,src/java/main/org/apache/zookeeper/server/persistence/FileSnap.java,249,0,0.0,0,0,0.0,0,0,0.0,0,0,0.0,0,0,0,0,NO
9,src/java/main/org/apache/zookeeper/server/persistence/FileTxnLog.java,604,0,0.0,0,0,0.0,0,0,0.0,0,0,0.0,0,0,0,0,YES
9,src/java/main/org/apache/zookeeper/server/persistence/FileTxnSnapLog.java,296,0,0.0,0,0,0.0,0,0,0.0,0,0,0.0,0,0,0,0,YES
9,src/java/main/org/apache/zookeeper/server/persistence/SnapShot.java,66,0,0.0,0,0,0.0,0,0,0.0,0,0,0.0,0,0,0,0,NO
9,src/java/main/org/apache/zookeeper/server/persistence/TxnLog.java,120,0,0.0,0,0,0.0,0,0,0.0,0,0,0.0,0,0,0,0,NO
9,src/java/main/org/apache/zookeeper/server/persistence/Util.java,325,0,0.0,0,0,0.0,0,0,0.0,0,0,0.0,0,0,0,0,NO
9,src/java/main/org/apache/zookeeper/server/quorum/AckRequestProcessor.java,53,0,0.0,0,0,0.0,0,0,0.0,0,0,0.0,0,0,0,0,NO
9,src/java/main/org/apache/zookeeper/server/quorum/AuthFastLeaderElection.java,968,0,0.0,0,0,0.0,0,0,0.0,0,0,0.0,0,0,0,0,NO
9,src/java/main/org/apache/zookeeper/server/quorum/CommitProcessor.java,189,0,0.0,0,0,0.0,0,0,0.0,0,0,0.0,0,0,0,0,NO
9,src/java/main/org/apache/zookeeper/server/quorum/Election.java,27,0,0.0,0,0,0.0,0,0,0.0,0,0,0.0,0,0,0,0,NO
9,src/java/main/org/apache/zookeeper/server/quorum/FastLeaderElection.java,837,3,3.0,3,3,3.0,3,6,6.0,6,0,0.0,0,1,1,1,YES
9,src/java/main/org/apache/zookeeper/server/quorum/Follower.java,169,0,0.0,0,0,0.0,0,0,0.0,0,0,0.0,0,0,0,0,YES
9,src/java/main/org/apache/zookeeper/server/quorum/FollowerBean.java,50,0,0.0,0,0,0.0,0,0,0.0,0,0,0.0,0,0,0,0,NO
9,src/java/main/org/apache/zookeeper/server/quorum/FollowerMXBean.java,41,0,0.0,0,0,0.0,0,0,0.0,0,0,0.0,0,0,0,0,NO
9,src/java/main/org/apache/zookeeper/server/quorum/FollowerRequestProcessor.java,109,0,0.0,0,0,0.0,0,0,0.0,0,0,0.0,0,0,0,0,NO
9,src/java/main/org/apache/zookeeper/server/quorum/FollowerZooKeeperServer.java,162,0,0.0,0,0,0.0,0,0,0.0,0,0,0.0,0,0,0,0,NO
9,src/java/main/org/apache/zookeeper/server/quorum/Leader.java,718,0,0.0,0,0,0.0,0,0,0.0,0,0,0.0,0,0,0,0,YES
9,src/java/main/org/apache/zookeeper/server/quorum/LeaderBean.java,53,0,0.0,0,0,0.0,0,0,0.0,0,0,0.0,0,0,0,0,NO
9,src/java/main/org/apache/zookeeper/server/quorum/LeaderElection.java,274,2,2.0,2,2,2.0,2,4,4.0,4,0,0.0,0,1,1,1,NO
9,src/java/main/org/apache/zookeeper/server/quorum/LeaderElectionBean.java,42,0,0.0,0,0,0.0,0,0,0.0,0,0,0.0,0,0,0,0,NO
9,src/java/main/org/apache/zookeeper/server/quorum/LeaderElectionMXBean.java,31,0,0.0,0,0,0.0,0,0,0.0,0,0,0.0,0,0,0,0,NO
9,src/java/main/org/apache/zookeeper/server/quorum/LeaderMXBean.java,36,0,0.0,0,0,0.0,0,0,0.0,0,0,0.0,0,0,0,0,NO
9,src/java/main/org/apache/zookeeper/server/quorum/LeaderZooKeeperServer.java,176,0,0.0,0,0,0.0,0,0,0.0,0,0,0.0,0,0,0,0,NO
9,src/java/main/org/apache/zookeeper/server/quorum/Learner.java,375,1,1.0,1,1,1.0,1,2,2.0,2,0,0.0,0,1,1,1,YES
9,src/java/main/org/apache/zookeeper/server/quorum/LearnerHandler.java,506,0,0.0,0,0,0.0,0,0,0.0,0,0,0.0,0,0,0,0,YES
9,src/java/main/org/apache/zookeeper/server/quorum/LearnerSessionTracker.java,92,0,0.0,0,0,0.0,0,0,0.0,0,0,0.0,0,0,0,0,NO
9,src/java/main/org/apache/zookeeper/server/quorum/LearnerSyncRequest.java,34,0,0.0,0,0,0.0,0,0,0.0,0,0,0.0,0,0,0,0,NO
9,src/java/main/org/apache/zookeeper/server/quorum/LearnerZooKeeperServer.java,142,0,0.0,0,0,0.0,0,0,0.0,0,0,0.0,0,0,0,0,NO
9,src/java/main/org/apache/zookeeper/server/quorum/LocalPeerBean.java,85,0,0.0,0,0,0.0,0,0,0.0,0,0,0.0,0,0,0,0,NO
9,src/java/main/org/apache/zookeeper/server/quorum/LocalPeerMXBean.java,77,0,0.0,0,0,0.0,0,0,0.0,0,0,0.0,0,0,0,0,NO
9,src/java/main/org/apache/zookeeper/server/quorum/Observer.java,146,0,0.0,0,0,0.0,0,0,0.0,0,0,0.0,0,0,0,0,NO
9,src/java/main/org/apache/zookeeper/server/quorum/ObserverMXBean.java,37,0,0.0,0,0,0.0,0,0,0.0,0,0,0.0,0,0,0,0,NO
9,src/java/main/org/apache/zookeeper/server/quorum/ObserverRequestProcessor.java,123,0,0.0,0,0,0.0,0,0,0.0,0,0,0.0,0,0,0,0,NO
9,src/java/main/org/apache/zookeeper/server/quorum/ObserverZooKeeperServer.java,116,0,0.0,0,0,0.0,0,0,0.0,0,0,0.0,0,0,0,0,NO
9,src/java/main/org/apache/zookeeper/server/quorum/ProposalRequestProcessor.java,82,0,0.0,0,0,0.0,0,0,0.0,0,0,0.0,0,0,0,0,NO
9,src/java/main/org/apache/zookeeper/server/quorum/QuorumBean.java,44,0,0.0,0,0,0.0,0,0,0.0,0,0,0.0,0,0,0,0,NO
9,src/java/main/org/apache/zookeeper/server/quorum/QuorumCnxManager.java,668,0,0.0,0,0,0.0,0,0,0.0,0,0,0.0,0,0,0,0,YES
9,src/java/main/org/apache/zookeeper/server/quorum/QuorumMXBean.java,34,0,0.0,0,0,0.0,0,0,0.0,0,0,0.0,0,0,0,0,NO
9,src/java/main/org/apache/zookeeper/server/quorum/QuorumPeer.java,957,15,15.0,15,5,5.0,5,20,20.0,20,10,10.0,10,1,1,1,YES
9,src/java/main/org/apache/zookeeper/server/quorum/QuorumPeerConfig.java,344,0,0.0,0,0,0.0,0,0,0.0,0,0,0.0,0,0,0,0,YES
9,src/java/main/org/apache/zookeeper/server/quorum/QuorumPeerMain.java,150,1,1.0,1,1,1.0,1,2,2.0,2,0,0.0,0,1,1,1,NO
9,src/java/main/org/apache/zookeeper/server/quorum/QuorumStats.java,68,0,0.0,0,0,0.0,0,0,0.0,0,0,0.0,0,0,0,0,NO
9,src/java/main/org/apache/zookeeper/server/quorum/QuorumZooKeeperServer.java,62,1,1.0,1,1,1.0,1,2,2.0,2,0,0.0,0,1,1,1,NO
9,src/java/main/org/apache/zookeeper/server/quorum/RemotePeerBean.java,45,0,0.0,0,0,0.0,0,0,0.0,0,0,0.0,0,0,0,0,NO
9,src/java/main/org/apache/zookeeper/server/quorum/RemotePeerMXBean.java,33,0,0.0,0,0,0.0,0,0,0.0,0,0,0.0,0,0,0,0,NO
9,src/java/main/org/apache/zookeeper/server/quorum/SendAckRequestProcessor.java,79,0,0.0,0,0,0.0,0,0,0.0,0,0,0.0,0,0,0,0,NO
9,src/java/main/org/apache/zookeeper/server/quorum/ServerBean.java,38,0,0.0,0,0,0.0,0,0,0.0,0,0,0.0,0,0,0,0,NO
9,src/java/main/org/apache/zookeeper/server/quorum/ServerMXBean.java,33,0,0.0,0,0,0.0,0,0,0.0,0,0,0.0,0,0,0,0,NO
9,src/java/main/org/apache/zookeeper/server/quorum/Vote.java,69,0,0.0,0,0,0.0,0,0,0.0,0,0,0.0,0,0,0,0,YES
9,src/java/main/org/apache/zookeeper/server/quorum/flexible/QuorumHierarchical.java,272,0,0.0,0,0,0.0,0,0,0.0,0,0,0.0,0,0,0,0,NO
9,src/java/main/org/apache/zookeeper/server/quorum/flexible/QuorumMaj.java,57,0,0.0,0,0,0.0,0,0,0.0,0,0,0.0,0,0,0,0,NO
9,src/java/main/org/apache/zookeeper/server/quorum/flexible/QuorumVerifier.java,33,0,0.0,0,0,0.0,0,0,0.0,0,0,0.0,0,0,0,0,NO
9,src/java/main/org/apache/zookeeper/server/upgrade/DataNodeV1.java,129,0,0.0,0,0,0.0,0,0,0.0,0,0,0.0,0,0,0,0,NO
9,src/java/main/org/apache/zookeeper/server/upgrade/DataTreeV1.java,583,0,0.0,0,0,0.0,0,0,0.0,0,0,0.0,0,0,0,0,NO
9,src/java/main/org/apache/zookeeper/server/upgrade/UpgradeMain.java,180,0,0.0,0,0,0.0,0,0,0.0,0,0,0.0,0,0,0,0,NO
9,src/java/main/org/apache/zookeeper/server/upgrade/UpgradeSnapShot.java,33,0,0.0,0,0,0.0,0,0,0.0,0,0,0.0,0,0,0,0,NO
9,src/java/main/org/apache/zookeeper/server/upgrade/UpgradeSnapShotV1.java,333,0,0.0,0,0,0.0,0,0,0.0,0,0,0.0,0,0,0,0,NO
9,src/java/main/org/apache/zookeeper/server/util/Profiler.java,40,0,0.0,0,0,0.0,0,0,0.0,0,0,0.0,0,0,0,0,NO
9,src/java/main/org/apache/zookeeper/server/util/SerializeUtils.java,107,0,0.0,0,0,0.0,0,0,0.0,0,0,0.0,0,0,0,0,NO
9,src/java/main/org/apache/zookeeper/version/util/VerGen.java,146,0,0.0,0,0,0.0,0,0,0.0,0,0,0.0,0,0,0,0,YES
9,src/recipes/lock/src/java/org/apache/zookeeper/recipes/lock/LockListener.java,38,0,0.0,0,0,0.0,0,0,0.0,0,0,0.0,0,0,0,0,NO
9,src/recipes/lock/src/java/org/apache/zookeeper/recipes/lock/ProtocolSupport.java,192,0,0.0,0,0,0.0,0,0,0.0,0,0,0.0,0,0,0,0,NO
9,src/recipes/lock/src/java/org/apache/zookeeper/recipes/lock/WriteLock.java,294,0,0.0,0,0,0.0,0,0,0.0,0,0,0.0,0,0,0,0,NO
9,src/recipes/lock/src/java/org/apache/zookeeper/recipes/lock/ZNodeName.java,109,0,0.0,0,0,0.0,0,0,0.0,0,0,0.0,0,0,0,0,NO
9,src/recipes/lock/src/java/org/apache/zookeeper/recipes/lock/ZooKeeperOperation.java,38,0,0.0,0,0,0.0,0,0,0.0,0,0,0.0,0,0,0,0,NO
9,src/recipes/queue/src/java/org/apache/zookeeper/recipes/queue/DistributedQueue.java,312,0,0.0,0,0,0.0,0,0,0.0,0,0,0.0,0,0,0,0,NO
10,src/contrib/bookkeeper/benchmark/org/apache/bookkeeper/benchmark/MySqlClient.java,137,0,0.0,0,0,0.0,0,0,0.0,0,0,0.0,0,0,0,0,NO
10,src/contrib/bookkeeper/benchmark/org/apache/bookkeeper/benchmark/TestClient.java,252,2,2.0,2,2,2.0,2,4,4.0,4,0,0.0,0,1,1,1,NO
10,src/contrib/bookkeeper/src/java/org/apache/bookkeeper/bookie/Bookie.java,536,0,0.0,0,0,0.0,0,0,0.0,0,0,0.0,0,0,0,0,YES
10,src/contrib/bookkeeper/src/java/org/apache/bookkeeper/bookie/BookieException.java,81,0,0.0,0,0,0.0,0,0,0.0,0,0,0.0,0,0,0,0,NO
10,src/contrib/bookkeeper/src/java/org/apache/bookkeeper/bookie/BufferedChannel.java,168,0,0.0,0,0,0.0,0,0,0.0,0,0,0.0,0,0,0,0,NO
10,src/contrib/bookkeeper/src/java/org/apache/bookkeeper/bookie/EntryLogger.java,487,0,0.0,0,0,0.0,0,0,0.0,0,0,0.0,0,0,0,0,NO
10,src/contrib/bookkeeper/src/java/org/apache/bookkeeper/bookie/FileInfo.java,124,0,0.0,0,0,0.0,0,0,0.0,0,0,0.0,0,0,0,0,NO
10,src/contrib/bookkeeper/src/java/org/apache/bookkeeper/bookie/LedgerCache.java,536,0,0.0,0,0,0.0,0,0,0.0,0,0,0.0,0,0,0,0,NO
10,src/contrib/bookkeeper/src/java/org/apache/bookkeeper/bookie/LedgerDescriptor.java,133,0,0.0,0,0,0.0,0,0,0.0,0,0,0.0,0,0,0,0,NO
10,src/contrib/bookkeeper/src/java/org/apache/bookkeeper/bookie/LedgerEntryPage.java,151,0,0.0,0,0,0.0,0,0,0.0,0,0,0.0,0,0,0,0,NO
10,src/contrib/bookkeeper/src/java/org/apache/bookkeeper/bookie/MarkerFileChannel.java,147,0,0.0,0,0,0.0,0,0,0.0,0,0,0.0,0,0,0,0,NO
10,src/contrib/bookkeeper/src/java/org/apache/bookkeeper/client/AsyncCallback.java,126,12,12.0,12,0,0.0,0,12,12.0,12,12,12.0,12,1,0,1,NO
10,src/contrib/bookkeeper/src/java/org/apache/bookkeeper/client/BKException.java,238,12,12.0,12,1,1.0,1,13,13.0,13,11,11.0,11,1,0,1,NO
10,src/contrib/bookkeeper/src/java/org/apache/bookkeeper/client/BookKeeper.java,410,9,9.0,9,0,0.0,0,9,9.0,9,9,9.0,9,1,0,1,NO
10,src/contrib/bookkeeper/src/java/org/apache/bookkeeper/client/BookieWatcher.java,204,0,0.0,0,0,0.0,0,0,0.0,0,0,0.0,0,0,0,0,NO
10,src/contrib/bookkeeper/src/java/org/apache/bookkeeper/client/CRC32DigestManager.java,50,0,0.0,0,0,0.0,0,0,0.0,0,0,0.0,0,0,0,0,NO
10,src/contrib/bookkeeper/src/java/org/apache/bookkeeper/client/DigestManager.java,162,2,2.0,2,2,2.0,2,4,4.0,4,0,0.0,0,1,0,1,NO
10,src/contrib/bookkeeper/src/java/org/apache/bookkeeper/client/DistributionSchedule.java,61,1,1.0,1,1,1.0,1,2,2.0,2,0,0.0,0,1,0,1,NO
10,src/contrib/bookkeeper/src/java/org/apache/bookkeeper/client/LedgerCreateOp.java,167,4,4.0,4,0,0.0,0,4,4.0,4,4,4.0,4,1,0,1,NO
10,src/contrib/bookkeeper/src/java/org/apache/bookkeeper/client/LedgerDeleteOp.java,80,0,0.0,0,0,0.0,0,0,0.0,0,0,0.0,0,0,0,0,NO
10,src/contrib/bookkeeper/src/java/org/apache/bookkeeper/client/LedgerEntry.java,78,0,0.0,0,0,0.0,0,0,0.0,0,0,0.0,0,0,0,0,NO
10,src/contrib/bookkeeper/src/java/org/apache/bookkeeper/client/LedgerHandle.java,512,94,31.333334,94,30,10.0,30,124,41.333332,124,64,21.333334,64,3,1,1,NO
10,src/contrib/bookkeeper/src/java/org/apache/bookkeeper/client/LedgerMetadata.java,190,12,12.0,12,1,1.0,1,13,13.0,13,11,11.0,11,1,0,1,NO
10,src/contrib/bookkeeper/src/java/org/apache/bookkeeper/client/LedgerOpenOp.java,140,4,4.0,4,0,0.0,0,4,4.0,4,4,4.0,4,1,0,1,NO
10,src/contrib/bookkeeper/src/java/org/apache/bookkeeper/client/LedgerRecoveryOp.java,176,13,13.0,13,4,4.0,4,17,17.0,17,9,9.0,9,1,0,1,NO
10,src/contrib/bookkeeper/src/java/org/apache/bookkeeper/client/MacDigestManager.java,67,0,0.0,0,0,0.0,0,0,0.0,0,0,0.0,0,0,0,0,NO
10,src/contrib/bookkeeper/src/java/org/apache/bookkeeper/client/PendingAddOp.java,138,1,1.0,1,0,0.0,0,1,1.0,1,1,1.0,1,1,0,1,NO
10,src/contrib/bookkeeper/src/java/org/apache/bookkeeper/client/PendingReadOp.java,161,23,11.5,23,7,3.5,7,30,15.0,30,16,8.0,16,2,1,1,NO
10,src/contrib/bookkeeper/src/java/org/apache/bookkeeper/client/RoundRobinDistributionSchedule.java,87,0,0.0,0,0,0.0,0,0,0.0,0,0,0.0,0,0,0,0,NO
10,src/contrib/bookkeeper/src/java/org/apache/bookkeeper/client/SyncCounter.java,85,0,0.0,0,0,0.0,0,0,0.0,0,0,0.0,0,0,0,0,NO
10,src/contrib/bookkeeper/src/java/org/apache/bookkeeper/proto/BookieClient.java,178,0,0.0,0,0,0.0,0,0,0.0,0,0,0.0,0,0,0,0,NO
10,src/contrib/bookkeeper/src/java/org/apache/bookkeeper/proto/BookieProtocol.java,75,0,0.0,0,0,0.0,0,0,0.0,0,0,0.0,0,0,0,0,NO
10,src/contrib/bookkeeper/src/java/org/apache/bookkeeper/proto/BookieServer.java,208,0,0.0,0,0,0.0,0,0,0.0,0,0,0.0,0,0,0,0,YES
10,src/contrib/bookkeeper/src/java/org/apache/bookkeeper/proto/BookkeeperInternalCallbacks.java,57,0,0.0,0,0,0.0,0,0,0.0,0,0,0.0,0,0,0,0,NO
10,src/contrib/bookkeeper/src/java/org/apache/bookkeeper/proto/NIOServerFactory.java,517,0,0.0,0,0,0.0,0,0,0.0,0,0,0.0,0,0,0,0,YES
10,src/contrib/bookkeeper/src/java/org/apache/bookkeeper/proto/PerChannelBookieClient.java,573,3,3.0,3,0,0.0,0,3,3.0,3,3,3.0,3,1,0,1,NO
10,src/contrib/bookkeeper/src/java/org/apache/bookkeeper/proto/ServerStats.java,148,0,0.0,0,0,0.0,0,0,0.0,0,0,0.0,0,0,0,0,NO
10,src/contrib/bookkeeper/src/java/org/apache/bookkeeper/streaming/LedgerInputStream.java,173,0,0.0,0,0,0.0,0,0,0.0,0,0,0.0,0,0,0,0,NO
10,src/contrib/bookkeeper/src/java/org/apache/bookkeeper/streaming/LedgerOutputStream.java,147,0,0.0,0,0,0.0,0,0,0.0,0,0,0.0,0,0,0,0,NO
10,src/contrib/bookkeeper/src/java/org/apache/bookkeeper/tools/BookKeeperTools.java,762,762,762.0,762,0,0.0,0,762,762.0,762,762,762.0,762,1,0,1,NO
10,src/contrib/bookkeeper/src/java/org/apache/bookkeeper/util/LocalBookKeeper.java,209,6,6.0,6,5,5.0,5,11,11.0,11,1,1.0,1,1,1,1,NO
10,src/contrib/bookkeeper/src/java/org/apache/bookkeeper/util/Main.java,54,0,0.0,0,0,0.0,0,0,0.0,0,0,0.0,0,0,0,0,NO
10,src/contrib/bookkeeper/src/java/org/apache/bookkeeper/util/MathUtils.java,38,0,0.0,0,0,0.0,0,0,0.0,0,0,0.0,0,0,0,0,NO
10,src/contrib/bookkeeper/src/java/org/apache/bookkeeper/util/OrderedSafeExecutor.java,98,0,0.0,0,0,0.0,0,0,0.0,0,0,0.0,0,0,0,0,NO
10,src/contrib/bookkeeper/src/java/org/apache/bookkeeper/util/SafeRunnable.java,38,0,0.0,0,0,0.0,0,0,0.0,0,0,0.0,0,0,0,0,NO
10,src/contrib/bookkeeper/src/java/org/apache/bookkeeper/util/StringUtils.java,94,0,0.0,0,0,0.0,0,0,0.0,0,0,0.0,0,0,0,0,NO
10,src/contrib/fatjar/src/java/org/apache/zookeeper/util/FatJarMain.java,126,0,0.0,0,0,0.0,0,0,0.0,0,0,0.0,0,0,0,0,NO
10,src/contrib/hedwig/client/src/main/java/org/apache/hedwig/client/api/MessageHandler.java,48,48,48.0,48,0,0.0,0,48,48.0,48,48,48.0,48,1,0,1,NO
10,src/contrib/hedwig/client/src/main/java/org/apache/hedwig/client/api/Publisher.java,63,63,63.0,63,0,0.0,0,63,63.0,63,63,63.0,63,1,0,1,NO
10,src/contrib/hedwig/client/src/main/java/org/apache/hedwig/client/api/Subscriber.java,237,237,237.0,237,0,0.0,0,237,237.0,237,237,237.0,237,1,0,1,NO
10,src/contrib/hedwig/client/src/main/java/org/apache/hedwig/client/benchmark/BenchmarkPublisher.java,133,133,133.0,133,0,0.0,0,133,133.0,133,133,133.0,133,1,0,1,NO
10,src/contrib/hedwig/client/src/main/java/org/apache/hedwig/client/benchmark/BenchmarkSubscriber.java,136,136,136.0,136,0,0.0,0,136,136.0,136,136,136.0,136,1,0,1,NO
10,src/contrib/hedwig/client/src/main/java/org/apache/hedwig/client/benchmark/BenchmarkUtils.java,176,176,176.0,176,0,0.0,0,176,176.0,176,176,176.0,176,1,0,1,NO
10,src/contrib/hedwig/client/src/main/java/org/apache/hedwig/client/benchmark/BenchmarkWorker.java,46,46,46.0,46,0,0.0,0,46,46.0,46,46,46.0,46,1,0,1,NO
10,src/contrib/hedwig/client/src/main/java/org/apache/hedwig/client/benchmark/HedwigBenchmark.java,127,127,127.0,127,0,0.0,0,127,127.0,127,127,127.0,127,1,0,1,NO
10,src/contrib/hedwig/client/src/main/java/org/apache/hedwig/client/conf/ClientConfiguration.java,148,148,148.0,148,0,0.0,0,148,148.0,148,148,148.0,148,1,0,1,NO
10,src/contrib/hedwig/client/src/main/java/org/apache/hedwig/client/data/MessageConsumeData.java,58,58,58.0,58,0,0.0,0,58,58.0,58,58,58.0,58,1,0,1,NO
10,src/contrib/hedwig/client/src/main/java/org/apache/hedwig/client/data/PubSubData.java,149,149,149.0,149,0,0.0,0,149,149.0,149,149,149.0,149,1,0,1,NO
10,src/contrib/hedwig/client/src/main/java/org/apache/hedwig/client/data/TopicSubscriber.java,74,74,74.0,74,0,0.0,0,74,74.0,74,74,74.0,74,1,0,1,NO
10,src/contrib/hedwig/client/src/main/java/org/apache/hedwig/client/exceptions/InvalidSubscriberIdException.java,37,37,37.0,37,0,0.0,0,37,37.0,37,37,37.0,37,1,0,1,NO
10,src/contrib/hedwig/client/src/main/java/org/apache/hedwig/client/exceptions/ServerRedirectLoopException.java,38,38,38.0,38,0,0.0,0,38,38.0,38,38,38.0,38,1,0,1,NO
10,src/contrib/hedwig/client/src/main/java/org/apache/hedwig/client/exceptions/TooManyServerRedirectsException.java,39,39,39.0,39,0,0.0,0,39,39.0,39,39,39.0,39,1,0,1,NO
10,src/contrib/hedwig/client/src/main/java/org/apache/hedwig/client/handlers/MessageConsumeCallback.java,95,95,95.0,95,0,0.0,0,95,95.0,95,95,95.0,95,1,0,1,NO
10,src/contrib/hedwig/client/src/main/java/org/apache/hedwig/client/handlers/PubSubCallback.java,87,87,87.0,87,0,0.0,0,87,87.0,87,87,87.0,87,1,0,1,NO
10,src/contrib/hedwig/client/src/main/java/org/apache/hedwig/client/handlers/PublishResponseHandler.java,70,70,70.0,70,0,0.0,0,70,70.0,70,70,70.0,70,1,0,1,NO
10,src/contrib/hedwig/client/src/main/java/org/apache/hedwig/client/handlers/SubscribeReconnectCallback.java,113,113,113.0,113,0,0.0,0,113,113.0,113,113,113.0,113,1,0,1,NO
10,src/contrib/hedwig/client/src/main/java/org/apache/hedwig/client/handlers/SubscribeResponseHandler.java,329,329,329.0,329,0,0.0,0,329,329.0,329,329,329.0,329,1,0,1,NO
10,src/contrib/hedwig/client/src/main/java/org/apache/hedwig/client/handlers/UnsubscribeResponseHandler.java,83,83,83.0,83,0,0.0,0,83,83.0,83,83,83.0,83,1,0,1,NO
10,src/contrib/hedwig/client/src/main/java/org/apache/hedwig/client/netty/ClientChannelPipelineFactory.java,58,58,58.0,58,0,0.0,0,58,58.0,58,58,58.0,58,1,0,1,NO
10,src/contrib/hedwig/client/src/main/java/org/apache/hedwig/client/netty/ConnectCallback.java,122,122,122.0,122,0,0.0,0,122,122.0,122,122,122.0,122,1,0,1,NO
10,src/contrib/hedwig/client/src/main/java/org/apache/hedwig/client/netty/HedwigClient.java,359,359,359.0,359,0,0.0,0,359,359.0,359,359,359.0,359,1,0,1,NO
10,src/contrib/hedwig/client/src/main/java/org/apache/hedwig/client/netty/HedwigPublisher.java,224,224,224.0,224,0,0.0,0,224,224.0,224,224,224.0,224,1,0,1,NO
10,src/contrib/hedwig/client/src/main/java/org/apache/hedwig/client/netty/HedwigSubscriber.java,585,585,585.0,585,0,0.0,0,585,585.0,585,585,585.0,585,1,0,1,NO
10,src/contrib/hedwig/client/src/main/java/org/apache/hedwig/client/netty/ResponseHandler.java,365,365,365.0,365,0,0.0,0,365,365.0,365,365,365.0,365,1,0,1,NO
10,src/contrib/hedwig/client/src/main/java/org/apache/hedwig/client/netty/WriteCallback.java,98,98,98.0,98,0,0.0,0,98,98.0,98,98,98.0,98,1,0,1,NO
10,src/contrib/hedwig/client/src/main/java/org/apache/hedwig/client/ssl/SslClientContextFactory.java,41,41,41.0,41,0,0.0,0,41,41.0,41,41,41.0,41,1,0,1,NO
10,src/contrib/hedwig/client/src/main/java/org/apache/hedwig/client/ssl/SslContextFactory.java,65,65,65.0,65,0,0.0,0,65,65.0,65,65,65.0,65,1,0,1,NO
10,src/contrib/hedwig/client/src/main/java/org/apache/hedwig/conf/AbstractConfiguration.java,45,45,45.0,45,0,0.0,0,45,45.0,45,45,45.0,45,1,0,1,NO
10,src/contrib/hedwig/client/src/main/java/org/apache/hedwig/util/Callback.java,47,47,47.0,47,0,0.0,0,47,47.0,47,47,47.0,47,1,0,1,NO
10,src/contrib/hedwig/client/src/main/java/org/apache/hedwig/util/CallbackUtils.java,185,185,185.0,185,0,0.0,0,185,185.0,185,185,185.0,185,1,0,1,NO
10,src/contrib/hedwig/client/src/main/java/org/apache/hedwig/util/ConcurrencyUtils.java,49,49,49.0,49,0,0.0,0,49,49.0,49,49,49.0,49,1,0,1,NO
10,src/contrib/hedwig/client/src/main/java/org/apache/hedwig/util/Either.java,50,50,50.0,50,0,0.0,0,50,50.0,50,50,50.0,50,1,0,1,NO
10,src/contrib/hedwig/client/src/main/java/org/apache/hedwig/util/FileUtils.java,97,97,97.0,97,0,0.0,0,97,97.0,97,97,97.0,97,1,0,1,NO
10,src/contrib/hedwig/client/src/main/java/org/apache/hedwig/util/HedwigSocketAddress.java,138,138,138.0,138,0,0.0,0,138,138.0,138,138,138.0,138,1,0,1,NO
10,src/contrib/hedwig/client/src/main/java/org/apache/hedwig/util/Option.java,43,43,43.0,43,0,0.0,0,43,43.0,43,43,43.0,43,1,0,1,NO
10,src/contrib/hedwig/client/src/main/java/org/apache/hedwig/util/Pair.java,42,42,42.0,42,0,0.0,0,42,42.0,42,42,42.0,42,1,0,1,NO
10,src/contrib/hedwig/client/src/main/java/org/apache/hedwig/util/PathUtils.java,56,56,56.0,56,0,0.0,0,56,56.0,56,56,56.0,56,1,0,1,NO
10,src/contrib/hedwig/protocol/src/main/java/org/apache/hedwig/exceptions/PubSubException.java,162,162,162.0,162,0,0.0,0,162,162.0,162,162,162.0,162,1,0,1,NO
10,src/contrib/hedwig/protocol/src/main/java/org/apache/hedwig/protoextensions/MessageIdUtils.java,153,153,153.0,153,0,0.0,0,153,153.0,153,153,153.0,153,1,0,1,NO
10,src/contrib/hedwig/protocol/src/main/java/org/apache/hedwig/protoextensions/PubSubResponseUtils.java,43,43,43.0,43,0,0.0,0,43,43.0,43,43,43.0,43,1,0,1,NO
10,src/contrib/hedwig/protocol/src/main/java/org/apache/hedwig/protoextensions/SubscriptionStateUtils.java,41,41,41.0,41,0,0.0,0,41,41.0,41,41,41.0,41,1,0,1,NO
10,src/contrib/hedwig/server/src/main/java/org/apache/hedwig/server/benchmark/AbstractBenchmark.java,104,104,104.0,104,0,0.0,0,104,104.0,104,104,104.0,104,1,0,1,NO
10,src/contrib/hedwig/server/src/main/java/org/apache/hedwig/server/benchmark/BookieBenchmark.java,103,103,103.0,103,0,0.0,0,103,103.0,103,103,103.0,103,1,0,1,NO
10,src/contrib/hedwig/server/src/main/java/org/apache/hedwig/server/benchmark/BookkeeperBenchmark.java,91,91,91.0,91,0,0.0,0,91,91.0,91,91,91.0,91,1,0,1,NO
10,src/contrib/hedwig/server/src/main/java/org/apache/hedwig/server/benchmark/FakeBookie.java,100,100,100.0,100,0,0.0,0,100,100.0,100,100,100.0,100,1,0,1,NO
10,src/contrib/hedwig/server/src/main/java/org/apache/hedwig/server/common/ByteStringInterner.java,45,45,45.0,45,0,0.0,0,45,45.0,45,45,45.0,45,1,0,1,NO
10,src/contrib/hedwig/server/src/main/java/org/apache/hedwig/server/common/ServerConfiguration.java,289,289,144.5,289,0,0.0,0,289,144.5,289,289,144.5,289,2,1,2,NO
10,src/contrib/hedwig/server/src/main/java/org/apache/hedwig/server/common/TerminateJVMExceptionHandler.java,31,31,31.0,31,0,0.0,0,31,31.0,31,31,31.0,31,1,0,1,NO
10,src/contrib/hedwig/server/src/main/java/org/apache/hedwig/server/common/TopicOpQueuer.java,111,111,111.0,111,0,0.0,0,111,111.0,111,111,111.0,111,1,0,1,NO
10,src/contrib/hedwig/server/src/main/java/org/apache/hedwig/server/common/UnexpectedError.java,35,35,35.0,35,0,0.0,0,35,35.0,35,35,35.0,35,1,0,1,NO
10,src/contrib/hedwig/server/src/main/java/org/apache/hedwig/server/delivery/ChannelEndPoint.java,81,81,81.0,81,0,0.0,0,81,81.0,81,81,81.0,81,1,0,1,NO
10,src/contrib/hedwig/server/src/main/java/org/apache/hedwig/server/delivery/DeliveryCallback.java,27,27,27.0,27,0,0.0,0,27,27.0,27,27,27.0,27,1,0,1,NO
10,src/contrib/hedwig/server/src/main/java/org/apache/hedwig/server/delivery/DeliveryEndPoint.java,28,28,28.0,28,0,0.0,0,28,28.0,28,28,28.0,28,1,0,1,NO
10,src/contrib/hedwig/server/src/main/java/org/apache/hedwig/server/delivery/DeliveryManager.java,29,29,29.0,29,0,0.0,0,29,29.0,29,29,29.0,29,1,0,1,NO
10,src/contrib/hedwig/server/src/main/java/org/apache/hedwig/server/delivery/FIFODeliveryManager.java,561,561,561.0,561,0,0.0,0,561,561.0,561,561,561.0,561,1,0,1,NO
10,src/contrib/hedwig/server/src/main/java/org/apache/hedwig/server/handlers/BaseHandler.java,64,64,64.0,64,0,0.0,0,64,64.0,64,64,64.0,64,1,0,1,NO
10,src/contrib/hedwig/server/src/main/java/org/apache/hedwig/server/handlers/ChannelDisconnectListener.java,29,29,29.0,29,0,0.0,0,29,29.0,29,29,29.0,29,1,0,1,NO
10,src/contrib/hedwig/server/src/main/java/org/apache/hedwig/server/handlers/ConsumeHandler.java,64,64,64.0,64,0,0.0,0,64,64.0,64,64,64.0,64,1,0,1,NO
10,src/contrib/hedwig/server/src/main/java/org/apache/hedwig/server/handlers/Handler.java,37,37,37.0,37,0,0.0,0,37,37.0,37,37,37.0,37,1,0,1,NO
10,src/contrib/hedwig/server/src/main/java/org/apache/hedwig/server/handlers/PublishHandler.java,68,68,68.0,68,0,0.0,0,68,68.0,68,68,68.0,68,1,0,1,NO
10,src/contrib/hedwig/server/src/main/java/org/apache/hedwig/server/handlers/SubscribeHandler.java,153,153,153.0,153,0,0.0,0,153,153.0,153,153,153.0,153,1,0,1,NO
10,src/contrib/hedwig/server/src/main/java/org/apache/hedwig/server/handlers/UnsubscribeHandler.java,72,72,72.0,72,0,0.0,0,72,72.0,72,72,72.0,72,1,0,1,NO
10,src/contrib/hedwig/server/src/main/java/org/apache/hedwig/server/netty/PubSubServer.java,364,364,364.0,364,0,0.0,0,364,364.0,364,364,364.0,364,1,0,1,NO
10,src/contrib/hedwig/server/src/main/java/org/apache/hedwig/server/netty/PubSubServerPipelineFactory.java,76,76,76.0,76,0,0.0,0,76,76.0,76,76,76.0,76,1,0,1,NO
10,src/contrib/hedwig/server/src/main/java/org/apache/hedwig/server/netty/UmbrellaHandler.java,158,158,158.0,158,0,0.0,0,158,158.0,158,158,158.0,158,1,0,1,NO
10,src/contrib/hedwig/server/src/main/java/org/apache/hedwig/server/persistence/BookkeeperPersistenceManager.java,736,740,370.0,740,4,2.0,4,744,372.0,744,742,371.0,742,2,1,2,NO
10,src/contrib/hedwig/server/src/main/java/org/apache/hedwig/server/persistence/CacheKey.java,74,74,74.0,74,0,0.0,0,74,74.0,74,74,74.0,74,1,0,1,NO
10,src/contrib/hedwig/server/src/main/java/org/apache/hedwig/server/persistence/CacheValue.java,93,93,93.0,93,0,0.0,0,93,93.0,93,93,93.0,93,1,0,1,NO
10,src/contrib/hedwig/server/src/main/java/org/apache/hedwig/server/persistence/Factory.java,22,22,22.0,22,0,0.0,0,22,22.0,22,22,22.0,22,1,0,1,NO
10,src/contrib/hedwig/server/src/main/java/org/apache/hedwig/server/persistence/LocalDBPersistenceManager.java,426,426,426.0,426,0,0.0,0,426,426.0,426,426,426.0,426,1,0,1,NO
10,src/contrib/hedwig/server/src/main/java/org/apache/hedwig/server/persistence/MapMethods.java,62,62,62.0,62,0,0.0,0,62,62.0,62,62,62.0,62,1,0,1,NO
10,src/contrib/hedwig/server/src/main/java/org/apache/hedwig/server/persistence/PersistRequest.java,58,58,58.0,58,0,0.0,0,58,58.0,58,58,58.0,58,1,0,1,NO
10,src/contrib/hedwig/server/src/main/java/org/apache/hedwig/server/persistence/PersistenceManager.java,91,91,91.0,91,0,0.0,0,91,91.0,91,91,91.0,91,1,0,1,NO
10,src/contrib/hedwig/server/src/main/java/org/apache/hedwig/server/persistence/PersistenceManagerWithRangeScan.java,27,27,27.0,27,0,0.0,0,27,27.0,27,27,27.0,27,1,0,1,NO
10,src/contrib/hedwig/server/src/main/java/org/apache/hedwig/server/persistence/RangeScanRequest.java,77,77,77.0,77,0,0.0,0,77,77.0,77,77,77.0,77,1,0,1,NO
10,src/contrib/hedwig/server/src/main/java/org/apache/hedwig/server/persistence/ReadAheadCache.java,703,703,703.0,703,0,0.0,0,703,703.0,703,703,703.0,703,1,0,1,NO
10,src/contrib/hedwig/server/src/main/java/org/apache/hedwig/server/persistence/ScanCallback.java,63,63,63.0,63,0,0.0,0,63,63.0,63,63,63.0,63,1,0,1,NO
10,src/contrib/hedwig/server/src/main/java/org/apache/hedwig/server/persistence/ScanCallbackWithContext.java,37,37,37.0,37,0,0.0,0,37,37.0,37,37,37.0,37,1,0,1,NO
10,src/contrib/hedwig/server/src/main/java/org/apache/hedwig/server/persistence/ScanRequest.java,64,64,64.0,64,0,0.0,0,64,64.0,64,64,64.0,64,1,0,1,NO
10,src/contrib/hedwig/server/src/main/java/org/apache/hedwig/server/proxy/ChannelTracker.java,124,124,124.0,124,0,0.0,0,124,124.0,124,124,124.0,124,1,0,1,NO
10,src/contrib/hedwig/server/src/main/java/org/apache/hedwig/server/proxy/HedwigProxy.java,159,159,159.0,159,0,0.0,0,159,159.0,159,159,159.0,159,1,0,1,NO
10,src/contrib/hedwig/server/src/main/java/org/apache/hedwig/server/proxy/ProxyConfiguration.java,36,36,36.0,36,0,0.0,0,36,36.0,36,36,36.0,36,1,0,1,NO
10,src/contrib/hedwig/server/src/main/java/org/apache/hedwig/server/proxy/ProxyConsumeHandler.java,57,57,57.0,57,0,0.0,0,57,57.0,57,57,57.0,57,1,0,1,NO
10,src/contrib/hedwig/server/src/main/java/org/apache/hedwig/server/proxy/ProxyPublishHander.java,62,62,62.0,62,0,0.0,0,62,62.0,62,62,62.0,62,1,0,1,NO
10,src/contrib/hedwig/server/src/main/java/org/apache/hedwig/server/proxy/ProxyStartDeliveryHandler.java,129,129,129.0,129,0,0.0,0,129,129.0,129,129,129.0,129,1,0,1,NO
10,src/contrib/hedwig/server/src/main/java/org/apache/hedwig/server/proxy/ProxyStopDeliveryHandler.java,73,73,73.0,73,0,0.0,0,73,73.0,73,73,73.0,73,1,0,1,NO
10,src/contrib/hedwig/server/src/main/java/org/apache/hedwig/server/proxy/ProxySubscribeHandler.java,82,82,82.0,82,0,0.0,0,82,82.0,82,82,82.0,82,1,0,1,NO
10,src/contrib/hedwig/server/src/main/java/org/apache/hedwig/server/proxy/ProxyUnsubscribeHandler.java,74,74,74.0,74,0,0.0,0,74,74.0,74,74,74.0,74,1,0,1,NO
10,src/contrib/hedwig/server/src/main/java/org/apache/hedwig/server/regions/HedwigHubClient.java,48,48,48.0,48,0,0.0,0,48,48.0,48,48,48.0,48,1,0,1,NO
10,src/contrib/hedwig/server/src/main/java/org/apache/hedwig/server/regions/HedwigHubClientFactory.java,60,60,60.0,60,0,0.0,0,60,60.0,60,60,60.0,60,1,0,1,NO
10,src/contrib/hedwig/server/src/main/java/org/apache/hedwig/server/regions/HedwigHubSubscriber.java,70,70,70.0,70,0,0.0,0,70,70.0,70,70,70.0,70,1,0,1,NO
10,src/contrib/hedwig/server/src/main/java/org/apache/hedwig/server/regions/RegionManager.java,180,180,180.0,180,0,0.0,0,180,180.0,180,180,180.0,180,1,0,1,NO
10,src/contrib/hedwig/server/src/main/java/org/apache/hedwig/server/ssl/SslServerContextFactory.java,53,53,53.0,53,0,0.0,0,53,53.0,53,53,53.0,53,1,0,1,NO
10,src/contrib/hedwig/server/src/main/java/org/apache/hedwig/server/subscriptions/AbstractSubscriptionManager.java,450,450,450.0,450,0,0.0,0,450,450.0,450,450,450.0,450,1,0,1,NO
10,src/contrib/hedwig/server/src/main/java/org/apache/hedwig/server/subscriptions/AllToAllTopologyFilter.java,39,39,39.0,39,0,0.0,0,39,39.0,39,39,39.0,39,1,0,1,NO
10,src/contrib/hedwig/server/src/main/java/org/apache/hedwig/server/subscriptions/InMemorySubscriptionManager.java,78,78,78.0,78,0,0.0,0,78,78.0,78,78,78.0,78,1,0,1,NO
10,src/contrib/hedwig/server/src/main/java/org/apache/hedwig/server/subscriptions/InMemorySubscriptionState.java,64,64,64.0,64,0,0.0,0,64,64.0,64,64,64.0,64,1,0,1,NO
10,src/contrib/hedwig/server/src/main/java/org/apache/hedwig/server/subscriptions/MessageFilter.java,31,31,31.0,31,0,0.0,0,31,31.0,31,31,31.0,31,1,0,1,NO
10,src/contrib/hedwig/server/src/main/java/org/apache/hedwig/server/subscriptions/SubscriptionEventListener.java,57,57,57.0,57,0,0.0,0,57,57.0,57,57,57.0,57,1,0,1,NO
10,src/contrib/hedwig/server/src/main/java/org/apache/hedwig/server/subscriptions/SubscriptionManager.java,104,104,104.0,104,0,0.0,0,104,104.0,104,104,104.0,104,1,0,1,NO
10,src/contrib/hedwig/server/src/main/java/org/apache/hedwig/server/subscriptions/TrueFilter.java,32,32,32.0,32,0,0.0,0,32,32.0,32,32,32.0,32,1,0,1,NO
10,src/contrib/hedwig/server/src/main/java/org/apache/hedwig/server/subscriptions/ZkSubscriptionManager.java,226,226,226.0,226,0,0.0,0,226,226.0,226,226,226.0,226,1,0,1,NO
10,src/contrib/hedwig/server/src/main/java/org/apache/hedwig/server/topics/AbstractTopicManager.java,187,187,187.0,187,0,0.0,0,187,187.0,187,187,187.0,187,1,0,1,NO
10,src/contrib/hedwig/server/src/main/java/org/apache/hedwig/server/topics/TopicManager.java,75,75,75.0,75,0,0.0,0,75,75.0,75,75,75.0,75,1,0,1,NO
10,src/contrib/hedwig/server/src/main/java/org/apache/hedwig/server/topics/TopicOwnershipChangeListener.java,28,28,28.0,28,0,0.0,0,28,28.0,28,28,28.0,28,1,0,1,NO
10,src/contrib/hedwig/server/src/main/java/org/apache/hedwig/server/topics/TrivialOwnAllTopicManager.java,52,52,52.0,52,0,0.0,0,52,52.0,52,52,52.0,52,1,0,1,NO
10,src/contrib/hedwig/server/src/main/java/org/apache/hedwig/server/topics/ZkTopicManager.java,428,433,216.5,433,5,2.5,5,438,219.0,438,428,214.0,428,2,1,2,NO
10,src/contrib/hedwig/server/src/main/java/org/apache/hedwig/zookeeper/SafeAsynBKCallback.java,103,104,104.0,104,0,0.0,0,104,104.0,104,104,104.0,104,1,0,1,NO
10,src/contrib/hedwig/server/src/main/java/org/apache/hedwig/zookeeper/SafeAsyncCallback.java,35,35,35.0,35,0,0.0,0,35,35.0,35,35,35.0,35,1,0,1,NO
10,src/contrib/hedwig/server/src/main/java/org/apache/hedwig/zookeeper/SafeAsyncZKCallback.java,98,98,98.0,98,0,0.0,0,98,98.0,98,98,98.0,98,1,0,1,NO
10,src/contrib/hedwig/server/src/main/java/org/apache/hedwig/zookeeper/ZkUtils.java,78,78,78.0,78,0,0.0,0,78,78.0,78,78,78.0,78,1,0,1,NO
10,src/contrib/loggraph/src/java/org/apache/zookeeper/graph/FilterException.java,22,22,22.0,22,0,0.0,0,22,22.0,22,22,22.0,22,1,0,1,NO
10,src/contrib/loggraph/src/java/org/apache/zookeeper/graph/FilterOp.java,75,75,75.0,75,0,0.0,0,75,75.0,75,75,75.0,75,1,0,1,NO
10,src/contrib/loggraph/src/java/org/apache/zookeeper/graph/FilterParser.java,131,131,131.0,131,0,0.0,0,131,131.0,131,131,131.0,131,1,0,1,NO
10,src/contrib/loggraph/src/java/org/apache/zookeeper/graph/JsonGenerator.java,223,230,115.0,230,7,3.5,7,237,118.5,237,229,114.5,229,2,0,1,NO
10,src/contrib/loggraph/src/java/org/apache/zookeeper/graph/Log4JEntry.java,40,40,40.0,40,0,0.0,0,40,40.0,40,40,40.0,40,1,0,1,NO
10,src/contrib/loggraph/src/java/org/apache/zookeeper/graph/Log4JSource.java,380,381,190.5,381,1,0.5,1,382,191.0,382,380,190.0,380,2,0,1,NO
10,src/contrib/loggraph/src/java/org/apache/zookeeper/graph/LogEntry.java,46,46,46.0,46,0,0.0,0,46,46.0,46,46,46.0,46,1,0,1,NO
10,src/contrib/loggraph/src/java/org/apache/zookeeper/graph/LogIterator.java,26,26,26.0,26,0,0.0,0,26,26.0,26,26,26.0,26,1,0,1,NO
10,src/contrib/loggraph/src/java/org/apache/zookeeper/graph/LogServer.java,66,66,66.0,66,0,0.0,0,66,66.0,66,66,66.0,66,1,0,1,NO
10,src/contrib/loggraph/src/java/org/apache/zookeeper/graph/LogSkipList.java,94,94,94.0,94,0,0.0,0,94,94.0,94,94,94.0,94,1,0,1,NO
10,src/contrib/loggraph/src/java/org/apache/zookeeper/graph/LogSource.java,33,33,33.0,33,0,0.0,0,33,33.0,33,33,33.0,33,1,0,1,NO
10,src/contrib/loggraph/src/java/org/apache/zookeeper/graph/MeasureThroughput.java,103,103,103.0,103,0,0.0,0,103,103.0,103,103,103.0,103,1,0,1,NO
10,src/contrib/loggraph/src/java/org/apache/zookeeper/graph/MergedLogSource.java,218,218,218.0,218,0,0.0,0,218,218.0,218,218,218.0,218,1,0,1,NO
10,src/contrib/loggraph/src/java/org/apache/zookeeper/graph/RandomAccessFileReader.java,327,327,327.0,327,0,0.0,0,327,327.0,327,327,327.0,327,1,0,1,NO
10,src/contrib/loggraph/src/java/org/apache/zookeeper/graph/TransactionEntry.java,59,59,59.0,59,0,0.0,0,59,59.0,59,59,59.0,59,1,0,1,NO
10,src/contrib/loggraph/src/java/org/apache/zookeeper/graph/TxnLogSource.java,377,377,377.0,377,0,0.0,0,377,377.0,377,377,377.0,377,1,0,1,YES
10,src/contrib/loggraph/src/java/org/apache/zookeeper/graph/filterops/AndOp.java,33,33,33.0,33,0,0.0,0,33,33.0,33,33,33.0,33,1,0,1,NO
10,src/contrib/loggraph/src/java/org/apache/zookeeper/graph/filterops/Arg.java,36,36,36.0,36,0,0.0,0,36,36.0,36,36,36.0,36,1,0,1,NO
10,src/contrib/loggraph/src/java/org/apache/zookeeper/graph/filterops/EqualsOp.java,44,44,44.0,44,0,0.0,0,44,44.0,44,44,44.0,44,1,0,1,NO
10,src/contrib/loggraph/src/java/org/apache/zookeeper/graph/filterops/GreaterThanOp.java,70,70,70.0,70,0,0.0,0,70,70.0,70,70,70.0,70,1,0,1,NO
10,src/contrib/loggraph/src/java/org/apache/zookeeper/graph/filterops/LessThanOp.java,69,69,69.0,69,0,0.0,0,69,69.0,69,69,69.0,69,1,0,1,NO
10,src/contrib/loggraph/src/java/org/apache/zookeeper/graph/filterops/NotOp.java,31,31,31.0,31,0,0.0,0,31,31.0,31,31,31.0,31,1,0,1,NO
10,src/contrib/loggraph/src/java/org/apache/zookeeper/graph/filterops/NumberArg.java,27,28,28.0,28,0,0.0,0,28,28.0,28,28,28.0,28,1,0,1,NO
10,src/contrib/loggraph/src/java/org/apache/zookeeper/graph/filterops/OrOp.java,33,33,33.0,33,0,0.0,0,33,33.0,33,33,33.0,33,1,0,1,NO
10,src/contrib/loggraph/src/java/org/apache/zookeeper/graph/filterops/StringArg.java,27,28,28.0,28,0,0.0,0,28,28.0,28,28,28.0,28,1,0,1,NO
10,src/contrib/loggraph/src/java/org/apache/zookeeper/graph/filterops/SymbolArg.java,27,27,27.0,27,0,0.0,0,27,27.0,27,27,27.0,27,1,0,1,NO
10,src/contrib/loggraph/src/java/org/apache/zookeeper/graph/filterops/XorOp.java,40,40,40.0,40,0,0.0,0,40,40.0,40,40,40.0,40,1,0,1,NO
10,src/contrib/loggraph/src/java/org/apache/zookeeper/graph/servlets/FileLoader.java,60,60,60.0,60,0,0.0,0,60,60.0,60,60,60.0,60,1,0,1,NO
10,src/contrib/loggraph/src/java/org/apache/zookeeper/graph/servlets/Fs.java,69,69,69.0,69,0,0.0,0,69,69.0,69,69,69.0,69,1,0,1,NO
10,src/contrib/loggraph/src/java/org/apache/zookeeper/graph/servlets/GraphData.java,84,84,84.0,84,0,0.0,0,84,84.0,84,84,84.0,84,1,0,1,NO
10,src/contrib/loggraph/src/java/org/apache/zookeeper/graph/servlets/JsonServlet.java,85,85,85.0,85,0,0.0,0,85,85.0,85,85,85.0,85,1,0,1,NO
10,src/contrib/loggraph/src/java/org/apache/zookeeper/graph/servlets/NumEvents.java,85,86,86.0,86,0,0.0,0,86,86.0,86,86,86.0,86,1,0,1,NO
10,src/contrib/loggraph/src/java/org/apache/zookeeper/graph/servlets/StaticContent.java,50,50,50.0,50,0,0.0,0,50,50.0,50,50,50.0,50,1,0,1,NO
10,src/contrib/loggraph/src/java/org/apache/zookeeper/graph/servlets/Throughput.java,124,124,124.0,124,0,0.0,0,124,124.0,124,124,124.0,124,1,0,1,NO
10,src/contrib/rest/src/java/org/apache/zookeeper/server/jersey/RestMain.java,150,110,110.0,110,38,38.0,38,148,148.0,148,72,72.0,72,1,0,1,NO
10,src/contrib/rest/src/java/org/apache/zookeeper/server/jersey/ZooKeeperService.java,241,202,202.0,202,71,71.0,71,273,273.0,273,131,131.0,131,1,0,1,NO
10,src/contrib/rest/src/java/org/apache/zookeeper/server/jersey/cfg/Credentials.java,47,47,47.0,47,0,0.0,0,47,47.0,47,47,47.0,47,1,0,1,NO
10,src/contrib/rest/src/java/org/apache/zookeeper/server/jersey/cfg/Endpoint.java,72,72,72.0,72,0,0.0,0,72,72.0,72,72,72.0,72,1,0,1,NO
10,src/contrib/rest/src/java/org/apache/zookeeper/server/jersey/cfg/HostPort.java,51,51,51.0,51,0,0.0,0,51,51.0,51,51,51.0,51,1,0,1,NO
10,src/contrib/rest/src/java/org/apache/zookeeper/server/jersey/cfg/HostPortSet.java,51,51,51.0,51,0,0.0,0,51,51.0,51,51,51.0,51,1,0,1,NO
10,src/contrib/rest/src/java/org/apache/zookeeper/server/jersey/cfg/RestCfg.java,106,106,106.0,106,0,0.0,0,106,106.0,106,106,106.0,106,1,0,1,NO
10,src/contrib/rest/src/java/org/apache/zookeeper/server/jersey/filters/HTTPBasicAuth.java,87,87,87.0,87,0,0.0,0,87,87.0,87,87,87.0,87,1,0,1,NO
10,src/contrib/rest/src/java/org/apache/zookeeper/server/jersey/jaxb/ZChildren.java,80,0,0.0,0,0,0.0,0,0,0.0,0,0,0.0,0,0,0,0,NO
10,src/contrib/rest/src/java/org/apache/zookeeper/server/jersey/jaxb/ZChildrenJSON.java,76,0,0.0,0,0,0.0,0,0,0.0,0,0,0.0,0,0,0,0,NO
10,src/contrib/rest/src/java/org/apache/zookeeper/server/jersey/jaxb/ZError.java,41,0,0.0,0,0,0.0,0,0,0.0,0,0,0.0,0,0,0,0,NO
10,src/contrib/rest/src/java/org/apache/zookeeper/server/jersey/jaxb/ZPath.java,63,0,0.0,0,0,0.0,0,0,0.0,0,0,0.0,0,0,0,0,NO
10,src/contrib/rest/src/java/org/apache/zookeeper/server/jersey/jaxb/ZSession.java,55,55,55.0,55,0,0.0,0,55,55.0,55,55,55.0,55,1,0,1,NO
10,src/contrib/rest/src/java/org/apache/zookeeper/server/jersey/jaxb/ZStat.java,106,0,0.0,0,0,0.0,0,0,0.0,0,0,0.0,0,0,0,0,NO
10,src/contrib/rest/src/java/org/apache/zookeeper/server/jersey/resources/JAXBContextResolver.java,72,0,0.0,0,0,0.0,0,0,0.0,0,0,0.0,0,0,0,0,NO
10,src/contrib/rest/src/java/org/apache/zookeeper/server/jersey/resources/KeeperExceptionMapper.java,86,0,0.0,0,0,0.0,0,0,0.0,0,0,0.0,0,0,0,0,NO
10,src/contrib/rest/src/java/org/apache/zookeeper/server/jersey/resources/RuntimeExceptionMapper.java,55,0,0.0,0,0,0.0,0,0,0.0,0,0,0.0,0,0,0,0,NO
10,src/contrib/rest/src/java/org/apache/zookeeper/server/jersey/resources/SessionsResource.java,134,134,134.0,134,0,0.0,0,134,134.0,134,134,134.0,134,1,0,1,NO
10,src/contrib/rest/src/java/org/apache/zookeeper/server/jersey/resources/ZErrorWriter.java,63,0,0.0,0,0,0.0,0,0,0.0,0,0,0.0,0,0,0,0,NO
10,src/contrib/rest/src/java/org/apache/zookeeper/server/jersey/resources/ZNodeResource.java,412,99,99.0,99,96,96.0,96,195,195.0,195,3,3.0,3,1,0,1,NO
10,src/contrib/zooinspector/src/java/org/apache/zookeeper/inspector/ZooInspector.java,66,0,0.0,0,0,0.0,0,0,0.0,0,0,0.0,0,0,0,0,NO
10,src/contrib/zooinspector/src/java/org/apache/zookeeper/inspector/encryption/BasicDataEncryptionManager.java,50,0,0.0,0,0,0.0,0,0,0.0,0,0,0.0,0,0,0,0,NO
10,src/contrib/zooinspector/src/java/org/apache/zookeeper/inspector/encryption/DataEncryptionManager.java,39,0,0.0,0,0,0.0,0,0,0.0,0,0,0.0,0,0,0,0,NO
10,src/contrib/zooinspector/src/java/org/apache/zookeeper/inspector/gui/NodeViewersChangeListener.java,37,0,0.0,0,0,0.0,0,0,0.0,0,0,0.0,0,0,0,0,NO
10,src/contrib/zooinspector/src/java/org/apache/zookeeper/inspector/gui/ZooInspectorAboutDialog.java,80,0,0.0,0,0,0.0,0,0,0.0,0,0,0.0,0,0,0,0,NO
10,src/contrib/zooinspector/src/java/org/apache/zookeeper/inspector/gui/ZooInspectorConnectionPropertiesDialog.java,321,0,0.0,0,0,0.0,0,0,0.0,0,0,0.0,0,0,0,0,NO
10,src/contrib/zooinspector/src/java/org/apache/zookeeper/inspector/gui/ZooInspectorIconResources.java,118,0,0.0,0,0,0.0,0,0,0.0,0,0,0.0,0,0,0,0,NO
10,src/contrib/zooinspector/src/java/org/apache/zookeeper/inspector/gui/ZooInspectorNodeViewersDialog.java,605,0,0.0,0,0,0.0,0,0,0.0,0,0,0.0,0,0,0,0,NO
10,src/contrib/zooinspector/src/java/org/apache/zookeeper/inspector/gui/ZooInspectorNodeViewersPanel.java,140,0,0.0,0,0,0.0,0,0,0.0,0,0,0.0,0,0,0,0,NO
10,src/contrib/zooinspector/src/java/org/apache/zookeeper/inspector/gui/ZooInspectorPanel.java,361,0,0.0,0,0,0.0,0,0,0.0,0,0,0.0,0,0,0,0,NO
10,src/contrib/zooinspector/src/java/org/apache/zookeeper/inspector/gui/ZooInspectorTreeViewer.java,362,0,0.0,0,0,0.0,0,0,0.0,0,0,0.0,0,0,0,0,NO
10,src/contrib/zooinspector/src/java/org/apache/zookeeper/inspector/gui/nodeviewer/NodeViewerACL.java,187,0,0.0,0,0,0.0,0,0,0.0,0,0,0.0,0,0,0,0,NO
10,src/contrib/zooinspector/src/java/org/apache/zookeeper/inspector/gui/nodeviewer/NodeViewerData.java,146,0,0.0,0,0,0.0,0,0,0.0,0,0,0.0,0,0,0,0,NO
10,src/contrib/zooinspector/src/java/org/apache/zookeeper/inspector/gui/nodeviewer/NodeViewerMetaData.java,186,0,0.0,0,0,0.0,0,0,0.0,0,0,0.0,0,0,0,0,NO
10,src/contrib/zooinspector/src/java/org/apache/zookeeper/inspector/gui/nodeviewer/ZooInspectorNodeViewer.java,138,0,0.0,0,0,0.0,0,0,0.0,0,0,0.0,0,0,0,0,NO
10,src/contrib/zooinspector/src/java/org/apache/zookeeper/inspector/logger/LoggerFactory.java,38,0,0.0,0,0,0.0,0,0,0.0,0,0,0.0,0,0,0,0,NO
10,src/contrib/zooinspector/src/java/org/apache/zookeeper/inspector/manager/NodeListener.java,37,0,0.0,0,0,0.0,0,0,0.0,0,0,0.0,0,0,0,0,NO
10,src/contrib/zooinspector/src/java/org/apache/zookeeper/inspector/manager/Pair.java,120,0,0.0,0,0,0.0,0,0,0.0,0,0,0.0,0,0,0,0,NO
10,src/contrib/zooinspector/src/java/org/apache/zookeeper/inspector/manager/ZooInspectorManager.java,139,0,0.0,0,0,0.0,0,0,0.0,0,0,0.0,0,0,0,0,NO
10,src/contrib/zooinspector/src/java/org/apache/zookeeper/inspector/manager/ZooInspectorManagerImpl.java,852,0,0.0,0,0,0.0,0,0,0.0,0,0,0.0,0,0,0,0,NO
10,src/contrib/zooinspector/src/java/org/apache/zookeeper/inspector/manager/ZooInspectorNodeManager.java,33,0,0.0,0,0,0.0,0,0,0.0,0,0,0.0,0,0,0,0,NO
10,src/contrib/zooinspector/src/java/org/apache/zookeeper/inspector/manager/ZooInspectorNodeTreeManager.java,43,0,0.0,0,0,0.0,0,0,0.0,0,0,0.0,0,0,0,0,NO
10,src/contrib/zooinspector/src/java/org/apache/zookeeper/inspector/manager/ZooInspectorReadOnlyManager.java,99,0,0.0,0,0,0.0,0,0,0.0,0,0,0.0,0,0,0,0,NO
10,src/contrib/zooinspector/src/java/org/apache/zookeeper/retry/ZooKeeperRetry.java,288,0,0.0,0,0,0.0,0,0,0.0,0,0,0.0,0,0,0,0,NO
10,src/java/main/org/apache/jute/BinaryInputArchive.java,131,0,0.0,0,0,0.0,0,0,0.0,0,0,0.0,0,0,0,0,NO
10,src/java/main/org/apache/jute/BinaryOutputArchive.java,146,0,0.0,0,0,0.0,0,0,0.0,0,0,0.0,0,0,0,0,NO
10,src/java/main/org/apache/jute/CsvInputArchive.java,208,0,0.0,0,0,0.0,0,0,0.0,0,0,0.0,0,0,0,0,NO
10,src/java/main/org/apache/jute/CsvOutputArchive.java,150,0,0.0,0,0,0.0,0,0,0.0,0,0,0.0,0,0,0,0,NO
10,src/java/main/org/apache/jute/Index.java,38,0,0.0,0,0,0.0,0,0,0.0,0,0,0.0,0,0,0,0,NO
10,src/java/main/org/apache/jute/InputArchive.java,43,0,0.0,0,0,0.0,0,0,0.0,0,0,0.0,0,0,0,0,NO
10,src/java/main/org/apache/jute/OutputArchive.java,47,0,0.0,0,0,0.0,0,0,0.0,0,0,0.0,0,0,0,0,NO
10,src/java/main/org/apache/jute/Record.java,32,0,0.0,0,0,0.0,0,0,0.0,0,0,0.0,0,0,0,0,NO
10,src/java/main/org/apache/jute/RecordReader.java,93,0,0.0,0,0,0.0,0,0,0.0,0,0,0.0,0,0,0,0,NO
10,src/java/main/org/apache/jute/RecordWriter.java,113,0,0.0,0,0,0.0,0,0,0.0,0,0,0.0,0,0,0,0,NO
10,src/java/main/org/apache/jute/Utils.java,282,0,0.0,0,0,0.0,0,0,0.0,0,0,0.0,0,0,0,0,NO
10,src/java/main/org/apache/jute/XmlInputArchive.java,251,0,0.0,0,0,0.0,0,0,0.0,0,0,0.0,0,0,0,0,NO
10,src/java/main/org/apache/jute/XmlOutputArchive.java,251,0,0.0,0,0,0.0,0,0,0.0,0,0,0.0,0,0,0,0,NO
10,src/java/main/org/apache/jute/compiler/CGenerator.java,130,0,0.0,0,0,0.0,0,0,0.0,0,0,0.0,0,0,0,0,NO
10,src/java/main/org/apache/jute/compiler/CSharpGenerator.java,53,0,0.0,0,0,0.0,0,0,0.0,0,0,0.0,0,0,0,0,NO
10,src/java/main/org/apache/jute/compiler/CppGenerator.java,125,0,0.0,0,0,0.0,0,0,0.0,0,0,0.0,0,0,0,0,NO
10,src/java/main/org/apache/jute/compiler/JBoolean.java,50,0,0.0,0,0,0.0,0,0,0.0,0,0,0.0,0,0,0,0,NO
10,src/java/main/org/apache/jute/compiler/JBuffer.java,106,0,0.0,0,0,0.0,0,0,0.0,0,0,0.0,0,0,0,0,NO
10,src/java/main/org/apache/jute/compiler/JByte.java,34,0,0.0,0,0,0.0,0,0,0.0,0,0,0.0,0,0,0,0,NO
10,src/java/main/org/apache/jute/compiler/JCompType.java,66,0,0.0,0,0,0.0,0,0,0.0,0,0,0.0,0,0,0,0,NO
10,src/java/main/org/apache/jute/compiler/JDouble.java,40,0,0.0,0,0,0.0,0,0,0.0,0,0,0.0,0,0,0,0,NO
10,src/java/main/org/apache/jute/compiler/JField.java,140,0,0.0,0,0,0.0,0,0,0.0,0,0,0.0,0,0,0,0,NO
10,src/java/main/org/apache/jute/compiler/JFile.java,84,0,0.0,0,0,0.0,0,0,0.0,0,0,0.0,0,0,0,0,NO
10,src/java/main/org/apache/jute/compiler/JFloat.java,39,0,0.0,0,0,0.0,0,0,0.0,0,0,0.0,0,0,0,0,NO
10,src/java/main/org/apache/jute/compiler/JInt.java,34,0,0.0,0,0,0.0,0,0,0.0,0,0,0.0,0,0,0,0,NO
10,src/java/main/org/apache/jute/compiler/JLong.java,38,0,0.0,0,0,0.0,0,0,0.0,0,0,0.0,0,0,0,0,NO
10,src/java/main/org/apache/jute/compiler/JMap.java,149,0,0.0,0,0,0.0,0,0,0.0,0,0,0.0,0,0,0,0,NO
10,src/java/main/org/apache/jute/compiler/JRecord.java,762,0,0.0,0,0,0.0,0,0,0.0,0,0,0.0,0,0,0,0,NO
10,src/java/main/org/apache/jute/compiler/JString.java,46,0,0.0,0,0,0.0,0,0,0.0,0,0,0.0,0,0,0,0,NO
10,src/java/main/org/apache/jute/compiler/JType.java,204,0,0.0,0,0,0.0,0,0,0.0,0,0,0.0,0,0,0,0,NO
10,src/java/main/org/apache/jute/compiler/JVector.java,153,0,0.0,0,0,0.0,0,0,0.0,0,0,0.0,0,0,0,0,NO
10,src/java/main/org/apache/jute/compiler/JavaGenerator.java,57,0,0.0,0,0,0.0,0,0,0.0,0,0,0.0,0,0,0,0,NO
10,src/java/main/org/apache/jute/compiler/generated/ParseException.java,210,0,0.0,0,0,0.0,0,0,0.0,0,0,0.0,0,0,0,0,NO
10,src/java/main/org/apache/jute/compiler/generated/Rcc.java,525,0,0.0,0,0,0.0,0,0,0.0,0,0,0.0,0,0,0,0,NO
10,src/java/main/org/apache/jute/compiler/generated/RccConstants.java,88,0,0.0,0,0,0.0,0,0,0.0,0,0,0.0,0,0,0,0,NO
10,src/java/main/org/apache/jute/compiler/generated/RccTokenManager.java,833,0,0.0,0,0,0.0,0,0,0.0,0,0,0.0,0,0,0,0,NO
10,src/java/main/org/apache/jute/compiler/generated/SimpleCharStream.java,457,0,0.0,0,0,0.0,0,0,0.0,0,0,0.0,0,0,0,0,NO
10,src/java/main/org/apache/jute/compiler/generated/Token.java,99,0,0.0,0,0,0.0,0,0,0.0,0,0,0.0,0,0,0,0,NO
10,src/java/main/org/apache/jute/compiler/generated/TokenMgrError.java,151,0,0.0,0,0,0.0,0,0,0.0,0,0,0.0,0,0,0,0,NO
10,src/java/main/org/apache/zookeeper/AsyncCallback.java,57,0,0.0,0,0,0.0,0,0,0.0,0,0,0.0,0,0,0,0,NO
10,src/java/main/org/apache/zookeeper/ClientCnxn.java,1143,347,57.833332,347,524,87.333336,524,871,145.16667,871,289,48.166668,289,6,4,2,YES
10,src/java/main/org/apache/zookeeper/ClientCnxnSocket.java,154,154,154.0,154,0,0.0,0,154,154.0,154,154,154.0,154,1,0,1,NO
10,src/java/main/org/apache/zookeeper/ClientCnxnSocketNIO.java,318,318,318.0,318,0,0.0,0,318,318.0,318,318,318.0,318,1,0,1,YES
10,src/java/main/org/apache/zookeeper/ClientWatchManager.java,39,0,0.0,0,0,0.0,0,0,0.0,0,0,0.0,0,0,0,0,NO
10,src/java/main/org/apache/zookeeper/CreateMode.java,89,0,0.0,0,0,0.0,0,0,0.0,0,0,0.0,0,0,0,0,NO
10,src/java/main/org/apache/zookeeper/Environment.java,100,0,0.0,0,0,0.0,0,0,0.0,0,0,0.0,0,0,0,0,NO
10,src/java/main/org/apache/zookeeper/JLineZNodeCompletor.java,84,0,0.0,0,0,0.0,0,0,0.0,0,0,0.0,0,0,0,0,NO
10,src/java/main/org/apache/zookeeper/KeeperException.java,662,0,0.0,0,0,0.0,0,0,0.0,0,0,0.0,0,0,0,0,NO
10,src/java/main/org/apache/zookeeper/Quotas.java,68,0,0.0,0,0,0.0,0,0,0.0,0,0,0.0,0,0,0,0,NO
10,src/java/main/org/apache/zookeeper/ServerAdminClient.java,312,0,0.0,0,0,0.0,0,0,0.0,0,0,0.0,0,0,0,0,NO
10,src/java/main/org/apache/zookeeper/StatsTrack.java,101,0,0.0,0,0,0.0,0,0,0.0,0,0,0.0,0,0,0,0,NO
10,src/java/main/org/apache/zookeeper/Version.java,78,0,0.0,0,0,0.0,0,0,0.0,0,0,0.0,0,0,0,0,YES
10,src/java/main/org/apache/zookeeper/WatchedEvent.java,79,0,0.0,0,0,0.0,0,0,0.0,0,0,0.0,0,0,0,0,NO
10,src/java/main/org/apache/zookeeper/Watcher.java,132,8,8.0,8,1,1.0,1,9,9.0,9,7,7.0,7,1,1,1,NO
10,src/java/main/org/apache/zookeeper/ZooDefs.java,113,0,0.0,0,0,0.0,0,0,0.0,0,0,0.0,0,0,0,0,NO
10,src/java/main/org/apache/zookeeper/ZooKeeper.java,1653,28,14.0,28,10,5.0,10,38,19.0,38,18,9.0,18,2,0,1,YES
10,src/java/main/org/apache/zookeeper/ZooKeeperMain.java,840,4,2.0,4,1,0.5,1,5,2.5,5,3,1.5,3,2,1,2,YES
10,src/java/main/org/apache/zookeeper/common/PathTrie.java,283,0,0.0,0,0,0.0,0,0,0.0,0,0,0.0,0,0,0,0,NO
10,src/java/main/org/apache/zookeeper/common/PathUtils.java,103,0,0.0,0,0,0.0,0,0,0.0,0,0,0.0,0,0,0,0,NO
10,src/java/main/org/apache/zookeeper/jmx/CommonNames.java,29,0,0.0,0,0,0.0,0,0,0.0,0,0,0.0,0,0,0,0,NO
10,src/java/main/org/apache/zookeeper/jmx/MBeanRegistry.java,194,0,0.0,0,0,0.0,0,0,0.0,0,0,0.0,0,0,0,0,NO
10,src/java/main/org/apache/zookeeper/jmx/ManagedUtil.java,72,0,0.0,0,0,0.0,0,0,0.0,0,0,0.0,0,0,0,0,NO
10,src/java/main/org/apache/zookeeper/jmx/ZKMBeanInfo.java,36,0,0.0,0,0,0.0,0,0,0.0,0,0,0.0,0,0,0,0,NO
10,src/java/main/org/apache/zookeeper/server/ByteBufferInputStream.java,72,0,0.0,0,0,0.0,0,0,0.0,0,0,0.0,0,0,0,0,YES
10,src/java/main/org/apache/zookeeper/server/ConnectionBean.java,172,6,6.0,6,7,7.0,7,13,13.0,13,1,1.0,1,1,0,1,NO
10,src/java/main/org/apache/zookeeper/server/ConnectionMXBean.java,98,0,0.0,0,0,0.0,0,0,0.0,0,0,0.0,0,0,0,0,NO
10,src/java/main/org/apache/zookeeper/server/DataNode.java,170,0,0.0,0,0,0.0,0,0,0.0,0,0,0.0,0,0,0,0,YES
10,src/java/main/org/apache/zookeeper/server/DataTree.java,1194,9,9.0,9,0,0.0,0,9,9.0,9,9,9.0,9,1,0,1,YES
10,src/java/main/org/apache/zookeeper/server/DataTreeBean.java,61,1,1.0,1,10,10.0,10,11,11.0,11,9,9.0,9,1,0,1,NO
10,src/java/main/org/apache/zookeeper/server/DataTreeMXBean.java,47,0,0.0,0,0,0.0,0,0,0.0,0,0,0.0,0,0,0,0,NO
10,src/java/main/org/apache/zookeeper/server/FinalRequestProcessor.java,376,5,5.0,5,10,10.0,10,15,15.0,15,5,5.0,5,1,0,1,YES
10,src/java/main/org/apache/zookeeper/server/LogFormatter.java,107,0,0.0,0,0,0.0,0,0,0.0,0,0,0.0,0,0,0,0,YES
10,src/java/main/org/apache/zookeeper/server/NIOServerCnxn.java,1123,199,66.333336,199,893,297.66666,893,1092,364.0,1092,860,286.66666,860,3,1,2,YES
10,src/java/main/org/apache/zookeeper/server/NIOServerCnxnFactory.java,306,306,306.0,306,0,0.0,0,306,306.0,306,306,306.0,306,1,0,1,NO
10,src/java/main/org/apache/zookeeper/server/NettyServerCnxn.java,820,820,820.0,820,0,0.0,0,820,820.0,820,820,820.0,820,1,0,1,NO
10,src/java/main/org/apache/zookeeper/server/NettyServerCnxnFactory.java,396,398,199.0,398,2,1.0,2,400,200.0,400,396,198.0,396,2,0,1,NO
10,src/java/main/org/apache/zookeeper/server/ObserverBean.java,45,0,0.0,0,0,0.0,0,0,0.0,0,0,0.0,0,0,0,0,NO
10,src/java/main/org/apache/zookeeper/server/PrepRequestProcessor.java,516,9,4.5,9,5,2.5,5,14,7.0,14,4,2.0,4,2,1,2,YES
10,src/java/main/org/apache/zookeeper/server/PurgeTxnLog.java,132,0,0.0,0,0,0.0,0,0,0.0,0,0,0.0,0,0,0,0,NO
10,src/java/main/org/apache/zookeeper/server/Request.java,232,0,0.0,0,0,0.0,0,0,0.0,0,0,0.0,0,0,0,0,YES
10,src/java/main/org/apache/zookeeper/server/RequestProcessor.java,37,0,0.0,0,0,0.0,0,0,0.0,0,0,0.0,0,0,0,0,NO
10,src/java/main/org/apache/zookeeper/server/ServerCnxn.java,432,383,383.0,383,59,59.0,59,442,442.0,442,324,324.0,324,1,0,1,NO
10,src/java/main/org/apache/zookeeper/server/ServerCnxnFactory.java,134,134,134.0,134,0,0.0,0,134,134.0,134,134,134.0,134,1,0,1,NO
10,src/java/main/org/apache/zookeeper/server/ServerConfig.java,111,0,0.0,0,0,0.0,0,0,0.0,0,0,0.0,0,0,0,0,NO
10,src/java/main/org/apache/zookeeper/server/ServerStats.java,132,0,0.0,0,0,0.0,0,0,0.0,0,0,0.0,0,0,0,0,NO
10,src/java/main/org/apache/zookeeper/server/SessionTracker.java,74,0,0.0,0,0,0.0,0,0,0.0,0,0,0.0,0,0,0,0,NO
10,src/java/main/org/apache/zookeeper/server/SessionTrackerImpl.java,259,2,2.0,2,0,0.0,0,2,2.0,2,2,2.0,2,1,0,1,NO
10,src/java/main/org/apache/zookeeper/server/Stats.java,68,68,68.0,68,0,0.0,0,68,68.0,68,68,68.0,68,1,0,1,NO
10,src/java/main/org/apache/zookeeper/server/SyncRequestProcessor.java,184,1,1.0,1,0,0.0,0,1,1.0,1,1,1.0,1,1,0,1,YES
10,src/java/main/org/apache/zookeeper/server/TraceFormatter.java,121,0,0.0,0,0,0.0,0,0,0.0,0,0,0.0,0,0,0,0,NO
10,src/java/main/org/apache/zookeeper/server/WatchManager.java,170,5,5.0,5,1,1.0,1,6,6.0,6,4,4.0,4,1,0,1,NO
10,src/java/main/org/apache/zookeeper/server/ZKDatabase.java,465,6,6.0,6,2,2.0,2,8,8.0,8,4,4.0,4,1,1,1,YES
10,src/java/main/org/apache/zookeeper/server/ZooKeeperServer.java,865,188,62.666668,188,25,8.333333,25,213,71.0,213,165,55.0,165,3,2,3,YES
10,src/java/main/org/apache/zookeeper/server/ZooKeeperServerBean.java,143,3,3.0,3,3,3.0,3,6,6.0,6,0,0.0,0,1,0,1,NO
10,src/java/main/org/apache/zookeeper/server/ZooKeeperServerMXBean.java,106,0,0.0,0,0,0.0,0,0,0.0,0,0,0.0,0,0,0,0,NO
10,src/java/main/org/apache/zookeeper/server/ZooKeeperServerMain.java,128,3,3.0,3,2,2.0,2,5,5.0,5,1,1.0,1,1,0,1,NO
10,src/java/main/org/apache/zookeeper/server/ZooTrace.java,92,0,0.0,0,0,0.0,0,0,0.0,0,0,0.0,0,0,0,0,NO
10,src/java/main/org/apache/zookeeper/server/auth/AuthenticationProvider.java,82,0,0.0,0,0,0.0,0,0,0.0,0,0,0.0,0,0,0,0,NO
10,src/java/main/org/apache/zookeeper/server/auth/DigestAuthenticationProvider.java,138,2,2.0,2,2,2.0,2,4,4.0,4,0,0.0,0,1,0,1,NO
10,src/java/main/org/apache/zookeeper/server/auth/IPAuthenticationProvider.java,117,3,3.0,3,3,3.0,3,6,6.0,6,0,0.0,0,1,0,1,NO
10,src/java/main/org/apache/zookeeper/server/auth/ProviderRegistry.java,76,0,0.0,0,0,0.0,0,0,0.0,0,0,0.0,0,0,0,0,NO
10,src/java/main/org/apache/zookeeper/server/persistence/FileSnap.java,249,0,0.0,0,0,0.0,0,0,0.0,0,0,0.0,0,0,0,0,NO
10,src/java/main/org/apache/zookeeper/server/persistence/FileTxnLog.java,609,6,6.0,6,1,1.0,1,7,7.0,7,5,5.0,5,1,1,1,YES
10,src/java/main/org/apache/zookeeper/server/persistence/FileTxnSnapLog.java,296,0,0.0,0,0,0.0,0,0,0.0,0,0,0.0,0,0,0,0,YES
10,src/java/main/org/apache/zookeeper/server/persistence/SnapShot.java,66,0,0.0,0,0,0.0,0,0,0.0,0,0,0.0,0,0,0,0,NO
10,src/java/main/org/apache/zookeeper/server/persistence/TxnLog.java,120,0,0.0,0,0,0.0,0,0,0.0,0,0,0.0,0,0,0,0,NO
10,src/java/main/org/apache/zookeeper/server/persistence/Util.java,325,0,0.0,0,0,0.0,0,0,0.0,0,0,0.0,0,0,0,0,NO
10,src/java/main/org/apache/zookeeper/server/quorum/AckRequestProcessor.java,53,0,0.0,0,0,0.0,0,0,0.0,0,0,0.0,0,0,0,0,NO
10,src/java/main/org/apache/zookeeper/server/quorum/AuthFastLeaderElection.java,968,0,0.0,0,0,0.0,0,0,0.0,0,0,0.0,0,0,0,0,NO
10,src/java/main/org/apache/zookeeper/server/quorum/CommitProcessor.java,190,1,1.0,1,0,0.0,0,1,1.0,1,1,1.0,1,1,0,1,YES
10,src/java/main/org/apache/zookeeper/server/quorum/Election.java,27,0,0.0,0,0,0.0,0,0,0.0,0,0,0.0,0,0,0,0,NO
10,src/java/main/org/apache/zookeeper/server/quorum/FastLeaderElection.java,842,280,140.0,280,275,137.5,275,555,277.5,555,5,2.5,5,2,0,1,YES
10,src/java/main/org/apache/zookeeper/server/quorum/Follower.java,168,4,4.0,4,5,5.0,5,9,9.0,9,1,1.0,1,1,0,1,YES
10,src/java/main/org/apache/zookeeper/server/quorum/FollowerBean.java,50,0,0.0,0,0,0.0,0,0,0.0,0,0,0.0,0,0,0,0,NO
10,src/java/main/org/apache/zookeeper/server/quorum/FollowerMXBean.java,41,0,0.0,0,0,0.0,0,0,0.0,0,0,0.0,0,0,0,0,NO
10,src/java/main/org/apache/zookeeper/server/quorum/FollowerRequestProcessor.java,110,1,1.0,1,0,0.0,0,1,1.0,1,1,1.0,1,1,0,1,YES
10,src/java/main/org/apache/zookeeper/server/quorum/FollowerZooKeeperServer.java,163,2,2.0,2,1,1.0,1,3,3.0,3,1,1.0,1,1,0,1,NO
10,src/java/main/org/apache/zookeeper/server/quorum/Leader.java,736,29,9.666667,29,11,3.6666667,11,40,13.333333,40,20,6.6666665,20,3,2,3,YES
10,src/java/main/org/apache/zookeeper/server/quorum/LeaderBean.java,53,0,0.0,0,0,0.0,0,0,0.0,0,0,0.0,0,0,0,0,NO
10,src/java/main/org/apache/zookeeper/server/quorum/LeaderElection.java,274,0,0.0,0,0,0.0,0,0,0.0,0,0,0.0,0,0,0,0,NO
10,src/java/main/org/apache/zookeeper/server/quorum/LeaderElectionBean.java,42,0,0.0,0,0,0.0,0,0,0.0,0,0,0.0,0,0,0,0,NO
10,src/java/main/org/apache/zookeeper/server/quorum/LeaderElectionMXBean.java,31,0,0.0,0,0,0.0,0,0,0.0,0,0,0.0,0,0,0,0,NO
10,src/java/main/org/apache/zookeeper/server/quorum/LeaderMXBean.java,36,0,0.0,0,0,0.0,0,0,0.0,0,0,0.0,0,0,0,0,NO
10,src/java/main/org/apache/zookeeper/server/quorum/LeaderZooKeeperServer.java,176,1,1.0,1,1,1.0,1,2,2.0,2,0,0.0,0,1,0,1,NO
10,src/java/main/org/apache/zookeeper/server/quorum/Learner.java,377,6,3.0,6,4,2.0,4,10,5.0,10,4,2.0,4,2,1,2,YES
10,src/java/main/org/apache/zookeeper/server/quorum/LearnerHandler.java,529,29,14.5,29,6,3.0,6,35,17.5,35,23,11.5,23,2,2,2,YES
10,src/java/main/org/apache/zookeeper/server/quorum/LearnerSessionTracker.java,92,0,0.0,0,0,0.0,0,0,0.0,0,0,0.0,0,0,0,0,NO
10,src/java/main/org/apache/zookeeper/server/quorum/LearnerSyncRequest.java,34,0,0.0,0,0,0.0,0,0,0.0,0,0,0.0,0,0,0,0,NO
10,src/java/main/org/apache/zookeeper/server/quorum/LearnerZooKeeperServer.java,142,1,1.0,1,1,1.0,1,2,2.0,2,0,0.0,0,1,0,1,NO
10,src/java/main/org/apache/zookeeper/server/quorum/LocalPeerBean.java,79,1,1.0,1,7,7.0,7,8,8.0,8,6,6.0,6,1,0,1,NO
10,src/java/main/org/apache/zookeeper/server/quorum/LocalPeerMXBean.java,77,0,0.0,0,0,0.0,0,0,0.0,0,0,0.0,0,0,0,0,NO
10,src/java/main/org/apache/zookeeper/server/quorum/Observer.java,146,0,0.0,0,0,0.0,0,0,0.0,0,0,0.0,0,0,0,0,YES
10,src/java/main/org/apache/zookeeper/server/quorum/ObserverMXBean.java,37,0,0.0,0,0,0.0,0,0,0.0,0,0,0.0,0,0,0,0,NO
10,src/java/main/org/apache/zookeeper/server/quorum/ObserverRequestProcessor.java,124,1,1.0,1,0,0.0,0,1,1.0,1,1,1.0,1,1,0,1,YES
10,src/java/main/org/apache/zookeeper/server/quorum/ObserverZooKeeperServer.java,116,0,0.0,0,0,0.0,0,0,0.0,0,0,0.0,0,0,0,0,NO
10,src/java/main/org/apache/zookeeper/server/quorum/ProposalRequestProcessor.java,88,6,6.0,6,0,0.0,0,6,6.0,6,6,6.0,6,1,0,1,NO
10,src/java/main/org/apache/zookeeper/server/quorum/QuorumBean.java,44,0,0.0,0,0,0.0,0,0,0.0,0,0,0.0,0,0,0,0,NO
10,src/java/main/org/apache/zookeeper/server/quorum/QuorumCnxManager.java,715,84,28.0,84,37,12.333333,37,121,40.333332,121,47,15.666667,47,3,2,1,YES
10,src/java/main/org/apache/zookeeper/server/quorum/QuorumMXBean.java,34,0,0.0,0,0,0.0,0,0,0.0,0,0,0.0,0,0,0,0,NO
10,src/java/main/org/apache/zookeeper/server/quorum/QuorumPeer.java,960,23,23.0,23,20,20.0,20,43,43.0,43,3,3.0,3,1,0,1,YES
10,src/java/main/org/apache/zookeeper/server/quorum/QuorumPeerConfig.java,381,43,10.75,43,6,1.5,6,49,12.25,49,37,9.25,37,4,2,3,NO
10,src/java/main/org/apache/zookeeper/server/quorum/QuorumPeerMain.java,150,4,4.0,4,4,4.0,4,8,8.0,8,0,0.0,0,1,0,1,NO
10,src/java/main/org/apache/zookeeper/server/quorum/QuorumStats.java,68,0,0.0,0,0,0.0,0,0,0.0,0,0,0.0,0,0,0,0,NO
10,src/java/main/org/apache/zookeeper/server/quorum/QuorumZooKeeperServer.java,62,0,0.0,0,0,0.0,0,0,0.0,0,0,0.0,0,0,0,0,NO
10,src/java/main/org/apache/zookeeper/server/quorum/RemotePeerBean.java,45,0,0.0,0,0,0.0,0,0,0.0,0,0,0.0,0,0,0,0,NO
10,src/java/main/org/apache/zookeeper/server/quorum/RemotePeerMXBean.java,33,0,0.0,0,0,0.0,0,0,0.0,0,0,0.0,0,0,0,0,NO
10,src/java/main/org/apache/zookeeper/server/quorum/SendAckRequestProcessor.java,79,0,0.0,0,0,0.0,0,0,0.0,0,0,0.0,0,0,0,0,NO
10,src/java/main/org/apache/zookeeper/server/quorum/ServerBean.java,38,0,0.0,0,0,0.0,0,0,0.0,0,0,0.0,0,0,0,0,NO
10,src/java/main/org/apache/zookeeper/server/quorum/ServerMXBean.java,33,0,0.0,0,0,0.0,0,0,0.0,0,0,0.0,0,0,0,0,NO
10,src/java/main/org/apache/zookeeper/server/quorum/Vote.java,69,0,0.0,0,0,0.0,0,0,0.0,0,0,0.0,0,0,0,0,YES
10,src/java/main/org/apache/zookeeper/server/quorum/flexible/QuorumHierarchical.java,272,0,0.0,0,0,0.0,0,0,0.0,0,0,0.0,0,0,0,0,NO
10,src/java/main/org/apache/zookeeper/server/quorum/flexible/QuorumMaj.java,57,0,0.0,0,0,0.0,0,0,0.0,0,0,0.0,0,0,0,0,NO
10,src/java/main/org/apache/zookeeper/server/quorum/flexible/QuorumVerifier.java,33,0,0.0,0,0,0.0,0,0,0.0,0,0,0.0,0,0,0,0,NO
10,src/java/main/org/apache/zookeeper/server/upgrade/DataNodeV1.java,129,0,0.0,0,0,0.0,0,0,0.0,0,0,0.0,0,0,0,0,NO
10,src/java/main/org/apache/zookeeper/server/upgrade/DataTreeV1.java,583,0,0.0,0,0,0.0,0,0,0.0,0,0,0.0,0,0,0,0,NO
10,src/java/main/org/apache/zookeeper/server/upgrade/UpgradeMain.java,180,0,0.0,0,0,0.0,0,0,0.0,0,0,0.0,0,0,0,0,NO
10,src/java/main/org/apache/zookeeper/server/upgrade/UpgradeSnapShot.java,33,0,0.0,0,0,0.0,0,0,0.0,0,0,0.0,0,0,0,0,NO
10,src/java/main/org/apache/zookeeper/server/upgrade/UpgradeSnapShotV1.java,333,0,0.0,0,0,0.0,0,0,0.0,0,0,0.0,0,0,0,0,YES
10,src/java/main/org/apache/zookeeper/server/util/Profiler.java,40,0,0.0,0,0,0.0,0,0,0.0,0,0,0.0,0,0,0,0,NO
10,src/java/main/org/apache/zookeeper/server/util/SerializeUtils.java,107,0,0.0,0,0,0.0,0,0,0.0,0,0,0.0,0,0,0,0,YES
10,src/java/main/org/apache/zookeeper/version/util/VerGen.java,146,0,0.0,0,0,0.0,0,0,0.0,0,0,0.0,0,0,0,0,YES
10,src/recipes/lock/src/java/org/apache/zookeeper/recipes/lock/LockListener.java,38,0,0.0,0,0,0.0,0,0,0.0,0,0,0.0,0,0,0,0,NO
10,src/recipes/lock/src/java/org/apache/zookeeper/recipes/lock/ProtocolSupport.java,192,0,0.0,0,0,0.0,0,0,0.0,0,0,0.0,0,0,0,0,NO
10,src/recipes/lock/src/java/org/apache/zookeeper/recipes/lock/WriteLock.java,294,0,0.0,0,0,0.0,0,0,0.0,0,0,0.0,0,0,0,0,NO
10,src/recipes/lock/src/java/org/apache/zookeeper/recipes/lock/ZNodeName.java,109,0,0.0,0,0,0.0,0,0,0.0,0,0,0.0,0,0,0,0,NO
10,src/recipes/lock/src/java/org/apache/zookeeper/recipes/lock/ZooKeeperOperation.java,38,0,0.0,0,0,0.0,0,0,0.0,0,0,0.0,0,0,0,0,NO
10,src/recipes/queue/src/java/org/apache/zookeeper/recipes/queue/DistributedQueue.java,312,0,0.0,0,0,0.0,0,0,0.0,0,0,0.0,0,0,0,0,NO
11,src/contrib/bookkeeper/benchmark/org/apache/bookkeeper/benchmark/MySqlClient.java,137,0,0.0,0,0,0.0,0,0,0.0,0,0,0.0,0,0,0,0,NO
11,src/contrib/bookkeeper/benchmark/org/apache/bookkeeper/benchmark/TestClient.java,252,0,0.0,0,0,0.0,0,0,0.0,0,0,0.0,0,0,0,0,NO
11,src/contrib/bookkeeper/src/java/org/apache/bookkeeper/bookie/Bookie.java,545,9,9.0,9,0,0.0,0,9,9.0,9,9,9.0,9,1,1,1,NO
11,src/contrib/bookkeeper/src/java/org/apache/bookkeeper/bookie/BookieException.java,81,0,0.0,0,0,0.0,0,0,0.0,0,0,0.0,0,0,0,0,NO
11,src/contrib/bookkeeper/src/java/org/apache/bookkeeper/bookie/BufferedChannel.java,168,0,0.0,0,0,0.0,0,0,0.0,0,0,0.0,0,0,0,0,NO
11,src/contrib/bookkeeper/src/java/org/apache/bookkeeper/bookie/EntryLogger.java,487,0,0.0,0,0,0.0,0,0,0.0,0,0,0.0,0,0,0,0,NO
11,src/contrib/bookkeeper/src/java/org/apache/bookkeeper/bookie/FileInfo.java,124,0,0.0,0,0,0.0,0,0,0.0,0,0,0.0,0,0,0,0,NO
11,src/contrib/bookkeeper/src/java/org/apache/bookkeeper/bookie/LedgerCache.java,536,0,0.0,0,0,0.0,0,0,0.0,0,0,0.0,0,0,0,0,NO
11,src/contrib/bookkeeper/src/java/org/apache/bookkeeper/bookie/LedgerDescriptor.java,133,0,0.0,0,0,0.0,0,0,0.0,0,0,0.0,0,0,0,0,NO
11,src/contrib/bookkeeper/src/java/org/apache/bookkeeper/bookie/LedgerEntryPage.java,151,0,0.0,0,0,0.0,0,0,0.0,0,0,0.0,0,0,0,0,NO
11,src/contrib/bookkeeper/src/java/org/apache/bookkeeper/bookie/MarkerFileChannel.java,147,0,0.0,0,0,0.0,0,0,0.0,0,0,0.0,0,0,0,0,NO
11,src/contrib/bookkeeper/src/java/org/apache/bookkeeper/client/AsyncCallback.java,126,0,0.0,0,0,0.0,0,0,0.0,0,0,0.0,0,0,0,0,NO
11,src/contrib/bookkeeper/src/java/org/apache/bookkeeper/client/BKException.java,249,11,11.0,11,0,0.0,0,11,11.0,11,11,11.0,11,1,0,1,NO
11,src/contrib/bookkeeper/src/java/org/apache/bookkeeper/client/BookKeeper.java,410,0,0.0,0,0,0.0,0,0,0.0,0,0,0.0,0,0,0,0,NO
11,src/contrib/bookkeeper/src/java/org/apache/bookkeeper/client/BookieWatcher.java,204,0,0.0,0,0,0.0,0,0,0.0,0,0,0.0,0,0,0,0,NO
11,src/contrib/bookkeeper/src/java/org/apache/bookkeeper/client/CRC32DigestManager.java,50,0,0.0,0,0,0.0,0,0,0.0,0,0,0.0,0,0,0,0,NO
11,src/contrib/bookkeeper/src/java/org/apache/bookkeeper/client/DigestManager.java,184,32,32.0,32,10,10.0,10,42,42.0,42,22,22.0,22,1,0,1,NO
11,src/contrib/bookkeeper/src/java/org/apache/bookkeeper/client/DistributionSchedule.java,61,0,0.0,0,0,0.0,0,0,0.0,0,0,0.0,0,0,0,0,NO
11,src/contrib/bookkeeper/src/java/org/apache/bookkeeper/client/LedgerCreateOp.java,167,0,0.0,0,0,0.0,0,0,0.0,0,0,0.0,0,0,0,0,NO
11,src/contrib/bookkeeper/src/java/org/apache/bookkeeper/client/LedgerDeleteOp.java,80,0,0.0,0,0,0.0,0,0,0.0,0,0,0.0,0,0,0,0,NO
11,src/contrib/bookkeeper/src/java/org/apache/bookkeeper/client/LedgerEntry.java,83,5,5.0,5,0,0.0,0,5,5.0,5,5,5.0,5,1,0,1,NO
11,src/contrib/bookkeeper/src/java/org/apache/bookkeeper/client/LedgerHandle.java,547,41,20.5,41,6,3.0,6,47,23.5,47,35,17.5,35,2,0,2,NO
11,src/contrib/bookkeeper/src/java/org/apache/bookkeeper/client/LedgerMetadata.java,198,13,13.0,13,5,5.0,5,18,18.0,18,8,8.0,8,1,0,1,NO
11,src/contrib/bookkeeper/src/java/org/apache/bookkeeper/client/LedgerOpenOp.java,140,0,0.0,0,0,0.0,0,0,0.0,0,0,0.0,0,0,0,0,NO
11,src/contrib/bookkeeper/src/java/org/apache/bookkeeper/client/LedgerRecoveryOp.java,178,18,9.0,18,16,8.0,16,34,17.0,34,22,11.0,22,2,0,2,NO
11,src/contrib/bookkeeper/src/java/org/apache/bookkeeper/client/MacDigestManager.java,67,0,0.0,0,0,0.0,0,0,0.0,0,0,0.0,0,0,0,0,NO
11,src/contrib/bookkeeper/src/java/org/apache/bookkeeper/client/PendingAddOp.java,138,0,0.0,0,0,0.0,0,0,0.0,0,0,0.0,0,0,0,0,NO
11,src/contrib/bookkeeper/src/java/org/apache/bookkeeper/client/PendingReadOp.java,170,10,10.0,10,1,1.0,1,11,11.0,11,9,9.0,9,1,0,1,NO
11,src/contrib/bookkeeper/src/java/org/apache/bookkeeper/client/RoundRobinDistributionSchedule.java,87,0,0.0,0,0,0.0,0,0,0.0,0,0,0.0,0,0,0,0,NO
11,src/contrib/bookkeeper/src/java/org/apache/bookkeeper/client/SyncCounter.java,85,0,0.0,0,0,0.0,0,0,0.0,0,0,0.0,0,0,0,0,NO
11,src/contrib/bookkeeper/src/java/org/apache/bookkeeper/proto/BookieClient.java,178,0,0.0,0,0,0.0,0,0,0.0,0,0,0.0,0,0,0,0,NO
11,src/contrib/bookkeeper/src/java/org/apache/bookkeeper/proto/BookieProtocol.java,75,0,0.0,0,0,0.0,0,0,0.0,0,0,0.0,0,0,0,0,NO
11,src/contrib/bookkeeper/src/java/org/apache/bookkeeper/proto/BookieServer.java,209,5,5.0,5,4,4.0,4,9,9.0,9,1,1.0,1,1,1,1,NO
11,src/contrib/bookkeeper/src/java/org/apache/bookkeeper/proto/BookkeeperInternalCallbacks.java,57,0,0.0,0,0,0.0,0,0,0.0,0,0,0.0,0,0,0,0,NO
11,src/contrib/bookkeeper/src/java/org/apache/bookkeeper/proto/NIOServerFactory.java,521,4,4.0,4,0,0.0,0,4,4.0,4,4,4.0,4,1,1,1,NO
11,src/contrib/bookkeeper/src/java/org/apache/bookkeeper/proto/PerChannelBookieClient.java,573,0,0.0,0,0,0.0,0,0,0.0,0,0,0.0,0,0,0,0,NO
11,src/contrib/bookkeeper/src/java/org/apache/bookkeeper/proto/ServerStats.java,148,0,0.0,0,0,0.0,0,0,0.0,0,0,0.0,0,0,0,0,NO
11,src/contrib/bookkeeper/src/java/org/apache/bookkeeper/streaming/LedgerInputStream.java,173,0,0.0,0,0,0.0,0,0,0.0,0,0,0.0,0,0,0,0,NO
11,src/contrib/bookkeeper/src/java/org/apache/bookkeeper/streaming/LedgerOutputStream.java,147,0,0.0,0,0,0.0,0,0,0.0,0,0,0.0,0,0,0,0,NO
11,src/contrib/bookkeeper/src/java/org/apache/bookkeeper/tools/BookKeeperTools.java,763,2,2.0,2,1,1.0,1,3,3.0,3,1,1.0,1,1,0,1,NO
11,src/contrib/bookkeeper/src/java/org/apache/bookkeeper/util/LocalBookKeeper.java,209,0,0.0,0,0,0.0,0,0,0.0,0,0,0.0,0,0,0,0,NO
11,src/contrib/bookkeeper/src/java/org/apache/bookkeeper/util/Main.java,54,0,0.0,0,0,0.0,0,0,0.0,0,0,0.0,0,0,0,0,NO
11,src/contrib/bookkeeper/src/java/org/apache/bookkeeper/util/MathUtils.java,38,0,0.0,0,0,0.0,0,0,0.0,0,0,0.0,0,0,0,0,NO
11,src/contrib/bookkeeper/src/java/org/apache/bookkeeper/util/OrderedSafeExecutor.java,98,0,0.0,0,0,0.0,0,0,0.0,0,0,0.0,0,0,0,0,NO
11,src/contrib/bookkeeper/src/java/org/apache/bookkeeper/util/SafeRunnable.java,38,0,0.0,0,0,0.0,0,0,0.0,0,0,0.0,0,0,0,0,NO
11,src/contrib/bookkeeper/src/java/org/apache/bookkeeper/util/StringUtils.java,94,0,0.0,0,0,0.0,0,0,0.0,0,0,0.0,0,0,0,0,NO
11,src/contrib/fatjar/src/java/org/apache/zookeeper/util/FatJarMain.java,126,0,0.0,0,0,0.0,0,0,0.0,0,0,0.0,0,0,0,0,NO
11,src/contrib/hedwig/client/src/main/java/org/apache/hedwig/client/api/MessageHandler.java,48,0,0.0,0,0,0.0,0,0,0.0,0,0,0.0,0,0,0,0,NO
11,src/contrib/hedwig/client/src/main/java/org/apache/hedwig/client/api/Publisher.java,63,0,0.0,0,0,0.0,0,0,0.0,0,0,0.0,0,0,0,0,NO
11,src/contrib/hedwig/client/src/main/java/org/apache/hedwig/client/api/Subscriber.java,237,0,0.0,0,0,0.0,0,0,0.0,0,0,0.0,0,0,0,0,NO
11,src/contrib/hedwig/client/src/main/java/org/apache/hedwig/client/benchmark/BenchmarkPublisher.java,133,0,0.0,0,0,0.0,0,0,0.0,0,0,0.0,0,0,0,0,NO
11,src/contrib/hedwig/client/src/main/java/org/apache/hedwig/client/benchmark/BenchmarkSubscriber.java,136,0,0.0,0,0,0.0,0,0,0.0,0,0,0.0,0,0,0,0,NO
11,src/contrib/hedwig/client/src/main/java/org/apache/hedwig/client/benchmark/BenchmarkUtils.java,176,0,0.0,0,0,0.0,0,0,0.0,0,0,0.0,0,0,0,0,NO
11,src/contrib/hedwig/client/src/main/java/org/apache/hedwig/client/benchmark/BenchmarkWorker.java,46,0,0.0,0,0,0.0,0,0,0.0,0,0,0.0,0,0,0,0,NO
11,src/contrib/hedwig/client/src/main/java/org/apache/hedwig/client/benchmark/HedwigBenchmark.java,127,0,0.0,0,0,0.0,0,0,0.0,0,0,0.0,0,0,0,0,NO
11,src/contrib/hedwig/client/src/main/java/org/apache/hedwig/client/conf/ClientConfiguration.java,148,0,0.0,0,0,0.0,0,0,0.0,0,0,0.0,0,0,0,0,NO
11,src/contrib/hedwig/client/src/main/java/org/apache/hedwig/client/data/MessageConsumeData.java,58,0,0.0,0,0,0.0,0,0,0.0,0,0,0.0,0,0,0,0,NO
11,src/contrib/hedwig/client/src/main/java/org/apache/hedwig/client/data/PubSubData.java,149,0,0.0,0,0,0.0,0,0,0.0,0,0,0.0,0,0,0,0,NO
11,src/contrib/hedwig/client/src/main/java/org/apache/hedwig/client/data/TopicSubscriber.java,74,0,0.0,0,0,0.0,0,0,0.0,0,0,0.0,0,0,0,0,NO
11,src/contrib/hedwig/client/src/main/java/org/apache/hedwig/client/exceptions/InvalidSubscriberIdException.java,37,0,0.0,0,0,0.0,0,0,0.0,0,0,0.0,0,0,0,0,NO
11,src/contrib/hedwig/client/src/main/java/org/apache/hedwig/client/exceptions/ServerRedirectLoopException.java,38,0,0.0,0,0,0.0,0,0,0.0,0,0,0.0,0,0,0,0,NO
11,src/contrib/hedwig/client/src/main/java/org/apache/hedwig/client/exceptions/TooManyServerRedirectsException.java,39,0,0.0,0,0,0.0,0,0,0.0,0,0,0.0,0,0,0,0,NO
11,src/contrib/hedwig/client/src/main/java/org/apache/hedwig/client/handlers/MessageConsumeCallback.java,95,0,0.0,0,0,0.0,0,0,0.0,0,0,0.0,0,0,0,0,NO
11,src/contrib/hedwig/client/src/main/java/org/apache/hedwig/client/handlers/PubSubCallback.java,87,0,0.0,0,0,0.0,0,0,0.0,0,0,0.0,0,0,0,0,NO
11,src/contrib/hedwig/client/src/main/java/org/apache/hedwig/client/handlers/PublishResponseHandler.java,70,0,0.0,0,0,0.0,0,0,0.0,0,0,0.0,0,0,0,0,NO
11,src/contrib/hedwig/client/src/main/java/org/apache/hedwig/client/handlers/SubscribeReconnectCallback.java,113,0,0.0,0,0,0.0,0,0,0.0,0,0,0.0,0,0,0,0,NO
11,src/contrib/hedwig/client/src/main/java/org/apache/hedwig/client/handlers/SubscribeResponseHandler.java,329,0,0.0,0,0,0.0,0,0,0.0,0,0,0.0,0,0,0,0,NO
11,src/contrib/hedwig/client/src/main/java/org/apache/hedwig/client/handlers/UnsubscribeResponseHandler.java,83,0,0.0,0,0,0.0,0,0,0.0,0,0,0.0,0,0,0,0,NO
11,src/contrib/hedwig/client/src/main/java/org/apache/hedwig/client/netty/ClientChannelPipelineFactory.java,58,0,0.0,0,0,0.0,0,0,0.0,0,0,0.0,0,0,0,0,NO
11,src/contrib/hedwig/client/src/main/java/org/apache/hedwig/client/netty/ConnectCallback.java,122,0,0.0,0,0,0.0,0,0,0.0,0,0,0.0,0,0,0,0,NO
11,src/contrib/hedwig/client/src/main/java/org/apache/hedwig/client/netty/HedwigClient.java,359,0,0.0,0,0,0.0,0,0,0.0,0,0,0.0,0,0,0,0,NO
11,src/contrib/hedwig/client/src/main/java/org/apache/hedwig/client/netty/HedwigPublisher.java,224,0,0.0,0,0,0.0,0,0,0.0,0,0,0.0,0,0,0,0,NO
11,src/contrib/hedwig/client/src/main/java/org/apache/hedwig/client/netty/HedwigSubscriber.java,585,0,0.0,0,0,0.0,0,0,0.0,0,0,0.0,0,0,0,0,NO
11,src/contrib/hedwig/client/src/main/java/org/apache/hedwig/client/netty/ResponseHandler.java,365,0,0.0,0,0,0.0,0,0,0.0,0,0,0.0,0,0,0,0,NO
11,src/contrib/hedwig/client/src/main/java/org/apache/hedwig/client/netty/WriteCallback.java,98,0,0.0,0,0,0.0,0,0,0.0,0,0,0.0,0,0,0,0,NO
11,src/contrib/hedwig/client/src/main/java/org/apache/hedwig/client/ssl/SslClientContextFactory.java,41,0,0.0,0,0,0.0,0,0,0.0,0,0,0.0,0,0,0,0,NO
11,src/contrib/hedwig/client/src/main/java/org/apache/hedwig/client/ssl/SslContextFactory.java,65,0,0.0,0,0,0.0,0,0,0.0,0,0,0.0,0,0,0,0,NO
11,src/contrib/hedwig/client/src/main/java/org/apache/hedwig/conf/AbstractConfiguration.java,45,0,0.0,0,0,0.0,0,0,0.0,0,0,0.0,0,0,0,0,NO
11,src/contrib/hedwig/client/src/main/java/org/apache/hedwig/util/Callback.java,47,0,0.0,0,0,0.0,0,0,0.0,0,0,0.0,0,0,0,0,NO
11,src/contrib/hedwig/client/src/main/java/org/apache/hedwig/util/CallbackUtils.java,185,0,0.0,0,0,0.0,0,0,0.0,0,0,0.0,0,0,0,0,NO
11,src/contrib/hedwig/client/src/main/java/org/apache/hedwig/util/ConcurrencyUtils.java,49,0,0.0,0,0,0.0,0,0,0.0,0,0,0.0,0,0,0,0,NO
11,src/contrib/hedwig/client/src/main/java/org/apache/hedwig/util/Either.java,50,0,0.0,0,0,0.0,0,0,0.0,0,0,0.0,0,0,0,0,NO
11,src/contrib/hedwig/client/src/main/java/org/apache/hedwig/util/FileUtils.java,97,0,0.0,0,0,0.0,0,0,0.0,0,0,0.0,0,0,0,0,NO
11,src/contrib/hedwig/client/src/main/java/org/apache/hedwig/util/HedwigSocketAddress.java,138,0,0.0,0,0,0.0,0,0,0.0,0,0,0.0,0,0,0,0,NO
11,src/contrib/hedwig/client/src/main/java/org/apache/hedwig/util/Option.java,43,0,0.0,0,0,0.0,0,0,0.0,0,0,0.0,0,0,0,0,NO
11,src/contrib/hedwig/client/src/main/java/org/apache/hedwig/util/Pair.java,42,0,0.0,0,0,0.0,0,0,0.0,0,0,0.0,0,0,0,0,NO
11,src/contrib/hedwig/client/src/main/java/org/apache/hedwig/util/PathUtils.java,56,0,0.0,0,0,0.0,0,0,0.0,0,0,0.0,0,0,0,0,NO
11,src/contrib/hedwig/protocol/src/main/java/org/apache/hedwig/exceptions/PubSubException.java,162,0,0.0,0,0,0.0,0,0,0.0,0,0,0.0,0,0,0,0,NO
11,src/contrib/hedwig/protocol/src/main/java/org/apache/hedwig/protoextensions/MessageIdUtils.java,153,0,0.0,0,0,0.0,0,0,0.0,0,0,0.0,0,0,0,0,NO
11,src/contrib/hedwig/protocol/src/main/java/org/apache/hedwig/protoextensions/PubSubResponseUtils.java,43,0,0.0,0,0,0.0,0,0,0.0,0,0,0.0,0,0,0,0,NO
11,src/contrib/hedwig/protocol/src/main/java/org/apache/hedwig/protoextensions/SubscriptionStateUtils.java,41,0,0.0,0,0,0.0,0,0,0.0,0,0,0.0,0,0,0,0,NO
11,src/contrib/hedwig/server/src/main/java/org/apache/hedwig/server/benchmark/AbstractBenchmark.java,104,0,0.0,0,0,0.0,0,0,0.0,0,0,0.0,0,0,0,0,NO
11,src/contrib/hedwig/server/src/main/java/org/apache/hedwig/server/benchmark/BookieBenchmark.java,103,0,0.0,0,0,0.0,0,0,0.0,0,0,0.0,0,0,0,0,NO
11,src/contrib/hedwig/server/src/main/java/org/apache/hedwig/server/benchmark/BookkeeperBenchmark.java,91,0,0.0,0,0,0.0,0,0,0.0,0,0,0.0,0,0,0,0,NO
11,src/contrib/hedwig/server/src/main/java/org/apache/hedwig/server/benchmark/FakeBookie.java,100,0,0.0,0,0,0.0,0,0,0.0,0,0,0.0,0,0,0,0,NO
11,src/contrib/hedwig/server/src/main/java/org/apache/hedwig/server/common/ByteStringInterner.java,45,0,0.0,0,0,0.0,0,0,0.0,0,0,0.0,0,0,0,0,NO
11,src/contrib/hedwig/server/src/main/java/org/apache/hedwig/server/common/ServerConfiguration.java,289,0,0.0,0,0,0.0,0,0,0.0,0,0,0.0,0,0,0,0,NO
11,src/contrib/hedwig/server/src/main/java/org/apache/hedwig/server/common/TerminateJVMExceptionHandler.java,31,0,0.0,0,0,0.0,0,0,0.0,0,0,0.0,0,0,0,0,NO
11,src/contrib/hedwig/server/src/main/java/org/apache/hedwig/server/common/TopicOpQueuer.java,111,0,0.0,0,0,0.0,0,0,0.0,0,0,0.0,0,0,0,0,NO
11,src/contrib/hedwig/server/src/main/java/org/apache/hedwig/server/common/UnexpectedError.java,35,0,0.0,0,0,0.0,0,0,0.0,0,0,0.0,0,0,0,0,NO
11,src/contrib/hedwig/server/src/main/java/org/apache/hedwig/server/delivery/ChannelEndPoint.java,81,0,0.0,0,0,0.0,0,0,0.0,0,0,0.0,0,0,0,0,NO
11,src/contrib/hedwig/server/src/main/java/org/apache/hedwig/server/delivery/DeliveryCallback.java,27,0,0.0,0,0,0.0,0,0,0.0,0,0,0.0,0,0,0,0,NO
11,src/contrib/hedwig/server/src/main/java/org/apache/hedwig/server/delivery/DeliveryEndPoint.java,28,0,0.0,0,0,0.0,0,0,0.0,0,0,0.0,0,0,0,0,NO
11,src/contrib/hedwig/server/src/main/java/org/apache/hedwig/server/delivery/DeliveryManager.java,29,0,0.0,0,0,0.0,0,0,0.0,0,0,0.0,0,0,0,0,NO
11,src/contrib/hedwig/server/src/main/java/org/apache/hedwig/server/delivery/FIFODeliveryManager.java,561,0,0.0,0,0,0.0,0,0,0.0,0,0,0.0,0,0,0,0,NO
11,src/contrib/hedwig/server/src/main/java/org/apache/hedwig/server/handlers/BaseHandler.java,64,0,0.0,0,0,0.0,0,0,0.0,0,0,0.0,0,0,0,0,NO
11,src/contrib/hedwig/server/src/main/java/org/apache/hedwig/server/handlers/ChannelDisconnectListener.java,29,0,0.0,0,0,0.0,0,0,0.0,0,0,0.0,0,0,0,0,NO
11,src/contrib/hedwig/server/src/main/java/org/apache/hedwig/server/handlers/ConsumeHandler.java,64,0,0.0,0,0,0.0,0,0,0.0,0,0,0.0,0,0,0,0,NO
11,src/contrib/hedwig/server/src/main/java/org/apache/hedwig/server/handlers/Handler.java,37,0,0.0,0,0,0.0,0,0,0.0,0,0,0.0,0,0,0,0,NO
11,src/contrib/hedwig/server/src/main/java/org/apache/hedwig/server/handlers/PublishHandler.java,68,0,0.0,0,0,0.0,0,0,0.0,0,0,0.0,0,0,0,0,NO
11,src/contrib/hedwig/server/src/main/java/org/apache/hedwig/server/handlers/SubscribeHandler.java,153,0,0.0,0,0,0.0,0,0,0.0,0,0,0.0,0,0,0,0,NO
11,src/contrib/hedwig/server/src/main/java/org/apache/hedwig/server/handlers/UnsubscribeHandler.java,72,0,0.0,0,0,0.0,0,0,0.0,0,0,0.0,0,0,0,0,NO
11,src/contrib/hedwig/server/src/main/java/org/apache/hedwig/server/netty/PubSubServer.java,364,0,0.0,0,0,0.0,0,0,0.0,0,0,0.0,0,0,0,0,NO
11,src/contrib/hedwig/server/src/main/java/org/apache/hedwig/server/netty/PubSubServerPipelineFactory.java,76,0,0.0,0,0,0.0,0,0,0.0,0,0,0.0,0,0,0,0,NO
11,src/contrib/hedwig/server/src/main/java/org/apache/hedwig/server/netty/UmbrellaHandler.java,158,0,0.0,0,0,0.0,0,0,0.0,0,0,0.0,0,0,0,0,NO
11,src/contrib/hedwig/server/src/main/java/org/apache/hedwig/server/persistence/BookkeeperPersistenceManager.java,736,0,0.0,0,0,0.0,0,0,0.0,0,0,0.0,0,0,0,0,NO
11,src/contrib/hedwig/server/src/main/java/org/apache/hedwig/server/persistence/CacheKey.java,74,0,0.0,0,0,0.0,0,0,0.0,0,0,0.0,0,0,0,0,NO
11,src/contrib/hedwig/server/src/main/java/org/apache/hedwig/server/persistence/CacheValue.java,93,0,0.0,0,0,0.0,0,0,0.0,0,0,0.0,0,0,0,0,NO
11,src/contrib/hedwig/server/src/main/java/org/apache/hedwig/server/persistence/Factory.java,22,0,0.0,0,0,0.0,0,0,0.0,0,0,0.0,0,0,0,0,NO
11,src/contrib/hedwig/server/src/main/java/org/apache/hedwig/server/persistence/LocalDBPersistenceManager.java,426,0,0.0,0,0,0.0,0,0,0.0,0,0,0.0,0,0,0,0,NO
11,src/contrib/hedwig/server/src/main/java/org/apache/hedwig/server/persistence/MapMethods.java,62,0,0.0,0,0,0.0,0,0,0.0,0,0,0.0,0,0,0,0,NO
11,src/contrib/hedwig/server/src/main/java/org/apache/hedwig/server/persistence/PersistRequest.java,58,0,0.0,0,0,0.0,0,0,0.0,0,0,0.0,0,0,0,0,NO
11,src/contrib/hedwig/server/src/main/java/org/apache/hedwig/server/persistence/PersistenceManager.java,91,0,0.0,0,0,0.0,0,0,0.0,0,0,0.0,0,0,0,0,NO
11,src/contrib/hedwig/server/src/main/java/org/apache/hedwig/server/persistence/PersistenceManagerWithRangeScan.java,27,0,0.0,0,0,0.0,0,0,0.0,0,0,0.0,0,0,0,0,NO
11,src/contrib/hedwig/server/src/main/java/org/apache/hedwig/server/persistence/RangeScanRequest.java,77,0,0.0,0,0,0.0,0,0,0.0,0,0,0.0,0,0,0,0,NO
11,src/contrib/hedwig/server/src/main/java/org/apache/hedwig/server/persistence/ReadAheadCache.java,703,0,0.0,0,0,0.0,0,0,0.0,0,0,0.0,0,0,0,0,NO
11,src/contrib/hedwig/server/src/main/java/org/apache/hedwig/server/persistence/ScanCallback.java,63,0,0.0,0,0,0.0,0,0,0.0,0,0,0.0,0,0,0,0,NO
11,src/contrib/hedwig/server/src/main/java/org/apache/hedwig/server/persistence/ScanCallbackWithContext.java,37,0,0.0,0,0,0.0,0,0,0.0,0,0,0.0,0,0,0,0,NO
11,src/contrib/hedwig/server/src/main/java/org/apache/hedwig/server/persistence/ScanRequest.java,64,0,0.0,0,0,0.0,0,0,0.0,0,0,0.0,0,0,0,0,NO
11,src/contrib/hedwig/server/src/main/java/org/apache/hedwig/server/proxy/ChannelTracker.java,124,0,0.0,0,0,0.0,0,0,0.0,0,0,0.0,0,0,0,0,NO
11,src/contrib/hedwig/server/src/main/java/org/apache/hedwig/server/proxy/HedwigProxy.java,159,0,0.0,0,0,0.0,0,0,0.0,0,0,0.0,0,0,0,0,NO
11,src/contrib/hedwig/server/src/main/java/org/apache/hedwig/server/proxy/ProxyConfiguration.java,36,0,0.0,0,0,0.0,0,0,0.0,0,0,0.0,0,0,0,0,NO
11,src/contrib/hedwig/server/src/main/java/org/apache/hedwig/server/proxy/ProxyConsumeHandler.java,57,0,0.0,0,0,0.0,0,0,0.0,0,0,0.0,0,0,0,0,NO
11,src/contrib/hedwig/server/src/main/java/org/apache/hedwig/server/proxy/ProxyPublishHander.java,62,0,0.0,0,0,0.0,0,0,0.0,0,0,0.0,0,0,0,0,NO
11,src/contrib/hedwig/server/src/main/java/org/apache/hedwig/server/proxy/ProxyStartDeliveryHandler.java,129,0,0.0,0,0,0.0,0,0,0.0,0,0,0.0,0,0,0,0,NO
11,src/contrib/hedwig/server/src/main/java/org/apache/hedwig/server/proxy/ProxyStopDeliveryHandler.java,73,0,0.0,0,0,0.0,0,0,0.0,0,0,0.0,0,0,0,0,NO
11,src/contrib/hedwig/server/src/main/java/org/apache/hedwig/server/proxy/ProxySubscribeHandler.java,82,0,0.0,0,0,0.0,0,0,0.0,0,0,0.0,0,0,0,0,NO
11,src/contrib/hedwig/server/src/main/java/org/apache/hedwig/server/proxy/ProxyUnsubscribeHandler.java,74,0,0.0,0,0,0.0,0,0,0.0,0,0,0.0,0,0,0,0,NO
11,src/contrib/hedwig/server/src/main/java/org/apache/hedwig/server/regions/HedwigHubClient.java,48,0,0.0,0,0,0.0,0,0,0.0,0,0,0.0,0,0,0,0,NO
11,src/contrib/hedwig/server/src/main/java/org/apache/hedwig/server/regions/HedwigHubClientFactory.java,60,0,0.0,0,0,0.0,0,0,0.0,0,0,0.0,0,0,0,0,NO
11,src/contrib/hedwig/server/src/main/java/org/apache/hedwig/server/regions/HedwigHubSubscriber.java,70,0,0.0,0,0,0.0,0,0,0.0,0,0,0.0,0,0,0,0,NO
11,src/contrib/hedwig/server/src/main/java/org/apache/hedwig/server/regions/RegionManager.java,180,0,0.0,0,0,0.0,0,0,0.0,0,0,0.0,0,0,0,0,NO
11,src/contrib/hedwig/server/src/main/java/org/apache/hedwig/server/ssl/SslServerContextFactory.java,53,0,0.0,0,0,0.0,0,0,0.0,0,0,0.0,0,0,0,0,NO
11,src/contrib/hedwig/server/src/main/java/org/apache/hedwig/server/subscriptions/AbstractSubscriptionManager.java,450,0,0.0,0,0,0.0,0,0,0.0,0,0,0.0,0,0,0,0,NO
11,src/contrib/hedwig/server/src/main/java/org/apache/hedwig/server/subscriptions/AllToAllTopologyFilter.java,39,0,0.0,0,0,0.0,0,0,0.0,0,0,0.0,0,0,0,0,NO
11,src/contrib/hedwig/server/src/main/java/org/apache/hedwig/server/subscriptions/InMemorySubscriptionManager.java,78,0,0.0,0,0,0.0,0,0,0.0,0,0,0.0,0,0,0,0,NO
11,src/contrib/hedwig/server/src/main/java/org/apache/hedwig/server/subscriptions/InMemorySubscriptionState.java,64,0,0.0,0,0,0.0,0,0,0.0,0,0,0.0,0,0,0,0,NO
11,src/contrib/hedwig/server/src/main/java/org/apache/hedwig/server/subscriptions/MessageFilter.java,31,0,0.0,0,0,0.0,0,0,0.0,0,0,0.0,0,0,0,0,NO
11,src/contrib/hedwig/server/src/main/java/org/apache/hedwig/server/subscriptions/SubscriptionEventListener.java,57,0,0.0,0,0,0.0,0,0,0.0,0,0,0.0,0,0,0,0,NO
11,src/contrib/hedwig/server/src/main/java/org/apache/hedwig/server/subscriptions/SubscriptionManager.java,104,0,0.0,0,0,0.0,0,0,0.0,0,0,0.0,0,0,0,0,NO
11,src/contrib/hedwig/server/src/main/java/org/apache/hedwig/server/subscriptions/TrueFilter.java,32,0,0.0,0,0,0.0,0,0,0.0,0,0,0.0,0,0,0,0,NO
11,src/contrib/hedwig/server/src/main/java/org/apache/hedwig/server/subscriptions/ZkSubscriptionManager.java,226,0,0.0,0,0,0.0,0,0,0.0,0,0,0.0,0,0,0,0,NO
11,src/contrib/hedwig/server/src/main/java/org/apache/hedwig/server/topics/AbstractTopicManager.java,187,0,0.0,0,0,0.0,0,0,0.0,0,0,0.0,0,0,0,0,NO
11,src/contrib/hedwig/server/src/main/java/org/apache/hedwig/server/topics/TopicManager.java,75,0,0.0,0,0,0.0,0,0,0.0,0,0,0.0,0,0,0,0,NO
11,src/contrib/hedwig/server/src/main/java/org/apache/hedwig/server/topics/TopicOwnershipChangeListener.java,28,0,0.0,0,0,0.0,0,0,0.0,0,0,0.0,0,0,0,0,NO
11,src/contrib/hedwig/server/src/main/java/org/apache/hedwig/server/topics/TrivialOwnAllTopicManager.java,52,0,0.0,0,0,0.0,0,0,0.0,0,0,0.0,0,0,0,0,NO
11,src/contrib/hedwig/server/src/main/java/org/apache/hedwig/server/topics/ZkTopicManager.java,428,0,0.0,0,0,0.0,0,0,0.0,0,0,0.0,0,0,0,0,NO
11,src/contrib/hedwig/server/src/main/java/org/apache/hedwig/zookeeper/SafeAsynBKCallback.java,103,0,0.0,0,0,0.0,0,0,0.0,0,0,0.0,0,0,0,0,NO
11,src/contrib/hedwig/server/src/main/java/org/apache/hedwig/zookeeper/SafeAsyncCallback.java,35,0,0.0,0,0,0.0,0,0,0.0,0,0,0.0,0,0,0,0,NO
11,src/contrib/hedwig/server/src/main/java/org/apache/hedwig/zookeeper/SafeAsyncZKCallback.java,98,0,0.0,0,0,0.0,0,0,0.0,0,0,0.0,0,0,0,0,NO
11,src/contrib/hedwig/server/src/main/java/org/apache/hedwig/zookeeper/ZkUtils.java,78,0,0.0,0,0,0.0,0,0,0.0,0,0,0.0,0,0,0,0,NO
11,src/contrib/loggraph/src/java/org/apache/zookeeper/graph/FilterException.java,22,0,0.0,0,0,0.0,0,0,0.0,0,0,0.0,0,0,0,0,NO
11,src/contrib/loggraph/src/java/org/apache/zookeeper/graph/FilterOp.java,75,0,0.0,0,0,0.0,0,0,0.0,0,0,0.0,0,0,0,0,NO
11,src/contrib/loggraph/src/java/org/apache/zookeeper/graph/FilterParser.java,131,0,0.0,0,0,0.0,0,0,0.0,0,0,0.0,0,0,0,0,NO
11,src/contrib/loggraph/src/java/org/apache/zookeeper/graph/JsonGenerator.java,223,0,0.0,0,0,0.0,0,0,0.0,0,0,0.0,0,0,0,0,NO
11,src/contrib/loggraph/src/java/org/apache/zookeeper/graph/Log4JEntry.java,40,0,0.0,0,0,0.0,0,0,0.0,0,0,0.0,0,0,0,0,NO
11,src/contrib/loggraph/src/java/org/apache/zookeeper/graph/Log4JSource.java,380,0,0.0,0,0,0.0,0,0,0.0,0,0,0.0,0,0,0,0,NO
11,src/contrib/loggraph/src/java/org/apache/zookeeper/graph/LogEntry.java,46,0,0.0,0,0,0.0,0,0,0.0,0,0,0.0,0,0,0,0,NO
11,src/contrib/loggraph/src/java/org/apache/zookeeper/graph/LogIterator.java,26,0,0.0,0,0,0.0,0,0,0.0,0,0,0.0,0,0,0,0,NO
11,src/contrib/loggraph/src/java/org/apache/zookeeper/graph/LogServer.java,66,0,0.0,0,0,0.0,0,0,0.0,0,0,0.0,0,0,0,0,NO
11,src/contrib/loggraph/src/java/org/apache/zookeeper/graph/LogSkipList.java,94,0,0.0,0,0,0.0,0,0,0.0,0,0,0.0,0,0,0,0,NO
11,src/contrib/loggraph/src/java/org/apache/zookeeper/graph/LogSource.java,33,0,0.0,0,0,0.0,0,0,0.0,0,0,0.0,0,0,0,0,NO
11,src/contrib/loggraph/src/java/org/apache/zookeeper/graph/MeasureThroughput.java,103,0,0.0,0,0,0.0,0,0,0.0,0,0,0.0,0,0,0,0,NO
11,src/contrib/loggraph/src/java/org/apache/zookeeper/graph/MergedLogSource.java,218,0,0.0,0,0,0.0,0,0,0.0,0,0,0.0,0,0,0,0,NO
11,src/contrib/loggraph/src/java/org/apache/zookeeper/graph/RandomAccessFileReader.java,327,0,0.0,0,0,0.0,0,0,0.0,0,0,0.0,0,0,0,0,NO
11,src/contrib/loggraph/src/java/org/apache/zookeeper/graph/TransactionEntry.java,59,0,0.0,0,0,0.0,0,0,0.0,0,0,0.0,0,0,0,0,NO
11,src/contrib/loggraph/src/java/org/apache/zookeeper/graph/TxnLogSource.java,377,0,0.0,0,0,0.0,0,0,0.0,0,0,0.0,0,0,0,0,YES
11,src/contrib/loggraph/src/java/org/apache/zookeeper/graph/filterops/AndOp.java,33,0,0.0,0,0,0.0,0,0,0.0,0,0,0.0,0,0,0,0,NO
11,src/contrib/loggraph/src/java/org/apache/zookeeper/graph/filterops/Arg.java,36,0,0.0,0,0,0.0,0,0,0.0,0,0,0.0,0,0,0,0,NO
11,src/contrib/loggraph/src/java/org/apache/zookeeper/graph/filterops/EqualsOp.java,44,0,0.0,0,0,0.0,0,0,0.0,0,0,0.0,0,0,0,0,NO
11,src/contrib/loggraph/src/java/org/apache/zookeeper/graph/filterops/GreaterThanOp.java,70,0,0.0,0,0,0.0,0,0,0.0,0,0,0.0,0,0,0,0,NO
11,src/contrib/loggraph/src/java/org/apache/zookeeper/graph/filterops/LessThanOp.java,69,0,0.0,0,0,0.0,0,0,0.0,0,0,0.0,0,0,0,0,NO
11,src/contrib/loggraph/src/java/org/apache/zookeeper/graph/filterops/NotOp.java,31,0,0.0,0,0,0.0,0,0,0.0,0,0,0.0,0,0,0,0,NO
11,src/contrib/loggraph/src/java/org/apache/zookeeper/graph/filterops/NumberArg.java,27,0,0.0,0,0,0.0,0,0,0.0,0,0,0.0,0,0,0,0,NO
11,src/contrib/loggraph/src/java/org/apache/zookeeper/graph/filterops/OrOp.java,33,0,0.0,0,0,0.0,0,0,0.0,0,0,0.0,0,0,0,0,NO
11,src/contrib/loggraph/src/java/org/apache/zookeeper/graph/filterops/StringArg.java,27,0,0.0,0,0,0.0,0,0,0.0,0,0,0.0,0,0,0,0,NO
11,src/contrib/loggraph/src/java/org/apache/zookeeper/graph/filterops/SymbolArg.java,27,0,0.0,0,0,0.0,0,0,0.0,0,0,0.0,0,0,0,0,NO
11,src/contrib/loggraph/src/java/org/apache/zookeeper/graph/filterops/XorOp.java,40,0,0.0,0,0,0.0,0,0,0.0,0,0,0.0,0,0,0,0,NO
11,src/contrib/loggraph/src/java/org/apache/zookeeper/graph/servlets/FileLoader.java,60,0,0.0,0,0,0.0,0,0,0.0,0,0,0.0,0,0,0,0,NO
11,src/contrib/loggraph/src/java/org/apache/zookeeper/graph/servlets/Fs.java,69,0,0.0,0,0,0.0,0,0,0.0,0,0,0.0,0,0,0,0,NO
11,src/contrib/loggraph/src/java/org/apache/zookeeper/graph/servlets/GraphData.java,84,0,0.0,0,0,0.0,0,0,0.0,0,0,0.0,0,0,0,0,NO
11,src/contrib/loggraph/src/java/org/apache/zookeeper/graph/servlets/JsonServlet.java,85,0,0.0,0,0,0.0,0,0,0.0,0,0,0.0,0,0,0,0,NO
11,src/contrib/loggraph/src/java/org/apache/zookeeper/graph/servlets/NumEvents.java,85,0,0.0,0,0,0.0,0,0,0.0,0,0,0.0,0,0,0,0,NO
11,src/contrib/loggraph/src/java/org/apache/zookeeper/graph/servlets/StaticContent.java,50,0,0.0,0,0,0.0,0,0,0.0,0,0,0.0,0,0,0,0,NO
11,src/contrib/loggraph/src/java/org/apache/zookeeper/graph/servlets/Throughput.java,124,0,0.0,0,0,0.0,0,0,0.0,0,0,0.0,0,0,0,0,NO
11,src/contrib/rest/src/java/org/apache/zookeeper/server/jersey/RestMain.java,150,0,0.0,0,0,0.0,0,0,0.0,0,0,0.0,0,0,0,0,NO
11,src/contrib/rest/src/java/org/apache/zookeeper/server/jersey/ZooKeeperService.java,241,0,0.0,0,0,0.0,0,0,0.0,0,0,0.0,0,0,0,0,NO
11,src/contrib/rest/src/java/org/apache/zookeeper/server/jersey/cfg/Credentials.java,47,0,0.0,0,0,0.0,0,0,0.0,0,0,0.0,0,0,0,0,NO
11,src/contrib/rest/src/java/org/apache/zookeeper/server/jersey/cfg/Endpoint.java,72,0,0.0,0,0,0.0,0,0,0.0,0,0,0.0,0,0,0,0,NO
11,src/contrib/rest/src/java/org/apache/zookeeper/server/jersey/cfg/HostPort.java,51,0,0.0,0,0,0.0,0,0,0.0,0,0,0.0,0,0,0,0,NO
11,src/contrib/rest/src/java/org/apache/zookeeper/server/jersey/cfg/HostPortSet.java,51,0,0.0,0,0,0.0,0,0,0.0,0,0,0.0,0,0,0,0,NO
11,src/contrib/rest/src/java/org/apache/zookeeper/server/jersey/cfg/RestCfg.java,106,0,0.0,0,0,0.0,0,0,0.0,0,0,0.0,0,0,0,0,NO
11,src/contrib/rest/src/java/org/apache/zookeeper/server/jersey/filters/HTTPBasicAuth.java,87,0,0.0,0,0,0.0,0,0,0.0,0,0,0.0,0,0,0,0,NO
11,src/contrib/rest/src/java/org/apache/zookeeper/server/jersey/jaxb/ZChildren.java,80,0,0.0,0,0,0.0,0,0,0.0,0,0,0.0,0,0,0,0,NO
11,src/contrib/rest/src/java/org/apache/zookeeper/server/jersey/jaxb/ZChildrenJSON.java,76,0,0.0,0,0,0.0,0,0,0.0,0,0,0.0,0,0,0,0,NO
11,src/contrib/rest/src/java/org/apache/zookeeper/server/jersey/jaxb/ZError.java,41,0,0.0,0,0,0.0,0,0,0.0,0,0,0.0,0,0,0,0,NO
11,src/contrib/rest/src/java/org/apache/zookeeper/server/jersey/jaxb/ZPath.java,63,0,0.0,0,0,0.0,0,0,0.0,0,0,0.0,0,0,0,0,NO
11,src/contrib/rest/src/java/org/apache/zookeeper/server/jersey/jaxb/ZSession.java,55,0,0.0,0,0,0.0,0,0,0.0,0,0,0.0,0,0,0,0,NO
11,src/contrib/rest/src/java/org/apache/zookeeper/server/jersey/jaxb/ZStat.java,106,0,0.0,0,0,0.0,0,0,0.0,0,0,0.0,0,0,0,0,NO
11,src/contrib/rest/src/java/org/apache/zookeeper/server/jersey/resources/JAXBContextResolver.java,72,0,0.0,0,0,0.0,0,0,0.0,0,0,0.0,0,0,0,0,NO
11,src/contrib/rest/src/java/org/apache/zookeeper/server/jersey/resources/KeeperExceptionMapper.java,86,0,0.0,0,0,0.0,0,0,0.0,0,0,0.0,0,0,0,0,NO
11,src/contrib/rest/src/java/org/apache/zookeeper/server/jersey/resources/RuntimeExceptionMapper.java,55,0,0.0,0,0,0.0,0,0,0.0,0,0,0.0,0,0,0,0,NO
11,src/contrib/rest/src/java/org/apache/zookeeper/server/jersey/resources/SessionsResource.java,134,0,0.0,0,0,0.0,0,0,0.0,0,0,0.0,0,0,0,0,NO
11,src/contrib/rest/src/java/org/apache/zookeeper/server/jersey/resources/ZErrorWriter.java,63,0,0.0,0,0,0.0,0,0,0.0,0,0,0.0,0,0,0,0,NO
11,src/contrib/rest/src/java/org/apache/zookeeper/server/jersey/resources/ZNodeResource.java,412,0,0.0,0,0,0.0,0,0,0.0,0,0,0.0,0,0,0,0,NO
11,src/contrib/zooinspector/src/java/org/apache/zookeeper/inspector/ZooInspector.java,66,0,0.0,0,0,0.0,0,0,0.0,0,0,0.0,0,0,0,0,NO
11,src/contrib/zooinspector/src/java/org/apache/zookeeper/inspector/encryption/BasicDataEncryptionManager.java,50,0,0.0,0,0,0.0,0,0,0.0,0,0,0.0,0,0,0,0,NO
11,src/contrib/zooinspector/src/java/org/apache/zookeeper/inspector/encryption/DataEncryptionManager.java,39,0,0.0,0,0,0.0,0,0,0.0,0,0,0.0,0,0,0,0,NO
11,src/contrib/zooinspector/src/java/org/apache/zookeeper/inspector/gui/NodeViewersChangeListener.java,37,0,0.0,0,0,0.0,0,0,0.0,0,0,0.0,0,0,0,0,NO
11,src/contrib/zooinspector/src/java/org/apache/zookeeper/inspector/gui/ZooInspectorAboutDialog.java,80,0,0.0,0,0,0.0,0,0,0.0,0,0,0.0,0,0,0,0,NO
11,src/contrib/zooinspector/src/java/org/apache/zookeeper/inspector/gui/ZooInspectorConnectionPropertiesDialog.java,321,0,0.0,0,0,0.0,0,0,0.0,0,0,0.0,0,0,0,0,NO
11,src/contrib/zooinspector/src/java/org/apache/zookeeper/inspector/gui/ZooInspectorIconResources.java,118,0,0.0,0,0,0.0,0,0,0.0,0,0,0.0,0,0,0,0,NO
11,src/contrib/zooinspector/src/java/org/apache/zookeeper/inspector/gui/ZooInspectorNodeViewersDialog.java,605,0,0.0,0,0,0.0,0,0,0.0,0,0,0.0,0,0,0,0,NO
11,src/contrib/zooinspector/src/java/org/apache/zookeeper/inspector/gui/ZooInspectorNodeViewersPanel.java,140,0,0.0,0,0,0.0,0,0,0.0,0,0,0.0,0,0,0,0,NO
11,src/contrib/zooinspector/src/java/org/apache/zookeeper/inspector/gui/ZooInspectorPanel.java,361,0,0.0,0,0,0.0,0,0,0.0,0,0,0.0,0,0,0,0,NO
11,src/contrib/zooinspector/src/java/org/apache/zookeeper/inspector/gui/ZooInspectorTreeViewer.java,362,0,0.0,0,0,0.0,0,0,0.0,0,0,0.0,0,0,0,0,NO
11,src/contrib/zooinspector/src/java/org/apache/zookeeper/inspector/gui/nodeviewer/NodeViewerACL.java,187,0,0.0,0,0,0.0,0,0,0.0,0,0,0.0,0,0,0,0,NO
11,src/contrib/zooinspector/src/java/org/apache/zookeeper/inspector/gui/nodeviewer/NodeViewerData.java,146,0,0.0,0,0,0.0,0,0,0.0,0,0,0.0,0,0,0,0,NO
11,src/contrib/zooinspector/src/java/org/apache/zookeeper/inspector/gui/nodeviewer/NodeViewerMetaData.java,186,0,0.0,0,0,0.0,0,0,0.0,0,0,0.0,0,0,0,0,NO
11,src/contrib/zooinspector/src/java/org/apache/zookeeper/inspector/gui/nodeviewer/ZooInspectorNodeViewer.java,138,0,0.0,0,0,0.0,0,0,0.0,0,0,0.0,0,0,0,0,NO
11,src/contrib/zooinspector/src/java/org/apache/zookeeper/inspector/logger/LoggerFactory.java,38,0,0.0,0,0,0.0,0,0,0.0,0,0,0.0,0,0,0,0,NO
11,src/contrib/zooinspector/src/java/org/apache/zookeeper/inspector/manager/NodeListener.java,37,0,0.0,0,0,0.0,0,0,0.0,0,0,0.0,0,0,0,0,NO
11,src/contrib/zooinspector/src/java/org/apache/zookeeper/inspector/manager/Pair.java,120,0,0.0,0,0,0.0,0,0,0.0,0,0,0.0,0,0,0,0,NO
11,src/contrib/zooinspector/src/java/org/apache/zookeeper/inspector/manager/ZooInspectorManager.java,139,0,0.0,0,0,0.0,0,0,0.0,0,0,0.0,0,0,0,0,NO
11,src/contrib/zooinspector/src/java/org/apache/zookeeper/inspector/manager/ZooInspectorManagerImpl.java,852,0,0.0,0,0,0.0,0,0,0.0,0,0,0.0,0,0,0,0,NO
11,src/contrib/zooinspector/src/java/org/apache/zookeeper/inspector/manager/ZooInspectorNodeManager.java,33,0,0.0,0,0,0.0,0,0,0.0,0,0,0.0,0,0,0,0,NO
11,src/contrib/zooinspector/src/java/org/apache/zookeeper/inspector/manager/ZooInspectorNodeTreeManager.java,43,0,0.0,0,0,0.0,0,0,0.0,0,0,0.0,0,0,0,0,NO
11,src/contrib/zooinspector/src/java/org/apache/zookeeper/inspector/manager/ZooInspectorReadOnlyManager.java,99,0,0.0,0,0,0.0,0,0,0.0,0,0,0.0,0,0,0,0,NO
11,src/contrib/zooinspector/src/java/org/apache/zookeeper/retry/ZooKeeperRetry.java,288,0,0.0,0,0,0.0,0,0,0.0,0,0,0.0,0,0,0,0,NO
11,src/java/main/org/apache/jute/BinaryInputArchive.java,131,0,0.0,0,0,0.0,0,0,0.0,0,0,0.0,0,0,0,0,NO
11,src/java/main/org/apache/jute/BinaryOutputArchive.java,146,0,0.0,0,0,0.0,0,0,0.0,0,0,0.0,0,0,0,0,NO
11,src/java/main/org/apache/jute/CsvInputArchive.java,208,0,0.0,0,0,0.0,0,0,0.0,0,0,0.0,0,0,0,0,NO
11,src/java/main/org/apache/jute/CsvOutputArchive.java,150,0,0.0,0,0,0.0,0,0,0.0,0,0,0.0,0,0,0,0,NO
11,src/java/main/org/apache/jute/Index.java,38,0,0.0,0,0,0.0,0,0,0.0,0,0,0.0,0,0,0,0,NO
11,src/java/main/org/apache/jute/InputArchive.java,43,0,0.0,0,0,0.0,0,0,0.0,0,0,0.0,0,0,0,0,NO
11,src/java/main/org/apache/jute/OutputArchive.java,47,0,0.0,0,0,0.0,0,0,0.0,0,0,0.0,0,0,0,0,NO
11,src/java/main/org/apache/jute/Record.java,32,0,0.0,0,0,0.0,0,0,0.0,0,0,0.0,0,0,0,0,NO
11,src/java/main/org/apache/jute/RecordReader.java,93,0,0.0,0,0,0.0,0,0,0.0,0,0,0.0,0,0,0,0,NO
11,src/java/main/org/apache/jute/RecordWriter.java,113,0,0.0,0,0,0.0,0,0,0.0,0,0,0.0,0,0,0,0,NO
11,src/java/main/org/apache/jute/Utils.java,282,0,0.0,0,0,0.0,0,0,0.0,0,0,0.0,0,0,0,0,NO
11,src/java/main/org/apache/jute/XmlInputArchive.java,251,0,0.0,0,0,0.0,0,0,0.0,0,0,0.0,0,0,0,0,NO
11,src/java/main/org/apache/jute/XmlOutputArchive.java,251,0,0.0,0,0,0.0,0,0,0.0,0,0,0.0,0,0,0,0,NO
11,src/java/main/org/apache/jute/compiler/CGenerator.java,130,0,0.0,0,0,0.0,0,0,0.0,0,0,0.0,0,0,0,0,NO
11,src/java/main/org/apache/jute/compiler/CSharpGenerator.java,53,0,0.0,0,0,0.0,0,0,0.0,0,0,0.0,0,0,0,0,NO
11,src/java/main/org/apache/jute/compiler/CppGenerator.java,125,0,0.0,0,0,0.0,0,0,0.0,0,0,0.0,0,0,0,0,NO
11,src/java/main/org/apache/jute/compiler/JBoolean.java,50,0,0.0,0,0,0.0,0,0,0.0,0,0,0.0,0,0,0,0,NO
11,src/java/main/org/apache/jute/compiler/JBuffer.java,106,0,0.0,0,0,0.0,0,0,0.0,0,0,0.0,0,0,0,0,NO
11,src/java/main/org/apache/jute/compiler/JByte.java,34,0,0.0,0,0,0.0,0,0,0.0,0,0,0.0,0,0,0,0,NO
11,src/java/main/org/apache/jute/compiler/JCompType.java,66,0,0.0,0,0,0.0,0,0,0.0,0,0,0.0,0,0,0,0,NO
11,src/java/main/org/apache/jute/compiler/JDouble.java,40,0,0.0,0,0,0.0,0,0,0.0,0,0,0.0,0,0,0,0,NO
11,src/java/main/org/apache/jute/compiler/JField.java,140,0,0.0,0,0,0.0,0,0,0.0,0,0,0.0,0,0,0,0,NO
11,src/java/main/org/apache/jute/compiler/JFile.java,84,0,0.0,0,0,0.0,0,0,0.0,0,0,0.0,0,0,0,0,NO
11,src/java/main/org/apache/jute/compiler/JFloat.java,39,0,0.0,0,0,0.0,0,0,0.0,0,0,0.0,0,0,0,0,NO
11,src/java/main/org/apache/jute/compiler/JInt.java,34,0,0.0,0,0,0.0,0,0,0.0,0,0,0.0,0,0,0,0,NO
11,src/java/main/org/apache/jute/compiler/JLong.java,38,0,0.0,0,0,0.0,0,0,0.0,0,0,0.0,0,0,0,0,NO
11,src/java/main/org/apache/jute/compiler/JMap.java,149,0,0.0,0,0,0.0,0,0,0.0,0,0,0.0,0,0,0,0,NO
11,src/java/main/org/apache/jute/compiler/JRecord.java,762,0,0.0,0,0,0.0,0,0,0.0,0,0,0.0,0,0,0,0,NO
11,src/java/main/org/apache/jute/compiler/JString.java,46,0,0.0,0,0,0.0,0,0,0.0,0,0,0.0,0,0,0,0,NO
11,src/java/main/org/apache/jute/compiler/JType.java,204,0,0.0,0,0,0.0,0,0,0.0,0,0,0.0,0,0,0,0,NO
11,src/java/main/org/apache/jute/compiler/JVector.java,153,0,0.0,0,0,0.0,0,0,0.0,0,0,0.0,0,0,0,0,NO
11,src/java/main/org/apache/jute/compiler/JavaGenerator.java,57,0,0.0,0,0,0.0,0,0,0.0,0,0,0.0,0,0,0,0,NO
11,src/java/main/org/apache/jute/compiler/generated/ParseException.java,210,0,0.0,0,0,0.0,0,0,0.0,0,0,0.0,0,0,0,0,NO
11,src/java/main/org/apache/jute/compiler/generated/Rcc.java,525,0,0.0,0,0,0.0,0,0,0.0,0,0,0.0,0,0,0,0,NO
11,src/java/main/org/apache/jute/compiler/generated/RccConstants.java,88,0,0.0,0,0,0.0,0,0,0.0,0,0,0.0,0,0,0,0,NO
11,src/java/main/org/apache/jute/compiler/generated/RccTokenManager.java,833,0,0.0,0,0,0.0,0,0,0.0,0,0,0.0,0,0,0,0,NO
11,src/java/main/org/apache/jute/compiler/generated/SimpleCharStream.java,457,0,0.0,0,0,0.0,0,0,0.0,0,0,0.0,0,0,0,0,NO
11,src/java/main/org/apache/jute/compiler/generated/Token.java,99,0,0.0,0,0,0.0,0,0,0.0,0,0,0.0,0,0,0,0,NO
11,src/java/main/org/apache/jute/compiler/generated/TokenMgrError.java,151,0,0.0,0,0,0.0,0,0,0.0,0,0,0.0,0,0,0,0,NO
11,src/java/main/org/apache/zookeeper/AsyncCallback.java,57,0,0.0,0,0,0.0,0,0,0.0,0,0,0.0,0,0,0,0,NO
11,src/java/main/org/apache/zookeeper/ClientCnxn.java,1088,72,36.0,72,127,63.5,127,199,99.5,199,55,27.5,55,2,0,2,YES
11,src/java/main/org/apache/zookeeper/ClientCnxnSocket.java,158,4,4.0,4,0,0.0,0,4,4.0,4,4,4.0,4,1,0,1,NO
11,src/java/main/org/apache/zookeeper/ClientCnxnSocketNIO.java,318,4,4.0,4,4,4.0,4,8,8.0,8,0,0.0,0,1,0,1,YES
11,src/java/main/org/apache/zookeeper/ClientWatchManager.java,39,0,0.0,0,0,0.0,0,0,0.0,0,0,0.0,0,0,0,0,NO
11,src/java/main/org/apache/zookeeper/CreateMode.java,89,0,0.0,0,0,0.0,0,0,0.0,0,0,0.0,0,0,0,0,NO
11,src/java/main/org/apache/zookeeper/Environment.java,100,0,0.0,0,0,0.0,0,0,0.0,0,0,0.0,0,0,0,0,NO
11,src/java/main/org/apache/zookeeper/JLineZNodeCompletor.java,84,0,0.0,0,0,0.0,0,0,0.0,0,0,0.0,0,0,0,0,NO
11,src/java/main/org/apache/zookeeper/KeeperException.java,662,0,0.0,0,0,0.0,0,0,0.0,0,0,0.0,0,0,0,0,NO
11,src/java/main/org/apache/zookeeper/Quotas.java,68,0,0.0,0,0,0.0,0,0,0.0,0,0,0.0,0,0,0,0,NO
11,src/java/main/org/apache/zookeeper/ServerAdminClient.java,312,0,0.0,0,0,0.0,0,0,0.0,0,0,0.0,0,0,0,0,NO
11,src/java/main/org/apache/zookeeper/StatsTrack.java,101,0,0.0,0,0,0.0,0,0,0.0,0,0,0.0,0,0,0,0,NO
11,src/java/main/org/apache/zookeeper/Version.java,79,3,3.0,3,2,2.0,2,5,5.0,5,1,1.0,1,1,1,1,NO
11,src/java/main/org/apache/zookeeper/WatchedEvent.java,79,0,0.0,0,0,0.0,0,0,0.0,0,0,0.0,0,0,0,0,NO
11,src/java/main/org/apache/zookeeper/Watcher.java,132,0,0.0,0,0,0.0,0,0,0.0,0,0,0.0,0,0,0,0,NO
11,src/java/main/org/apache/zookeeper/ZooDefs.java,113,0,0.0,0,0,0.0,0,0,0.0,0,0,0.0,0,0,0,0,NO
11,src/java/main/org/apache/zookeeper/ZooKeeper.java,1669,20,20.0,20,4,4.0,4,24,24.0,24,16,16.0,16,1,0,1,YES
11,src/java/main/org/apache/zookeeper/ZooKeeperMain.java,840,0,0.0,0,0,0.0,0,0,0.0,0,0,0.0,0,0,0,0,YES
11,src/java/main/org/apache/zookeeper/client/ConnectStringParser.java,87,87,87.0,87,0,0.0,0,87,87.0,87,87,87.0,87,1,0,1,NO
11,src/java/main/org/apache/zookeeper/client/HostProvider.java,61,61,61.0,61,0,0.0,0,61,61.0,61,61,61.0,61,1,0,1,NO
11,src/java/main/org/apache/zookeeper/client/StaticHostProvider.java,98,98,98.0,98,0,0.0,0,98,98.0,98,98,98.0,98,1,0,1,NO
11,src/java/main/org/apache/zookeeper/common/PathTrie.java,283,0,0.0,0,0,0.0,0,0,0.0,0,0,0.0,0,0,0,0,NO
11,src/java/main/org/apache/zookeeper/common/PathUtils.java,103,0,0.0,0,0,0.0,0,0,0.0,0,0,0.0,0,0,0,0,NO
11,src/java/main/org/apache/zookeeper/jmx/CommonNames.java,29,0,0.0,0,0,0.0,0,0,0.0,0,0,0.0,0,0,0,0,NO
11,src/java/main/org/apache/zookeeper/jmx/MBeanRegistry.java,194,0,0.0,0,0,0.0,0,0,0.0,0,0,0.0,0,0,0,0,NO
11,src/java/main/org/apache/zookeeper/jmx/ManagedUtil.java,72,0,0.0,0,0,0.0,0,0,0.0,0,0,0.0,0,0,0,0,NO
11,src/java/main/org/apache/zookeeper/jmx/ZKMBeanInfo.java,36,0,0.0,0,0,0.0,0,0,0.0,0,0,0.0,0,0,0,0,NO
11,src/java/main/org/apache/zookeeper/server/ByteBufferInputStream.java,72,0,0.0,0,0,0.0,0,0,0.0,0,0,0.0,0,0,0,0,YES
11,src/java/main/org/apache/zookeeper/server/ConnectionBean.java,172,0,0.0,0,0,0.0,0,0,0.0,0,0,0.0,0,0,0,0,NO
11,src/java/main/org/apache/zookeeper/server/ConnectionMXBean.java,98,0,0.0,0,0,0.0,0,0,0.0,0,0,0.0,0,0,0,0,NO
11,src/java/main/org/apache/zookeeper/server/DataNode.java,170,0,0.0,0,0,0.0,0,0,0.0,0,0,0.0,0,0,0,0,YES
11,src/java/main/org/apache/zookeeper/server/DataTree.java,1194,0,0.0,0,0,0.0,0,0,0.0,0,0,0.0,0,0,0,0,YES
11,src/java/main/org/apache/zookeeper/server/DataTreeBean.java,61,0,0.0,0,0,0.0,0,0,0.0,0,0,0.0,0,0,0,0,NO
11,src/java/main/org/apache/zookeeper/server/DataTreeMXBean.java,47,0,0.0,0,0,0.0,0,0,0.0,0,0,0.0,0,0,0,0,NO
11,src/java/main/org/apache/zookeeper/server/FinalRequestProcessor.java,376,0,0.0,0,0,0.0,0,0,0.0,0,0,0.0,0,0,0,0,YES
11,src/java/main/org/apache/zookeeper/server/LogFormatter.java,107,0,0.0,0,0,0.0,0,0,0.0,0,0,0.0,0,0,0,0,YES
11,src/java/main/org/apache/zookeeper/server/NIOServerCnxn.java,1123,0,0.0,0,0,0.0,0,0,0.0,0,0,0.0,0,0,0,0,YES
11,src/java/main/org/apache/zookeeper/server/NIOServerCnxnFactory.java,306,0,0.0,0,0,0.0,0,0,0.0,0,0,0.0,0,0,0,0,NO
11,src/java/main/org/apache/zookeeper/server/NettyServerCnxn.java,820,0,0.0,0,0,0.0,0,0,0.0,0,0,0.0,0,0,0,0,NO
11,src/java/main/org/apache/zookeeper/server/NettyServerCnxnFactory.java,396,0,0.0,0,0,0.0,0,0,0.0,0,0,0.0,0,0,0,0,NO
11,src/java/main/org/apache/zookeeper/server/ObserverBean.java,45,0,0.0,0,0,0.0,0,0,0.0,0,0,0.0,0,0,0,0,NO
11,src/java/main/org/apache/zookeeper/server/PrepRequestProcessor.java,516,0,0.0,0,0,0.0,0,0,0.0,0,0,0.0,0,0,0,0,YES
11,src/java/main/org/apache/zookeeper/server/PurgeTxnLog.java,132,0,0.0,0,0,0.0,0,0,0.0,0,0,0.0,0,0,0,0,NO
11,src/java/main/org/apache/zookeeper/server/Request.java,232,0,0.0,0,0,0.0,0,0,0.0,0,0,0.0,0,0,0,0,YES
11,src/java/main/org/apache/zookeeper/server/RequestProcessor.java,37,0,0.0,0,0,0.0,0,0,0.0,0,0,0.0,0,0,0,0,YES
11,src/java/main/org/apache/zookeeper/server/ServerCnxn.java,432,0,0.0,0,0,0.0,0,0,0.0,0,0,0.0,0,0,0,0,NO
11,src/java/main/org/apache/zookeeper/server/ServerCnxnFactory.java,134,0,0.0,0,0,0.0,0,0,0.0,0,0,0.0,0,0,0,0,NO
11,src/java/main/org/apache/zookeeper/server/ServerConfig.java,111,0,0.0,0,0,0.0,0,0,0.0,0,0,0.0,0,0,0,0,NO
11,src/java/main/org/apache/zookeeper/server/ServerStats.java,132,0,0.0,0,0,0.0,0,0,0.0,0,0,0.0,0,0,0,0,NO
11,src/java/main/org/apache/zookeeper/server/SessionTracker.java,74,0,0.0,0,0,0.0,0,0,0.0,0,0,0.0,0,0,0,0,YES
11,src/java/main/org/apache/zookeeper/server/SessionTrackerImpl.java,259,0,0.0,0,0,0.0,0,0,0.0,0,0,0.0,0,0,0,0,YES
11,src/java/main/org/apache/zookeeper/server/Stats.java,68,0,0.0,0,0,0.0,0,0,0.0,0,0,0.0,0,0,0,0,NO
11,src/java/main/org/apache/zookeeper/server/SyncRequestProcessor.java,184,0,0.0,0,0,0.0,0,0,0.0,0,0,0.0,0,0,0,0,YES
11,src/java/main/org/apache/zookeeper/server/TraceFormatter.java,121,0,0.0,0,0,0.0,0,0,0.0,0,0,0.0,0,0,0,0,NO
11,src/java/main/org/apache/zookeeper/server/WatchManager.java,170,0,0.0,0,0,0.0,0,0,0.0,0,0,0.0,0,0,0,0,NO
11,src/java/main/org/apache/zookeeper/server/ZKDatabase.java,494,38,38.0,38,9,9.0,9,47,47.0,47,29,29.0,29,1,1,1,NO
11,src/java/main/org/apache/zookeeper/server/ZooKeeperServer.java,865,0,0.0,0,0,0.0,0,0,0.0,0,0,0.0,0,0,0,0,YES
11,src/java/main/org/apache/zookeeper/server/ZooKeeperServerBean.java,143,0,0.0,0,0,0.0,0,0,0.0,0,0,0.0,0,0,0,0,NO
11,src/java/main/org/apache/zookeeper/server/ZooKeeperServerMXBean.java,106,0,0.0,0,0,0.0,0,0,0.0,0,0,0.0,0,0,0,0,NO
11,src/java/main/org/apache/zookeeper/server/ZooKeeperServerMain.java,128,0,0.0,0,0,0.0,0,0,0.0,0,0,0.0,0,0,0,0,NO
11,src/java/main/org/apache/zookeeper/server/ZooTrace.java,92,0,0.0,0,0,0.0,0,0,0.0,0,0,0.0,0,0,0,0,NO
11,src/java/main/org/apache/zookeeper/server/auth/AuthenticationProvider.java,82,0,0.0,0,0,0.0,0,0,0.0,0,0,0.0,0,0,0,0,NO
11,src/java/main/org/apache/zookeeper/server/auth/DigestAuthenticationProvider.java,138,0,0.0,0,0,0.0,0,0,0.0,0,0,0.0,0,0,0,0,NO
11,src/java/main/org/apache/zookeeper/server/auth/IPAuthenticationProvider.java,117,0,0.0,0,0,0.0,0,0,0.0,0,0,0.0,0,0,0,0,NO
11,src/java/main/org/apache/zookeeper/server/auth/ProviderRegistry.java,76,0,0.0,0,0,0.0,0,0,0.0,0,0,0.0,0,0,0,0,NO
11,src/java/main/org/apache/zookeeper/server/persistence/FileSnap.java,249,0,0.0,0,0,0.0,0,0,0.0,0,0,0.0,0,0,0,0,NO
11,src/java/main/org/apache/zookeeper/server/persistence/FileTxnLog.java,612,4,4.0,4,1,1.0,1,5,5.0,5,3,3.0,3,1,1,1,YES
11,src/java/main/org/apache/zookeeper/server/persistence/FileTxnSnapLog.java,296,1,1.0,1,1,1.0,1,2,2.0,2,0,0.0,0,1,1,1,YES
11,src/java/main/org/apache/zookeeper/server/persistence/SnapShot.java,66,0,0.0,0,0,0.0,0,0,0.0,0,0,0.0,0,0,0,0,NO
11,src/java/main/org/apache/zookeeper/server/persistence/TxnLog.java,120,0,0.0,0,0,0.0,0,0,0.0,0,0,0.0,0,0,0,0,NO
11,src/java/main/org/apache/zookeeper/server/persistence/Util.java,325,0,0.0,0,0,0.0,0,0,0.0,0,0,0.0,0,0,0,0,YES
11,src/java/main/org/apache/zookeeper/server/quorum/AckRequestProcessor.java,53,0,0.0,0,0,0.0,0,0,0.0,0,0,0.0,0,0,0,0,NO
11,src/java/main/org/apache/zookeeper/server/quorum/AuthFastLeaderElection.java,974,98,98.0,98,92,92.0,92,190,190.0,190,6,6.0,6,1,0,1,NO
11,src/java/main/org/apache/zookeeper/server/quorum/CommitProcessor.java,190,2,2.0,2,2,2.0,2,4,4.0,4,0,0.0,0,1,1,1,YES
11,src/java/main/org/apache/zookeeper/server/quorum/Election.java,27,0,0.0,0,0,0.0,0,0,0.0,0,0,0.0,0,0,0,0,NO
11,src/java/main/org/apache/zookeeper/server/quorum/FastLeaderElection.java,842,0,0.0,0,0,0.0,0,0,0.0,0,0,0.0,0,0,0,0,YES
11,src/java/main/org/apache/zookeeper/server/quorum/Follower.java,164,3,1.5,3,7,3.5,7,10,5.0,10,4,2.0,4,2,1,2,YES
11,src/java/main/org/apache/zookeeper/server/quorum/FollowerBean.java,50,0,0.0,0,0,0.0,0,0,0.0,0,0,0.0,0,0,0,0,NO
11,src/java/main/org/apache/zookeeper/server/quorum/FollowerMXBean.java,41,0,0.0,0,0,0.0,0,0,0.0,0,0,0.0,0,0,0,0,NO
11,src/java/main/org/apache/zookeeper/server/quorum/FollowerRequestProcessor.java,110,0,0.0,0,0,0.0,0,0,0.0,0,0,0.0,0,0,0,0,YES
11,src/java/main/org/apache/zookeeper/server/quorum/FollowerZooKeeperServer.java,163,0,0.0,0,0,0.0,0,0,0.0,0,0,0.0,0,0,0,0,NO
11,src/java/main/org/apache/zookeeper/server/quorum/Leader.java,736,0,0.0,0,0,0.0,0,0,0.0,0,0,0.0,0,0,0,0,YES
11,src/java/main/org/apache/zookeeper/server/quorum/LeaderBean.java,53,0,0.0,0,0,0.0,0,0,0.0,0,0,0.0,0,0,0,0,NO
11,src/java/main/org/apache/zookeeper/server/quorum/LeaderElection.java,274,1,1.0,1,1,1.0,1,2,2.0,2,0,0.0,0,1,0,1,NO
11,src/java/main/org/apache/zookeeper/server/quorum/LeaderElectionBean.java,42,0,0.0,0,0,0.0,0,0,0.0,0,0,0.0,0,0,0,0,NO
11,src/java/main/org/apache/zookeeper/server/quorum/LeaderElectionMXBean.java,31,0,0.0,0,0,0.0,0,0,0.0,0,0,0.0,0,0,0,0,NO
11,src/java/main/org/apache/zookeeper/server/quorum/LeaderMXBean.java,36,0,0.0,0,0,0.0,0,0,0.0,0,0,0.0,0,0,0,0,NO
11,src/java/main/org/apache/zookeeper/server/quorum/LeaderZooKeeperServer.java,176,0,0.0,0,0,0.0,0,0,0.0,0,0,0.0,0,0,0,0,NO
11,src/java/main/org/apache/zookeeper/server/quorum/Learner.java,432,68,34.0,68,13,6.5,13,81,40.5,81,59,29.5,59,2,1,2,YES
11,src/java/main/org/apache/zookeeper/server/quorum/LearnerHandler.java,524,37,37.0,37,42,42.0,42,79,79.0,79,5,5.0,5,1,1,1,YES
11,src/java/main/org/apache/zookeeper/server/quorum/LearnerSessionTracker.java,92,0,0.0,0,0,0.0,0,0,0.0,0,0,0.0,0,0,0,0,YES
11,src/java/main/org/apache/zookeeper/server/quorum/LearnerSyncRequest.java,34,0,0.0,0,0,0.0,0,0,0.0,0,0,0.0,0,0,0,0,NO
11,src/java/main/org/apache/zookeeper/server/quorum/LearnerZooKeeperServer.java,142,0,0.0,0,0,0.0,0,0,0.0,0,0,0.0,0,0,0,0,NO
11,src/java/main/org/apache/zookeeper/server/quorum/LocalPeerBean.java,79,0,0.0,0,0,0.0,0,0,0.0,0,0,0.0,0,0,0,0,NO
11,src/java/main/org/apache/zookeeper/server/quorum/LocalPeerMXBean.java,77,0,0.0,0,0,0.0,0,0,0.0,0,0,0.0,0,0,0,0,NO
11,src/java/main/org/apache/zookeeper/server/quorum/Observer.java,142,3,1.5,3,7,3.5,7,10,5.0,10,4,2.0,4,2,1,2,YES
11,src/java/main/org/apache/zookeeper/server/quorum/ObserverMXBean.java,37,0,0.0,0,0,0.0,0,0,0.0,0,0,0.0,0,0,0,0,NO
11,src/java/main/org/apache/zookeeper/server/quorum/ObserverRequestProcessor.java,124,0,0.0,0,0,0.0,0,0,0.0,0,0,0.0,0,0,0,0,YES
11,src/java/main/org/apache/zookeeper/server/quorum/ObserverZooKeeperServer.java,116,0,0.0,0,0,0.0,0,0,0.0,0,0,0.0,0,0,0,0,NO
11,src/java/main/org/apache/zookeeper/server/quorum/ProposalRequestProcessor.java,88,0,0.0,0,0,0.0,0,0,0.0,0,0,0.0,0,0,0,0,YES
11,src/java/main/org/apache/zookeeper/server/quorum/QuorumBean.java,44,0,0.0,0,0,0.0,0,0,0.0,0,0,0.0,0,0,0,0,NO
11,src/java/main/org/apache/zookeeper/server/quorum/QuorumCnxManager.java,730,204,102.0,204,189,94.5,189,393,196.5,393,21,10.5,21,2,0,2,YES
11,src/java/main/org/apache/zookeeper/server/quorum/QuorumMXBean.java,34,0,0.0,0,0,0.0,0,0,0.0,0,0,0.0,0,0,0,0,NO
11,src/java/main/org/apache/zookeeper/server/quorum/QuorumPeer.java,960,0,0.0,0,0,0.0,0,0,0.0,0,0,0.0,0,0,0,0,YES
11,src/java/main/org/apache/zookeeper/server/quorum/QuorumPeerConfig.java,381,0,0.0,0,0,0.0,0,0,0.0,0,0,0.0,0,0,0,0,NO
11,src/java/main/org/apache/zookeeper/server/quorum/QuorumPeerMain.java,150,0,0.0,0,0,0.0,0,0,0.0,0,0,0.0,0,0,0,0,NO
11,src/java/main/org/apache/zookeeper/server/quorum/QuorumStats.java,68,0,0.0,0,0,0.0,0,0,0.0,0,0,0.0,0,0,0,0,NO
11,src/java/main/org/apache/zookeeper/server/quorum/QuorumZooKeeperServer.java,62,0,0.0,0,0,0.0,0,0,0.0,0,0,0.0,0,0,0,0,NO
11,src/java/main/org/apache/zookeeper/server/quorum/RemotePeerBean.java,45,0,0.0,0,0,0.0,0,0,0.0,0,0,0.0,0,0,0,0,NO
11,src/java/main/org/apache/zookeeper/server/quorum/RemotePeerMXBean.java,33,0,0.0,0,0,0.0,0,0,0.0,0,0,0.0,0,0,0,0,NO
11,src/java/main/org/apache/zookeeper/server/quorum/SendAckRequestProcessor.java,79,0,0.0,0,0,0.0,0,0,0.0,0,0,0.0,0,0,0,0,NO
11,src/java/main/org/apache/zookeeper/server/quorum/ServerBean.java,38,0,0.0,0,0,0.0,0,0,0.0,0,0,0.0,0,0,0,0,NO
11,src/java/main/org/apache/zookeeper/server/quorum/ServerMXBean.java,33,0,0.0,0,0,0.0,0,0,0.0,0,0,0.0,0,0,0,0,NO
11,src/java/main/org/apache/zookeeper/server/quorum/Vote.java,69,0,0.0,0,0,0.0,0,0,0.0,0,0,0.0,0,0,0,0,YES
11,src/java/main/org/apache/zookeeper/server/quorum/flexible/QuorumHierarchical.java,272,0,0.0,0,0,0.0,0,0,0.0,0,0,0.0,0,0,0,0,NO
11,src/java/main/org/apache/zookeeper/server/quorum/flexible/QuorumMaj.java,57,0,0.0,0,0,0.0,0,0,0.0,0,0,0.0,0,0,0,0,NO
11,src/java/main/org/apache/zookeeper/server/quorum/flexible/QuorumVerifier.java,33,0,0.0,0,0,0.0,0,0,0.0,0,0,0.0,0,0,0,0,NO
11,src/java/main/org/apache/zookeeper/server/upgrade/DataNodeV1.java,129,0,0.0,0,0,0.0,0,0,0.0,0,0,0.0,0,0,0,0,NO
11,src/java/main/org/apache/zookeeper/server/upgrade/DataTreeV1.java,583,0,0.0,0,0,0.0,0,0,0.0,0,0,0.0,0,0,0,0,NO
11,src/java/main/org/apache/zookeeper/server/upgrade/UpgradeMain.java,180,0,0.0,0,0,0.0,0,0,0.0,0,0,0.0,0,0,0,0,NO
11,src/java/main/org/apache/zookeeper/server/upgrade/UpgradeSnapShot.java,33,0,0.0,0,0,0.0,0,0,0.0,0,0,0.0,0,0,0,0,NO
11,src/java/main/org/apache/zookeeper/server/upgrade/UpgradeSnapShotV1.java,333,0,0.0,0,0,0.0,0,0,0.0,0,0,0.0,0,0,0,0,YES
11,src/java/main/org/apache/zookeeper/server/util/Profiler.java,40,0,0.0,0,0,0.0,0,0,0.0,0,0,0.0,0,0,0,0,NO
11,src/java/main/org/apache/zookeeper/server/util/SerializeUtils.java,107,0,0.0,0,0,0.0,0,0,0.0,0,0,0.0,0,0,0,0,YES
11,src/java/main/org/apache/zookeeper/version/util/VerGen.java,177,49,49.0,49,18,18.0,18,67,67.0,67,31,31.0,31,1,1,1,NO
11,src/recipes/lock/src/java/org/apache/zookeeper/recipes/lock/LockListener.java,38,0,0.0,0,0,0.0,0,0,0.0,0,0,0.0,0,0,0,0,NO
11,src/recipes/lock/src/java/org/apache/zookeeper/recipes/lock/ProtocolSupport.java,192,0,0.0,0,0,0.0,0,0,0.0,0,0,0.0,0,0,0,0,NO
11,src/recipes/lock/src/java/org/apache/zookeeper/recipes/lock/WriteLock.java,294,0,0.0,0,0,0.0,0,0,0.0,0,0,0.0,0,0,0,0,NO
11,src/recipes/lock/src/java/org/apache/zookeeper/recipes/lock/ZNodeName.java,109,0,0.0,0,0,0.0,0,0,0.0,0,0,0.0,0,0,0,0,NO
11,src/recipes/lock/src/java/org/apache/zookeeper/recipes/lock/ZooKeeperOperation.java,38,0,0.0,0,0,0.0,0,0,0.0,0,0,0.0,0,0,0,0,NO
11,src/recipes/queue/src/java/org/apache/zookeeper/recipes/queue/DistributedQueue.java,312,0,0.0,0,0,0.0,0,0,0.0,0,0,0.0,0,0,0,0,NO
12,src/contrib/fatjar/src/java/org/apache/zookeeper/util/FatJarMain.java,126,0,0.0,0,0,0.0,0,0,0.0,0,0,0.0,0,0,0,0,NO
12,src/contrib/loggraph/src/java/org/apache/zookeeper/graph/FilterException.java,22,0,0.0,0,0,0.0,0,0,0.0,0,0,0.0,0,0,0,0,NO
12,src/contrib/loggraph/src/java/org/apache/zookeeper/graph/FilterOp.java,75,1,1.0,1,1,1.0,1,2,2.0,2,0,0.0,0,1,0,1,NO
12,src/contrib/loggraph/src/java/org/apache/zookeeper/graph/FilterParser.java,131,1,1.0,1,1,1.0,1,2,2.0,2,0,0.0,0,1,0,1,NO
12,src/contrib/loggraph/src/java/org/apache/zookeeper/graph/JsonGenerator.java,223,0,0.0,0,0,0.0,0,0,0.0,0,0,0.0,0,0,0,0,NO
12,src/contrib/loggraph/src/java/org/apache/zookeeper/graph/Log4JEntry.java,40,1,1.0,1,1,1.0,1,2,2.0,2,0,0.0,0,1,0,1,NO
12,src/contrib/loggraph/src/java/org/apache/zookeeper/graph/Log4JSource.java,381,4,4.0,4,3,3.0,3,7,7.0,7,1,1.0,1,1,0,1,NO
12,src/contrib/loggraph/src/java/org/apache/zookeeper/graph/LogEntry.java,46,0,0.0,0,0,0.0,0,0,0.0,0,0,0.0,0,0,0,0,NO
12,src/contrib/loggraph/src/java/org/apache/zookeeper/graph/LogIterator.java,26,1,1.0,1,1,1.0,1,2,2.0,2,0,0.0,0,1,0,1,NO
12,src/contrib/loggraph/src/java/org/apache/zookeeper/graph/LogServer.java,66,1,1.0,1,1,1.0,1,2,2.0,2,0,0.0,0,1,0,1,NO
12,src/contrib/loggraph/src/java/org/apache/zookeeper/graph/LogSkipList.java,95,4,4.0,4,3,3.0,3,7,7.0,7,1,1.0,1,1,0,1,NO
12,src/contrib/loggraph/src/java/org/apache/zookeeper/graph/LogSource.java,33,0,0.0,0,0,0.0,0,0,0.0,0,0,0.0,0,0,0,0,NO
12,src/contrib/loggraph/src/java/org/apache/zookeeper/graph/MeasureThroughput.java,103,1,1.0,1,1,1.0,1,2,2.0,2,0,0.0,0,1,0,1,NO
12,src/contrib/loggraph/src/java/org/apache/zookeeper/graph/MergedLogSource.java,219,3,3.0,3,2,2.0,2,5,5.0,5,1,1.0,1,1,0,1,NO
12,src/contrib/loggraph/src/java/org/apache/zookeeper/graph/RandomAccessFileReader.java,328,4,4.0,4,3,3.0,3,7,7.0,7,1,1.0,1,1,0,1,NO
12,src/contrib/loggraph/src/java/org/apache/zookeeper/graph/TransactionEntry.java,59,1,1.0,1,1,1.0,1,2,2.0,2,0,0.0,0,1,0,1,NO
12,src/contrib/loggraph/src/java/org/apache/zookeeper/graph/TxnLogSource.java,376,5,2.5,5,6,3.0,6,11,5.5,11,3,1.5,3,2,1,2,NO
12,src/contrib/loggraph/src/java/org/apache/zookeeper/graph/filterops/AndOp.java,33,0,0.0,0,0,0.0,0,0,0.0,0,0,0.0,0,0,0,0,NO
12,src/contrib/loggraph/src/java/org/apache/zookeeper/graph/filterops/Arg.java,36,0,0.0,0,0,0.0,0,0,0.0,0,0,0.0,0,0,0,0,NO
12,src/contrib/loggraph/src/java/org/apache/zookeeper/graph/filterops/EqualsOp.java,44,0,0.0,0,0,0.0,0,0,0.0,0,0,0.0,0,0,0,0,NO
12,src/contrib/loggraph/src/java/org/apache/zookeeper/graph/filterops/GreaterThanOp.java,70,0,0.0,0,0,0.0,0,0,0.0,0,0,0.0,0,0,0,0,NO
12,src/contrib/loggraph/src/java/org/apache/zookeeper/graph/filterops/LessThanOp.java,69,0,0.0,0,0,0.0,0,0,0.0,0,0,0.0,0,0,0,0,NO
12,src/contrib/loggraph/src/java/org/apache/zookeeper/graph/filterops/NotOp.java,31,0,0.0,0,0,0.0,0,0,0.0,0,0,0.0,0,0,0,0,NO
12,src/contrib/loggraph/src/java/org/apache/zookeeper/graph/filterops/NumberArg.java,27,0,0.0,0,0,0.0,0,0,0.0,0,0,0.0,0,0,0,0,NO
12,src/contrib/loggraph/src/java/org/apache/zookeeper/graph/filterops/OrOp.java,33,0,0.0,0,0,0.0,0,0,0.0,0,0,0.0,0,0,0,0,NO
12,src/contrib/loggraph/src/java/org/apache/zookeeper/graph/filterops/StringArg.java,27,0,0.0,0,0,0.0,0,0,0.0,0,0,0.0,0,0,0,0,NO
12,src/contrib/loggraph/src/java/org/apache/zookeeper/graph/filterops/SymbolArg.java,27,0,0.0,0,0,0.0,0,0,0.0,0,0,0.0,0,0,0,0,NO
12,src/contrib/loggraph/src/java/org/apache/zookeeper/graph/filterops/XorOp.java,40,0,0.0,0,0,0.0,0,0,0.0,0,0,0.0,0,0,0,0,NO
12,src/contrib/loggraph/src/java/org/apache/zookeeper/graph/servlets/FileLoader.java,60,1,1.0,1,1,1.0,1,2,2.0,2,0,0.0,0,1,0,1,NO
12,src/contrib/loggraph/src/java/org/apache/zookeeper/graph/servlets/Fs.java,69,1,1.0,1,1,1.0,1,2,2.0,2,0,0.0,0,1,0,1,NO
12,src/contrib/loggraph/src/java/org/apache/zookeeper/graph/servlets/GraphData.java,85,4,4.0,4,3,3.0,3,7,7.0,7,1,1.0,1,1,0,1,NO
12,src/contrib/loggraph/src/java/org/apache/zookeeper/graph/servlets/JsonServlet.java,85,0,0.0,0,0,0.0,0,0,0.0,0,0,0.0,0,0,0,0,NO
12,src/contrib/loggraph/src/java/org/apache/zookeeper/graph/servlets/NumEvents.java,86,3,3.0,3,2,2.0,2,5,5.0,5,1,1.0,1,1,0,1,NO
12,src/contrib/loggraph/src/java/org/apache/zookeeper/graph/servlets/StaticContent.java,50,0,0.0,0,0,0.0,0,0,0.0,0,0,0.0,0,0,0,0,NO
12,src/contrib/loggraph/src/java/org/apache/zookeeper/graph/servlets/Throughput.java,125,2,2.0,2,1,1.0,1,3,3.0,3,1,1.0,1,1,0,1,NO
12,src/contrib/rest/src/java/org/apache/zookeeper/server/jersey/RestMain.java,151,3,3.0,3,2,2.0,2,5,5.0,5,1,1.0,1,1,0,1,NO
12,src/contrib/rest/src/java/org/apache/zookeeper/server/jersey/ZooKeeperService.java,242,3,3.0,3,2,2.0,2,5,5.0,5,1,1.0,1,1,0,1,NO
12,src/contrib/rest/src/java/org/apache/zookeeper/server/jersey/cfg/Credentials.java,47,0,0.0,0,0,0.0,0,0,0.0,0,0,0.0,0,0,0,0,NO
12,src/contrib/rest/src/java/org/apache/zookeeper/server/jersey/cfg/Endpoint.java,72,0,0.0,0,0,0.0,0,0,0.0,0,0,0.0,0,0,0,0,NO
12,src/contrib/rest/src/java/org/apache/zookeeper/server/jersey/cfg/HostPort.java,51,0,0.0,0,0,0.0,0,0,0.0,0,0,0.0,0,0,0,0,NO
12,src/contrib/rest/src/java/org/apache/zookeeper/server/jersey/cfg/HostPortSet.java,51,0,0.0,0,0,0.0,0,0,0.0,0,0,0.0,0,0,0,0,NO
12,src/contrib/rest/src/java/org/apache/zookeeper/server/jersey/cfg/RestCfg.java,106,0,0.0,0,0,0.0,0,0,0.0,0,0,0.0,0,0,0,0,NO
12,src/contrib/rest/src/java/org/apache/zookeeper/server/jersey/filters/HTTPBasicAuth.java,87,0,0.0,0,0,0.0,0,0,0.0,0,0,0.0,0,0,0,0,NO
12,src/contrib/rest/src/java/org/apache/zookeeper/server/jersey/jaxb/ZChildren.java,80,0,0.0,0,0,0.0,0,0,0.0,0,0,0.0,0,0,0,0,NO
12,src/contrib/rest/src/java/org/apache/zookeeper/server/jersey/jaxb/ZChildrenJSON.java,76,0,0.0,0,0,0.0,0,0,0.0,0,0,0.0,0,0,0,0,NO
12,src/contrib/rest/src/java/org/apache/zookeeper/server/jersey/jaxb/ZError.java,41,0,0.0,0,0,0.0,0,0,0.0,0,0,0.0,0,0,0,0,NO
12,src/contrib/rest/src/java/org/apache/zookeeper/server/jersey/jaxb/ZPath.java,63,0,0.0,0,0,0.0,0,0,0.0,0,0,0.0,0,0,0,0,NO
12,src/contrib/rest/src/java/org/apache/zookeeper/server/jersey/jaxb/ZSession.java,55,0,0.0,0,0,0.0,0,0,0.0,0,0,0.0,0,0,0,0,NO
12,src/contrib/rest/src/java/org/apache/zookeeper/server/jersey/jaxb/ZStat.java,106,0,0.0,0,0,0.0,0,0,0.0,0,0,0.0,0,0,0,0,NO
12,src/contrib/rest/src/java/org/apache/zookeeper/server/jersey/resources/JAXBContextResolver.java,72,0,0.0,0,0,0.0,0,0,0.0,0,0,0.0,0,0,0,0,NO
12,src/contrib/rest/src/java/org/apache/zookeeper/server/jersey/resources/KeeperExceptionMapper.java,86,0,0.0,0,0,0.0,0,0,0.0,0,0,0.0,0,0,0,0,NO
12,src/contrib/rest/src/java/org/apache/zookeeper/server/jersey/resources/RuntimeExceptionMapper.java,55,0,0.0,0,0,0.0,0,0,0.0,0,0,0.0,0,0,0,0,NO
12,src/contrib/rest/src/java/org/apache/zookeeper/server/jersey/resources/SessionsResource.java,135,3,3.0,3,2,2.0,2,5,5.0,5,1,1.0,1,1,0,1,NO
12,src/contrib/rest/src/java/org/apache/zookeeper/server/jersey/resources/ZErrorWriter.java,63,0,0.0,0,0,0.0,0,0,0.0,0,0,0.0,0,0,0,0,NO
12,src/contrib/rest/src/java/org/apache/zookeeper/server/jersey/resources/ZNodeResource.java,412,0,0.0,0,0,0.0,0,0,0.0,0,0,0.0,0,0,0,0,NO
12,src/contrib/zooinspector/src/java/org/apache/zookeeper/inspector/ZooInspector.java,66,0,0.0,0,0,0.0,0,0,0.0,0,0,0.0,0,0,0,0,NO
12,src/contrib/zooinspector/src/java/org/apache/zookeeper/inspector/encryption/BasicDataEncryptionManager.java,50,0,0.0,0,0,0.0,0,0,0.0,0,0,0.0,0,0,0,0,NO
12,src/contrib/zooinspector/src/java/org/apache/zookeeper/inspector/encryption/DataEncryptionManager.java,39,0,0.0,0,0,0.0,0,0,0.0,0,0,0.0,0,0,0,0,NO
12,src/contrib/zooinspector/src/java/org/apache/zookeeper/inspector/gui/NodeViewersChangeListener.java,37,0,0.0,0,0,0.0,0,0,0.0,0,0,0.0,0,0,0,0,NO
12,src/contrib/zooinspector/src/java/org/apache/zookeeper/inspector/gui/ZooInspectorAboutDialog.java,80,0,0.0,0,0,0.0,0,0,0.0,0,0,0.0,0,0,0,0,NO
12,src/contrib/zooinspector/src/java/org/apache/zookeeper/inspector/gui/ZooInspectorConnectionPropertiesDialog.java,321,0,0.0,0,0,0.0,0,0,0.0,0,0,0.0,0,0,0,0,NO
12,src/contrib/zooinspector/src/java/org/apache/zookeeper/inspector/gui/ZooInspectorIconResources.java,118,0,0.0,0,0,0.0,0,0,0.0,0,0,0.0,0,0,0,0,NO
12,src/contrib/zooinspector/src/java/org/apache/zookeeper/inspector/gui/ZooInspectorNodeViewersDialog.java,605,0,0.0,0,0,0.0,0,0,0.0,0,0,0.0,0,0,0,0,NO
12,src/contrib/zooinspector/src/java/org/apache/zookeeper/inspector/gui/ZooInspectorNodeViewersPanel.java,140,0,0.0,0,0,0.0,0,0,0.0,0,0,0.0,0,0,0,0,NO
12,src/contrib/zooinspector/src/java/org/apache/zookeeper/inspector/gui/ZooInspectorPanel.java,361,0,0.0,0,0,0.0,0,0,0.0,0,0,0.0,0,0,0,0,NO
12,src/contrib/zooinspector/src/java/org/apache/zookeeper/inspector/gui/ZooInspectorTreeViewer.java,362,0,0.0,0,0,0.0,0,0,0.0,0,0,0.0,0,0,0,0,NO
12,src/contrib/zooinspector/src/java/org/apache/zookeeper/inspector/gui/nodeviewer/NodeViewerACL.java,187,0,0.0,0,0,0.0,0,0,0.0,0,0,0.0,0,0,0,0,NO
12,src/contrib/zooinspector/src/java/org/apache/zookeeper/inspector/gui/nodeviewer/NodeViewerData.java,146,0,0.0,0,0,0.0,0,0,0.0,0,0,0.0,0,0,0,0,NO
12,src/contrib/zooinspector/src/java/org/apache/zookeeper/inspector/gui/nodeviewer/NodeViewerMetaData.java,186,0,0.0,0,0,0.0,0,0,0.0,0,0,0.0,0,0,0,0,NO
12,src/contrib/zooinspector/src/java/org/apache/zookeeper/inspector/gui/nodeviewer/ZooInspectorNodeViewer.java,138,0,0.0,0,0,0.0,0,0,0.0,0,0,0.0,0,0,0,0,NO
12,src/contrib/zooinspector/src/java/org/apache/zookeeper/inspector/logger/LoggerFactory.java,36,2,2.0,2,4,4.0,4,6,6.0,6,2,2.0,2,1,0,1,NO
12,src/contrib/zooinspector/src/java/org/apache/zookeeper/inspector/manager/NodeListener.java,37,0,0.0,0,0,0.0,0,0,0.0,0,0,0.0,0,0,0,0,NO
12,src/contrib/zooinspector/src/java/org/apache/zookeeper/inspector/manager/Pair.java,120,0,0.0,0,0,0.0,0,0,0.0,0,0,0.0,0,0,0,0,NO
12,src/contrib/zooinspector/src/java/org/apache/zookeeper/inspector/manager/ZooInspectorManager.java,139,0,0.0,0,0,0.0,0,0,0.0,0,0,0.0,0,0,0,0,NO
12,src/contrib/zooinspector/src/java/org/apache/zookeeper/inspector/manager/ZooInspectorManagerImpl.java,852,0,0.0,0,0,0.0,0,0,0.0,0,0,0.0,0,0,0,0,NO
12,src/contrib/zooinspector/src/java/org/apache/zookeeper/inspector/manager/ZooInspectorNodeManager.java,33,0,0.0,0,0,0.0,0,0,0.0,0,0,0.0,0,0,0,0,NO
12,src/contrib/zooinspector/src/java/org/apache/zookeeper/inspector/manager/ZooInspectorNodeTreeManager.java,43,43,43.0,43,43,43.0,43,86,86.0,86,0,0.0,0,1,0,1,NO
12,src/contrib/zooinspector/src/java/org/apache/zookeeper/inspector/manager/ZooInspectorReadOnlyManager.java,99,99,99.0,99,99,99.0,99,198,198.0,198,0,0.0,0,1,0,1,NO
12,src/contrib/zooinspector/src/java/org/apache/zookeeper/retry/ZooKeeperRetry.java,288,0,0.0,0,0,0.0,0,0,0.0,0,0,0.0,0,0,0,0,NO
12,src/java/main/org/apache/jute/BinaryInputArchive.java,131,0,0.0,0,0,0.0,0,0,0.0,0,0,0.0,0,0,0,0,NO
12,src/java/main/org/apache/jute/BinaryOutputArchive.java,146,5,5.0,5,5,5.0,5,10,10.0,10,0,0.0,0,1,0,1,NO
12,src/java/main/org/apache/jute/CsvInputArchive.java,204,0,0.0,0,4,4.0,4,4,4.0,4,4,4.0,4,1,0,1,NO
12,src/java/main/org/apache/jute/CsvOutputArchive.java,150,4,4.0,4,4,4.0,4,8,8.0,8,0,0.0,0,1,0,1,NO
12,src/java/main/org/apache/jute/Index.java,38,0,0.0,0,0,0.0,0,0,0.0,0,0,0.0,0,0,0,0,NO
12,src/java/main/org/apache/jute/InputArchive.java,43,0,0.0,0,0,0.0,0,0,0.0,0,0,0.0,0,0,0,0,NO
12,src/java/main/org/apache/jute/OutputArchive.java,47,4,4.0,4,4,4.0,4,8,8.0,8,0,0.0,0,1,0,1,NO
12,src/java/main/org/apache/jute/Record.java,32,0,0.0,0,0,0.0,0,0,0.0,0,0,0.0,0,0,0,0,NO
12,src/java/main/org/apache/jute/RecordReader.java,93,6,6.0,6,6,6.0,6,12,12.0,12,0,0.0,0,1,0,1,NO
12,src/java/main/org/apache/jute/RecordWriter.java,93,6,6.0,6,26,26.0,26,32,32.0,32,20,20.0,20,1,0,1,NO
12,src/java/main/org/apache/jute/Utils.java,282,0,0.0,0,0,0.0,0,0,0.0,0,0,0.0,0,0,0,0,NO
12,src/java/main/org/apache/jute/XmlInputArchive.java,251,0,0.0,0,0,0.0,0,0,0.0,0,0,0.0,0,0,0,0,NO
12,src/java/main/org/apache/jute/XmlOutputArchive.java,251,4,4.0,4,4,4.0,4,8,8.0,8,0,0.0,0,1,0,1,NO
12,src/java/main/org/apache/jute/compiler/CGenerator.java,130,0,0.0,0,0,0.0,0,0,0.0,0,0,0.0,0,0,0,0,NO
12,src/java/main/org/apache/jute/compiler/CSharpGenerator.java,53,0,0.0,0,0,0.0,0,0,0.0,0,0,0.0,0,0,0,0,NO
12,src/java/main/org/apache/jute/compiler/CppGenerator.java,125,0,0.0,0,0,0.0,0,0,0.0,0,0,0.0,0,0,0,0,NO
12,src/java/main/org/apache/jute/compiler/JBoolean.java,50,0,0.0,0,0,0.0,0,0,0.0,0,0,0.0,0,0,0,0,NO
12,src/java/main/org/apache/jute/compiler/JBuffer.java,106,1,1.0,1,1,1.0,1,2,2.0,2,0,0.0,0,1,0,1,NO
12,src/java/main/org/apache/jute/compiler/JByte.java,34,0,0.0,0,0,0.0,0,0,0.0,0,0,0.0,0,0,0,0,NO
12,src/java/main/org/apache/jute/compiler/JCompType.java,66,0,0.0,0,0,0.0,0,0,0.0,0,0,0.0,0,0,0,0,NO
12,src/java/main/org/apache/jute/compiler/JDouble.java,40,0,0.0,0,0,0.0,0,0,0.0,0,0,0.0,0,0,0,0,NO
12,src/java/main/org/apache/jute/compiler/JField.java,140,0,0.0,0,0,0.0,0,0,0.0,0,0,0.0,0,0,0,0,NO
12,src/java/main/org/apache/jute/compiler/JFile.java,84,0,0.0,0,0,0.0,0,0,0.0,0,0,0.0,0,0,0,0,NO
12,src/java/main/org/apache/jute/compiler/JFloat.java,39,0,0.0,0,0,0.0,0,0,0.0,0,0,0.0,0,0,0,0,NO
12,src/java/main/org/apache/jute/compiler/JInt.java,34,0,0.0,0,0,0.0,0,0,0.0,0,0,0.0,0,0,0,0,NO
12,src/java/main/org/apache/jute/compiler/JLong.java,38,0,0.0,0,0,0.0,0,0,0.0,0,0,0.0,0,0,0,0,NO
12,src/java/main/org/apache/jute/compiler/JMap.java,149,0,0.0,0,0,0.0,0,0,0.0,0,0,0.0,0,0,0,0,NO
12,src/java/main/org/apache/jute/compiler/JRecord.java,761,10,5.0,10,11,5.5,11,21,10.5,21,1,0.5,1,2,0,2,NO
12,src/java/main/org/apache/jute/compiler/JString.java,46,0,0.0,0,0,0.0,0,0,0.0,0,0,0.0,0,0,0,0,NO
12,src/java/main/org/apache/jute/compiler/JType.java,204,0,0.0,0,0,0.0,0,0,0.0,0,0,0.0,0,0,0,0,NO
12,src/java/main/org/apache/jute/compiler/JVector.java,153,0,0.0,0,0,0.0,0,0,0.0,0,0,0.0,0,0,0,0,NO
12,src/java/main/org/apache/jute/compiler/JavaGenerator.java,57,0,0.0,0,0,0.0,0,0,0.0,0,0,0.0,0,0,0,0,NO
12,src/java/main/org/apache/zookeeper/AsyncCallback.java,57,0,0.0,0,0,0.0,0,0,0.0,0,0,0.0,0,0,0,0,NO
12,src/java/main/org/apache/zookeeper/ClientCnxn.java,1307,284,35.5,284,65,8.125,65,349,43.625,349,219,27.375,219,8,4,4,YES
12,src/java/main/org/apache/zookeeper/ClientCnxnSocket.java,170,19,6.3333335,19,7,2.3333333,7,26,8.666667,26,12,4.0,12,3,0,3,NO
12,src/java/main/org/apache/zookeeper/ClientCnxnSocketNIO.java,339,83,10.375,83,62,7.75,62,145,18.125,145,49,6.125,49,8,4,5,NO
12,src/java/main/org/apache/zookeeper/ClientWatchManager.java,40,3,3.0,3,2,2.0,2,5,5.0,5,1,1.0,1,1,0,1,NO
12,src/java/main/org/apache/zookeeper/CreateMode.java,90,3,3.0,3,2,2.0,2,5,5.0,5,1,1.0,1,1,0,1,YES
12,src/java/main/org/apache/zookeeper/Environment.java,100,2,1.0,2,2,1.0,2,4,2.0,4,2,1.0,2,2,0,2,NO
12,src/java/main/org/apache/zookeeper/JLineZNodeCompletor.java,84,1,1.0,1,1,1.0,1,2,2.0,2,0,0.0,0,1,0,1,NO
12,src/java/main/org/apache/zookeeper/KeeperException.java,699,38,19.0,38,1,0.5,1,39,19.5,39,37,18.5,37,2,0,2,NO
12,src/java/main/org/apache/zookeeper/Login.java,389,559,186.33333,559,170,56.666668,170,729,243.0,729,401,133.66667,401,3,0,2,NO
12,src/java/main/org/apache/zookeeper/MultiResponse.java,165,166,83.0,166,1,0.5,1,167,83.5,167,167,83.5,167,2,0,2,NO
12,src/java/main/org/apache/zookeeper/MultiTransactionRecord.java,159,160,80.0,160,1,0.5,1,161,80.5,161,161,80.5,161,2,0,2,NO
12,src/java/main/org/apache/zookeeper/Op.java,305,306,153.0,306,1,0.5,1,307,153.5,307,307,153.5,307,2,0,2,YES
12,src/java/main/org/apache/zookeeper/OpResult.java,185,185,185.0,185,0,0.0,0,185,185.0,185,185,185.0,185,1,0,1,YES
12,src/java/main/org/apache/zookeeper/Quotas.java,68,0,0.0,0,0,0.0,0,0,0.0,0,0,0.0,0,0,0,0,NO
12,src/java/main/org/apache/zookeeper/ServerAdminClient.java,277,3,1.5,3,38,19.0,38,41,20.5,41,37,18.5,37,2,0,2,NO
12,src/java/main/org/apache/zookeeper/Shell.java,476,476,238.0,476,0,0.0,0,476,238.0,476,476,238.0,476,2,0,2,NO
12,src/java/main/org/apache/zookeeper/StatsTrack.java,101,0,0.0,0,0,0.0,0,0,0.0,0,0,0.0,0,0,0,0,NO
12,src/java/main/org/apache/zookeeper/Transaction.java,60,60,60.0,60,0,0.0,0,60,60.0,60,60,60.0,60,1,0,1,YES
12,src/java/main/org/apache/zookeeper/Version.java,79,0,0.0,0,0,0.0,0,0,0.0,0,0,0.0,0,0,0,0,NO
12,src/java/main/org/apache/zookeeper/WatchedEvent.java,79,0,0.0,0,0,0.0,0,0,0.0,0,0,0.0,0,0,0,0,NO
12,src/java/main/org/apache/zookeeper/Watcher.java,149,24,12.0,24,7,3.5,7,31,15.5,31,17,8.5,17,2,0,2,NO
12,src/java/main/org/apache/zookeeper/ZKUtil.java,124,124,124.0,124,0,0.0,0,124,124.0,124,124,124.0,124,1,0,1,NO
12,src/java/main/org/apache/zookeeper/ZooDefs.java,119,6,3.0,6,0,0.0,0,6,3.0,6,6,3.0,6,2,0,2,NO
12,src/java/main/org/apache/zookeeper/ZooKeeper.java,1746,271,33.875,271,194,24.25,194,465,58.125,465,267,33.375,267,8,4,5,YES
12,src/java/main/org/apache/zookeeper/ZooKeeperMain.java,868,44,6.285714,44,16,2.2857144,16,60,8.571428,60,30,4.285714,30,7,2,5,YES
12,src/java/main/org/apache/zookeeper/client/ConnectStringParser.java,87,0,0.0,0,0,0.0,0,0,0.0,0,0,0.0,0,0,0,0,NO
12,src/java/main/org/apache/zookeeper/client/HostProvider.java,61,0,0.0,0,0,0.0,0,0,0.0,0,0,0.0,0,0,0,0,NO
12,src/java/main/org/apache/zookeeper/client/StaticHostProvider.java,101,6,6.0,6,3,3.0,3,9,9.0,9,3,3.0,3,1,0,1,NO
12,src/java/main/org/apache/zookeeper/client/ZooKeeperSaslClient.java,355,358,179.0,358,3,1.5,3,361,180.5,361,355,177.5,355,2,0,1,NO
12,src/java/main/org/apache/zookeeper/common/PathTrie.java,284,4,4.0,4,3,3.0,3,7,7.0,7,1,1.0,1,1,0,1,NO
12,src/java/main/org/apache/zookeeper/common/PathUtils.java,103,0,0.0,0,0,0.0,0,0,0.0,0,0,0.0,0,0,0,0,NO
12,src/java/main/org/apache/zookeeper/jmx/CommonNames.java,29,0,0.0,0,0,0.0,0,0,0.0,0,0,0.0,0,0,0,0,NO
12,src/java/main/org/apache/zookeeper/jmx/MBeanRegistry.java,215,30,15.0,30,9,4.5,9,39,19.5,39,21,10.5,21,2,0,2,NO
12,src/java/main/org/apache/zookeeper/jmx/ManagedUtil.java,71,1,1.0,1,2,2.0,2,3,3.0,3,1,1.0,1,1,0,1,NO
12,src/java/main/org/apache/zookeeper/jmx/ZKMBeanInfo.java,36,0,0.0,0,0,0.0,0,0,0.0,0,0,0.0,0,0,0,0,NO
12,src/java/main/org/apache/zookeeper/server/ByteBufferInputStream.java,82,10,10.0,10,0,0.0,0,10,10.0,10,10,10.0,10,1,1,1,NO
12,src/java/main/org/apache/zookeeper/server/ByteBufferOutputStream.java,51,52,26.0,52,1,0.5,1,53,26.5,53,53,26.5,53,2,1,2,NO
12,src/java/main/org/apache/zookeeper/server/ConnectionBean.java,173,3,3.0,3,2,2.0,2,5,5.0,5,1,1.0,1,1,0,1,NO
12,src/java/main/org/apache/zookeeper/server/ConnectionMXBean.java,98,0,0.0,0,0,0.0,0,0,0.0,0,0,0.0,0,0,0,0,NO
12,src/java/main/org/apache/zookeeper/server/DataNode.java,174,14,4.6666665,14,10,3.3333333,10,24,8.0,24,12,4.0,12,3,1,2,NO
12,src/java/main/org/apache/zookeeper/server/DataTree.java,1278,284,21.846153,284,200,15.384615,200,484,37.23077,484,228,17.538462,228,13,7,6,YES
12,src/java/main/org/apache/zookeeper/server/DataTreeBean.java,61,0,0.0,0,0,0.0,0,0,0.0,0,0,0.0,0,0,0,0,NO
12,src/java/main/org/apache/zookeeper/server/DataTreeMXBean.java,47,0,0.0,0,0,0.0,0,0,0.0,0,0,0.0,0,0,0,0,NO
12,src/java/main/org/apache/zookeeper/server/DatadirCleanupManager.java,192,201,100.5,201,9,4.5,9,210,105.0,210,192,96.0,192,2,0,1,NO
12,src/java/main/org/apache/zookeeper/server/FinalRequestProcessor.java,422,78,13.0,78,32,5.3333335,32,110,18.333334,110,54,9.0,54,6,1,4,YES
12,src/java/main/org/apache/zookeeper/server/LogFormatter.java,104,5,1.6666666,5,8,2.6666667,8,13,4.3333335,13,5,1.6666666,5,3,1,3,NO
12,src/java/main/org/apache/zookeeper/server/NIOServerCnxn.java,1156,40,6.6666665,40,7,1.1666666,7,47,7.8333335,47,33,5.5,33,6,1,3,YES
12,src/java/main/org/apache/zookeeper/server/NIOServerCnxnFactory.java,326,24,8.0,24,4,1.3333334,4,28,9.333333,28,20,6.6666665,20,3,0,3,NO
12,src/java/main/org/apache/zookeeper/server/NettyServerCnxn.java,851,35,7.0,35,4,0.8,4,39,7.8,39,31,6.2,31,5,0,3,YES
12,src/java/main/org/apache/zookeeper/server/NettyServerCnxnFactory.java,415,23,7.6666665,23,4,1.3333334,4,27,9.0,27,19,6.3333335,19,3,0,3,NO
12,src/java/main/org/apache/zookeeper/server/ObserverBean.java,45,0,0.0,0,0,0.0,0,0,0.0,0,0,0.0,0,0,0,0,NO
12,src/java/main/org/apache/zookeeper/server/PrepRequestProcessor.java,716,442,29.466667,442,242,16.133333,242,684,45.6,684,288,19.2,288,15,4,5,YES
12,src/java/main/org/apache/zookeeper/server/PurgeTxnLog.java,129,3,1.0,3,6,2.0,6,9,3.0,9,5,1.6666666,5,3,0,2,NO
12,src/java/main/org/apache/zookeeper/server/Request.java,256,50,10.0,50,26,5.2,26,76,15.2,76,28,5.6,28,5,1,4,NO
12,src/java/main/org/apache/zookeeper/server/RequestProcessor.java,37,1,1.0,1,1,1.0,1,2,2.0,2,0,0.0,0,1,0,1,YES
12,src/java/main/org/apache/zookeeper/server/ServerCnxn.java,452,22,5.5,22,2,0.5,2,24,6.0,24,20,5.0,20,4,0,2,NO
12,src/java/main/org/apache/zookeeper/server/ServerCnxnFactory.java,139,10,5.0,10,5,2.5,5,15,7.5,15,5,2.5,5,2,0,2,NO
12,src/java/main/org/apache/zookeeper/server/ServerConfig.java,112,6,6.0,6,5,5.0,5,11,11.0,11,1,1.0,1,1,0,1,NO
12,src/java/main/org/apache/zookeeper/server/ServerStats.java,132,0,0.0,0,0,0.0,0,0,0.0,0,0,0.0,0,0,0,0,NO
12,src/java/main/org/apache/zookeeper/server/SessionTracker.java,81,7,7.0,7,0,0.0,0,7,7.0,7,7,7.0,7,1,1,1,NO
12,src/java/main/org/apache/zookeeper/server/SessionTrackerImpl.java,274,18,9.0,18,3,1.5,3,21,10.5,21,15,7.5,15,2,1,2,YES
12,src/java/main/org/apache/zookeeper/server/Stats.java,68,1,1.0,1,1,1.0,1,2,2.0,2,0,0.0,0,1,0,1,NO
12,src/java/main/org/apache/zookeeper/server/SyncRequestProcessor.java,190,10,5.0,10,4,2.0,4,14,7.0,14,6,3.0,6,2,1,2,YES
12,src/java/main/org/apache/zookeeper/server/TraceFormatter.java,123,2,2.0,2,0,0.0,0,2,2.0,2,2,2.0,2,1,0,1,NO
12,src/java/main/org/apache/zookeeper/server/WatchManager.java,171,11,3.6666667,11,10,3.3333333,10,21,7.0,21,1,0.33333334,1,3,0,3,NO
12,src/java/main/org/apache/zookeeper/server/ZKDatabase.java,483,52,17.333334,52,63,21.0,63,115,38.333332,115,13,4.3333335,13,3,0,2,NO
12,src/java/main/org/apache/zookeeper/server/ZooKeeperSaslServer.java,127,131,131.0,131,0,0.0,0,131,131.0,131,131,131.0,131,1,0,1,NO
12,src/java/main/org/apache/zookeeper/server/ZooKeeperServer.java,921,181,20.11111,181,125,13.888889,125,306,34.0,306,134,14.888889,134,9,3,5,YES
12,src/java/main/org/apache/zookeeper/server/ZooKeeperServerBean.java,143,0,0.0,0,0,0.0,0,0,0.0,0,0,0.0,0,0,0,0,NO
12,src/java/main/org/apache/zookeeper/server/ZooKeeperServerMXBean.java,106,0,0.0,0,0,0.0,0,0,0.0,0,0,0.0,0,0,0,0,NO
12,src/java/main/org/apache/zookeeper/server/ZooKeeperServerMain.java,123,9,2.25,9,14,3.5,14,23,5.75,23,7,1.75,7,4,0,2,NO
12,src/java/main/org/apache/zookeeper/server/ZooTrace.java,93,3,3.0,3,2,2.0,2,5,5.0,5,1,1.0,1,1,0,1,NO
12,src/java/main/org/apache/zookeeper/server/auth/AuthenticationProvider.java,82,0,0.0,0,0,0.0,0,0,0.0,0,0,0.0,0,0,0,0,NO
12,src/java/main/org/apache/zookeeper/server/auth/DigestAuthenticationProvider.java,139,3,3.0,3,2,2.0,2,5,5.0,5,1,1.0,1,1,0,1,NO
12,src/java/main/org/apache/zookeeper/server/auth/DigestLoginModule.java,59,61,61.0,61,0,0.0,0,61,61.0,61,61,61.0,61,1,0,1,NO
12,src/java/main/org/apache/zookeeper/server/auth/IPAuthenticationProvider.java,117,0,0.0,0,0,0.0,0,0,0.0,0,0,0.0,0,0,0,0,NO
12,src/java/main/org/apache/zookeeper/server/auth/KerberosName.java,418,418,418.0,418,0,0.0,0,418,418.0,418,418,418.0,418,1,0,1,YES
12,src/java/main/org/apache/zookeeper/server/auth/ProviderRegistry.java,77,3,3.0,3,2,2.0,2,5,5.0,5,1,1.0,1,1,0,1,NO
12,src/java/main/org/apache/zookeeper/server/auth/SASLAuthenticationProvider.java,70,70,70.0,70,0,0.0,0,70,70.0,70,70,70.0,70,1,0,1,NO
12,src/java/main/org/apache/zookeeper/server/auth/SaslServerCallbackHandler.java,148,252,126.0,252,104,52.0,104,356,178.0,356,172,86.0,172,2,0,1,NO
12,src/java/main/org/apache/zookeeper/server/persistence/FileSnap.java,250,4,4.0,4,3,3.0,3,7,7.0,7,1,1.0,1,1,0,1,NO
12,src/java/main/org/apache/zookeeper/server/persistence/FileTxnLog.java,660,61,8.714286,61,13,1.8571428,13,74,10.571428,74,54,7.714286,54,7,4,4,NO
12,src/java/main/org/apache/zookeeper/server/persistence/FileTxnSnapLog.java,343,111,18.5,111,64,10.666667,64,175,29.166666,175,49,8.166667,49,6,4,4,YES
12,src/java/main/org/apache/zookeeper/server/persistence/SnapShot.java,66,1,1.0,1,1,1.0,1,2,2.0,2,0,0.0,0,1,0,1,NO
12,src/java/main/org/apache/zookeeper/server/persistence/TxnLog.java,120,0,0.0,0,0,0.0,0,0,0.0,0,0,0.0,0,0,0,0,NO
12,src/java/main/org/apache/zookeeper/server/persistence/Util.java,326,8,4.0,8,7,3.5,7,15,7.5,15,1,0.5,1,2,1,2,NO
12,src/java/main/org/apache/zookeeper/server/quorum/AckRequestProcessor.java,54,3,3.0,3,2,2.0,2,5,5.0,5,1,1.0,1,1,0,1,NO
12,src/java/main/org/apache/zookeeper/server/quorum/AuthFastLeaderElection.java,972,12,3.0,12,14,3.5,14,26,6.5,26,10,2.5,10,4,0,4,NO
12,src/java/main/org/apache/zookeeper/server/quorum/CommitProcessor.java,185,18,4.5,18,23,5.75,23,41,10.25,41,11,2.75,11,4,1,3,NO
12,src/java/main/org/apache/zookeeper/server/quorum/Election.java,27,1,1.0,1,1,1.0,1,2,2.0,2,0,0.0,0,1,0,1,NO
12,src/java/main/org/apache/zookeeper/server/quorum/FastLeaderElection.java,890,208,34.666668,208,160,26.666666,160,368,61.333332,368,80,13.333333,80,6,2,4,NO
12,src/java/main/org/apache/zookeeper/server/quorum/Follower.java,167,18,3.6,18,15,3.0,15,33,6.6,33,11,2.2,11,5,3,5,NO
12,src/java/main/org/apache/zookeeper/server/quorum/FollowerBean.java,50,0,0.0,0,0,0.0,0,0,0.0,0,0,0.0,0,0,0,0,NO
12,src/java/main/org/apache/zookeeper/server/quorum/FollowerMXBean.java,41,0,0.0,0,0,0.0,0,0,0.0,0,0,0.0,0,0,0,0,NO
12,src/java/main/org/apache/zookeeper/server/quorum/FollowerRequestProcessor.java,113,6,2.0,6,3,1.0,3,9,3.0,9,3,1.0,3,3,1,3,NO
12,src/java/main/org/apache/zookeeper/server/quorum/FollowerZooKeeperServer.java,160,16,5.3333335,16,19,6.3333335,19,35,11.666667,35,5,1.6666666,5,3,0,2,NO
12,src/java/main/org/apache/zookeeper/server/quorum/Leader.java,828,216,21.6,216,124,12.4,124,340,34.0,340,104,10.4,104,10,6,6,YES
12,src/java/main/org/apache/zookeeper/server/quorum/LeaderBean.java,53,0,0.0,0,0,0.0,0,0,0.0,0,0,0.0,0,0,0,0,NO
12,src/java/main/org/apache/zookeeper/server/quorum/LeaderElection.java,293,51,10.2,51,32,6.4,32,83,16.6,83,23,4.6,23,5,0,4,NO
12,src/java/main/org/apache/zookeeper/server/quorum/LeaderElectionBean.java,42,0,0.0,0,0,0.0,0,0,0.0,0,0,0.0,0,0,0,0,NO
12,src/java/main/org/apache/zookeeper/server/quorum/LeaderElectionMXBean.java,31,0,0.0,0,0,0.0,0,0,0.0,0,0,0.0,0,0,0,0,NO
12,src/java/main/org/apache/zookeeper/server/quorum/LeaderMXBean.java,36,0,0.0,0,0,0.0,0,0,0.0,0,0,0.0,0,0,0,0,NO
12,src/java/main/org/apache/zookeeper/server/quorum/LeaderZooKeeperServer.java,173,10,5.0,10,13,6.5,13,23,11.5,23,3,1.5,3,2,0,1,NO
12,src/java/main/org/apache/zookeeper/server/quorum/Learner.java,481,91,15.166667,91,42,7.0,42,133,22.166666,133,57,9.5,57,6,4,4,NO
12,src/java/main/org/apache/zookeeper/server/quorum/LearnerHandler.java,611,186,23.25,186,99,12.375,99,285,35.625,285,93,11.625,93,8,4,5,NO
12,src/java/main/org/apache/zookeeper/server/quorum/LearnerSessionTracker.java,96,4,4.0,4,0,0.0,0,4,4.0,4,4,4.0,4,1,1,1,NO
12,src/java/main/org/apache/zookeeper/server/quorum/LearnerSyncRequest.java,34,0,0.0,0,0,0.0,0,0,0.0,0,0,0.0,0,0,0,0,NO
12,src/java/main/org/apache/zookeeper/server/quorum/LearnerZooKeeperServer.java,141,2,2.0,2,3,3.0,3,5,5.0,5,1,1.0,1,1,0,1,NO
12,src/java/main/org/apache/zookeeper/server/quorum/LocalPeerBean.java,79,0,0.0,0,0,0.0,0,0,0.0,0,0,0.0,0,0,0,0,NO
12,src/java/main/org/apache/zookeeper/server/quorum/LocalPeerMXBean.java,77,0,0.0,0,0,0.0,0,0,0.0,0,0,0.0,0,0,0,0,NO
12,src/java/main/org/apache/zookeeper/server/quorum/Observer.java,134,16,5.3333335,16,24,8.0,24,40,13.333333,40,8,2.6666667,8,3,1,2,NO
12,src/java/main/org/apache/zookeeper/server/quorum/ObserverMXBean.java,37,0,0.0,0,0,0.0,0,0,0.0,0,0,0.0,0,0,0,0,NO
12,src/java/main/org/apache/zookeeper/server/quorum/ObserverRequestProcessor.java,127,10,3.3333333,10,7,2.3333333,7,17,5.6666665,17,3,1.0,3,3,1,3,NO
12,src/java/main/org/apache/zookeeper/server/quorum/ObserverZooKeeperServer.java,115,6,3.0,6,7,3.5,7,13,6.5,13,3,1.5,3,2,0,2,NO
12,src/java/main/org/apache/zookeeper/server/quorum/ProposalRequestProcessor.java,88,13,4.3333335,13,13,4.3333335,13,26,8.666667,26,2,0.6666667,2,3,0,2,YES
12,src/java/main/org/apache/zookeeper/server/quorum/QuorumBean.java,44,0,0.0,0,0,0.0,0,0,0.0,0,0,0.0,0,0,0,0,NO
12,src/java/main/org/apache/zookeeper/server/quorum/QuorumCnxManager.java,883,204,40.8,204,51,10.2,51,255,51.0,255,157,31.4,157,5,1,5,YES
12,src/java/main/org/apache/zookeeper/server/quorum/QuorumMXBean.java,34,0,0.0,0,0,0.0,0,0,0.0,0,0,0.0,0,0,0,0,NO
12,src/java/main/org/apache/zookeeper/server/quorum/QuorumPeer.java,1123,412,29.428572,412,249,17.785715,249,661,47.214287,661,177,12.642858,177,14,3,6,NO
12,src/java/main/org/apache/zookeeper/server/quorum/QuorumPeerConfig.java,411,59,14.75,59,29,7.25,29,88,22.0,88,30,7.5,30,4,0,2,NO
12,src/java/main/org/apache/zookeeper/server/quorum/QuorumPeerMain.java,157,15,3.75,15,8,2.0,8,23,5.75,23,9,2.25,9,4,0,2,NO
12,src/java/main/org/apache/zookeeper/server/quorum/QuorumStats.java,68,0,0.0,0,0,0.0,0,0,0.0,0,0,0.0,0,0,0,0,NO
12,src/java/main/org/apache/zookeeper/server/quorum/QuorumZooKeeperServer.java,59,2,1.0,2,5,2.5,5,7,3.5,7,3,1.5,3,2,0,2,NO
12,src/java/main/org/apache/zookeeper/server/quorum/ReadOnlyBean.java,38,38,38.0,38,0,0.0,0,38,38.0,38,38,38.0,38,1,0,1,NO
12,src/java/main/org/apache/zookeeper/server/quorum/ReadOnlyRequestProcessor.java,120,124,62.0,124,4,2.0,4,128,64.0,128,120,60.0,120,2,1,2,YES
12,src/java/main/org/apache/zookeeper/server/quorum/ReadOnlyZooKeeperServer.java,144,151,50.333332,151,7,2.3333333,7,158,52.666668,158,148,49.333332,148,3,0,3,NO
12,src/java/main/org/apache/zookeeper/server/quorum/RemotePeerBean.java,45,0,0.0,0,0,0.0,0,0,0.0,0,0,0.0,0,0,0,0,NO
12,src/java/main/org/apache/zookeeper/server/quorum/RemotePeerMXBean.java,33,0,0.0,0,0,0.0,0,0,0.0,0,0,0.0,0,0,0,0,NO
12,src/java/main/org/apache/zookeeper/server/quorum/SendAckRequestProcessor.java,80,6,3.0,6,5,2.5,5,11,5.5,11,1,0.5,1,2,0,2,NO
12,src/java/main/org/apache/zookeeper/server/quorum/ServerBean.java,38,0,0.0,0,0,0.0,0,0,0.0,0,0,0.0,0,0,0,0,NO
12,src/java/main/org/apache/zookeeper/server/quorum/ServerMXBean.java,33,0,0.0,0,0,0.0,0,0,0.0,0,0,0.0,0,0,0,0,NO
12,src/java/main/org/apache/zookeeper/server/quorum/StateSummary.java,57,57,57.0,57,0,0.0,0,57,57.0,57,57,57.0,57,1,1,1,NO
12,src/java/main/org/apache/zookeeper/server/quorum/Vote.java,106,51,17.0,51,14,4.6666665,14,65,21.666666,65,37,12.333333,37,3,1,2,NO
12,src/java/main/org/apache/zookeeper/server/quorum/flexible/QuorumHierarchical.java,271,4,2.0,4,5,2.5,5,9,4.5,9,3,1.5,3,2,0,2,NO
12,src/java/main/org/apache/zookeeper/server/quorum/flexible/QuorumMaj.java,57,1,1.0,1,1,1.0,1,2,2.0,2,0,0.0,0,1,0,1,NO
12,src/java/main/org/apache/zookeeper/server/quorum/flexible/QuorumVerifier.java,33,1,1.0,1,1,1.0,1,2,2.0,2,0,0.0,0,1,0,1,NO
12,src/java/main/org/apache/zookeeper/server/util/Profiler.java,41,3,3.0,3,2,2.0,2,5,5.0,5,1,1.0,1,1,0,1,NO
12,src/java/main/org/apache/zookeeper/server/util/SerializeUtils.java,141,38,12.666667,38,4,1.3333334,4,42,14.0,42,34,11.333333,34,3,1,3,NO
12,src/java/main/org/apache/zookeeper/server/util/VerifyingFileFactory.java,82,82,82.0,82,0,0.0,0,82,82.0,82,82,82.0,82,1,0,1,NO
12,src/java/main/org/apache/zookeeper/server/util/ZxidUtils.java,34,34,34.0,34,0,0.0,0,34,34.0,34,34,34.0,34,1,1,1,NO
12,src/java/main/org/apache/zookeeper/version/util/VerGen.java,177,0,0.0,0,0,0.0,0,0,0.0,0,0,0.0,0,0,0,0,NO
12,src/recipes/election/src/java/org/apache/zookeeper/recipes/leader/LeaderElectionAware.java,37,37,37.0,37,0,0.0,0,37,37.0,37,37,37.0,37,1,0,1,NO
12,src/recipes/election/src/java/org/apache/zookeeper/recipes/leader/LeaderElectionSupport.java,461,461,461.0,461,0,0.0,0,461,461.0,461,461,461.0,461,1,0,1,NO
12,src/recipes/election/src/java/org/apache/zookeeper/recipes/leader/LeaderOffer.java,84,84,84.0,84,0,0.0,0,84,84.0,84,84,84.0,84,1,0,1,NO
12,src/recipes/lock/src/java/org/apache/zookeeper/recipes/lock/LockListener.java,38,1,1.0,1,1,1.0,1,2,2.0,2,0,0.0,0,1,0,1,NO
12,src/recipes/lock/src/java/org/apache/zookeeper/recipes/lock/ProtocolSupport.java,193,3,3.0,3,2,2.0,2,5,5.0,5,1,1.0,1,1,0,1,NO
12,src/recipes/lock/src/java/org/apache/zookeeper/recipes/lock/WriteLock.java,295,3,3.0,3,2,2.0,2,5,5.0,5,1,1.0,1,1,0,1,NO
12,src/recipes/lock/src/java/org/apache/zookeeper/recipes/lock/ZNodeName.java,110,3,3.0,3,2,2.0,2,5,5.0,5,1,1.0,1,1,0,1,NO
12,src/recipes/lock/src/java/org/apache/zookeeper/recipes/lock/ZooKeeperOperation.java,38,0,0.0,0,0,0.0,0,0,0.0,0,0,0.0,0,0,0,0,NO
12,src/recipes/queue/src/java/org/apache/zookeeper/recipes/queue/DistributedQueue.java,313,3,3.0,3,2,2.0,2,5,5.0,5,1,1.0,1,1,0,1,NO
13,src/contrib/fatjar/src/java/org/apache/zookeeper/util/FatJarMain.java,126,0,0.0,0,0,0.0,0,0,0.0,0,0,0.0,0,0,0,0,NO
13,src/contrib/loggraph/src/java/org/apache/zookeeper/graph/FilterException.java,22,0,0.0,0,0,0.0,0,0,0.0,0,0,0.0,0,0,0,0,NO
13,src/contrib/loggraph/src/java/org/apache/zookeeper/graph/FilterOp.java,75,0,0.0,0,0,0.0,0,0,0.0,0,0,0.0,0,0,0,0,NO
13,src/contrib/loggraph/src/java/org/apache/zookeeper/graph/FilterParser.java,131,0,0.0,0,0,0.0,0,0,0.0,0,0,0.0,0,0,0,0,NO
13,src/contrib/loggraph/src/java/org/apache/zookeeper/graph/JsonGenerator.java,223,0,0.0,0,0,0.0,0,0,0.0,0,0,0.0,0,0,0,0,NO
13,src/contrib/loggraph/src/java/org/apache/zookeeper/graph/Log4JEntry.java,40,0,0.0,0,0,0.0,0,0,0.0,0,0,0.0,0,0,0,0,NO
13,src/contrib/loggraph/src/java/org/apache/zookeeper/graph/Log4JSource.java,381,0,0.0,0,0,0.0,0,0,0.0,0,0,0.0,0,0,0,0,NO
13,src/contrib/loggraph/src/java/org/apache/zookeeper/graph/LogEntry.java,46,0,0.0,0,0,0.0,0,0,0.0,0,0,0.0,0,0,0,0,NO
13,src/contrib/loggraph/src/java/org/apache/zookeeper/graph/LogIterator.java,26,0,0.0,0,0,0.0,0,0,0.0,0,0,0.0,0,0,0,0,NO
13,src/contrib/loggraph/src/java/org/apache/zookeeper/graph/LogServer.java,66,0,0.0,0,0,0.0,0,0,0.0,0,0,0.0,0,0,0,0,NO
13,src/contrib/loggraph/src/java/org/apache/zookeeper/graph/LogSkipList.java,95,0,0.0,0,0,0.0,0,0,0.0,0,0,0.0,0,0,0,0,NO
13,src/contrib/loggraph/src/java/org/apache/zookeeper/graph/LogSource.java,33,0,0.0,0,0,0.0,0,0,0.0,0,0,0.0,0,0,0,0,NO
13,src/contrib/loggraph/src/java/org/apache/zookeeper/graph/MeasureThroughput.java,103,0,0.0,0,0,0.0,0,0,0.0,0,0,0.0,0,0,0,0,NO
13,src/contrib/loggraph/src/java/org/apache/zookeeper/graph/MergedLogSource.java,219,0,0.0,0,0,0.0,0,0,0.0,0,0,0.0,0,0,0,0,NO
13,src/contrib/loggraph/src/java/org/apache/zookeeper/graph/RandomAccessFileReader.java,328,0,0.0,0,0,0.0,0,0,0.0,0,0,0.0,0,0,0,0,NO
13,src/contrib/loggraph/src/java/org/apache/zookeeper/graph/TransactionEntry.java,59,0,0.0,0,0,0.0,0,0,0.0,0,0,0.0,0,0,0,0,NO
13,src/contrib/loggraph/src/java/org/apache/zookeeper/graph/TxnLogSource.java,376,0,0.0,0,0,0.0,0,0,0.0,0,0,0.0,0,0,0,0,NO
13,src/contrib/loggraph/src/java/org/apache/zookeeper/graph/filterops/AndOp.java,33,0,0.0,0,0,0.0,0,0,0.0,0,0,0.0,0,0,0,0,NO
13,src/contrib/loggraph/src/java/org/apache/zookeeper/graph/filterops/Arg.java,36,0,0.0,0,0,0.0,0,0,0.0,0,0,0.0,0,0,0,0,NO
13,src/contrib/loggraph/src/java/org/apache/zookeeper/graph/filterops/EqualsOp.java,44,0,0.0,0,0,0.0,0,0,0.0,0,0,0.0,0,0,0,0,NO
13,src/contrib/loggraph/src/java/org/apache/zookeeper/graph/filterops/GreaterThanOp.java,70,0,0.0,0,0,0.0,0,0,0.0,0,0,0.0,0,0,0,0,NO
13,src/contrib/loggraph/src/java/org/apache/zookeeper/graph/filterops/LessThanOp.java,69,0,0.0,0,0,0.0,0,0,0.0,0,0,0.0,0,0,0,0,NO
13,src/contrib/loggraph/src/java/org/apache/zookeeper/graph/filterops/NotOp.java,31,0,0.0,0,0,0.0,0,0,0.0,0,0,0.0,0,0,0,0,NO
13,src/contrib/loggraph/src/java/org/apache/zookeeper/graph/filterops/NumberArg.java,27,0,0.0,0,0,0.0,0,0,0.0,0,0,0.0,0,0,0,0,NO
13,src/contrib/loggraph/src/java/org/apache/zookeeper/graph/filterops/OrOp.java,33,0,0.0,0,0,0.0,0,0,0.0,0,0,0.0,0,0,0,0,NO
13,src/contrib/loggraph/src/java/org/apache/zookeeper/graph/filterops/StringArg.java,27,0,0.0,0,0,0.0,0,0,0.0,0,0,0.0,0,0,0,0,NO
13,src/contrib/loggraph/src/java/org/apache/zookeeper/graph/filterops/SymbolArg.java,27,0,0.0,0,0,0.0,0,0,0.0,0,0,0.0,0,0,0,0,NO
13,src/contrib/loggraph/src/java/org/apache/zookeeper/graph/filterops/XorOp.java,40,0,0.0,0,0,0.0,0,0,0.0,0,0,0.0,0,0,0,0,NO
13,src/contrib/loggraph/src/java/org/apache/zookeeper/graph/servlets/FileLoader.java,60,0,0.0,0,0,0.0,0,0,0.0,0,0,0.0,0,0,0,0,NO
13,src/contrib/loggraph/src/java/org/apache/zookeeper/graph/servlets/Fs.java,69,0,0.0,0,0,0.0,0,0,0.0,0,0,0.0,0,0,0,0,NO
13,src/contrib/loggraph/src/java/org/apache/zookeeper/graph/servlets/GraphData.java,85,0,0.0,0,0,0.0,0,0,0.0,0,0,0.0,0,0,0,0,NO
13,src/contrib/loggraph/src/java/org/apache/zookeeper/graph/servlets/JsonServlet.java,85,0,0.0,0,0,0.0,0,0,0.0,0,0,0.0,0,0,0,0,NO
13,src/contrib/loggraph/src/java/org/apache/zookeeper/graph/servlets/NumEvents.java,86,0,0.0,0,0,0.0,0,0,0.0,0,0,0.0,0,0,0,0,NO
13,src/contrib/loggraph/src/java/org/apache/zookeeper/graph/servlets/StaticContent.java,50,0,0.0,0,0,0.0,0,0,0.0,0,0,0.0,0,0,0,0,NO
13,src/contrib/loggraph/src/java/org/apache/zookeeper/graph/servlets/Throughput.java,125,0,0.0,0,0,0.0,0,0,0.0,0,0,0.0,0,0,0,0,NO
13,src/contrib/rest/src/java/org/apache/zookeeper/server/jersey/RestMain.java,151,0,0.0,0,0,0.0,0,0,0.0,0,0,0.0,0,0,0,0,NO
13,src/contrib/rest/src/java/org/apache/zookeeper/server/jersey/ZooKeeperService.java,242,0,0.0,0,0,0.0,0,0,0.0,0,0,0.0,0,0,0,0,NO
13,src/contrib/rest/src/java/org/apache/zookeeper/server/jersey/cfg/Credentials.java,47,0,0.0,0,0,0.0,0,0,0.0,0,0,0.0,0,0,0,0,NO
13,src/contrib/rest/src/java/org/apache/zookeeper/server/jersey/cfg/Endpoint.java,72,0,0.0,0,0,0.0,0,0,0.0,0,0,0.0,0,0,0,0,NO
13,src/contrib/rest/src/java/org/apache/zookeeper/server/jersey/cfg/HostPort.java,51,0,0.0,0,0,0.0,0,0,0.0,0,0,0.0,0,0,0,0,NO
13,src/contrib/rest/src/java/org/apache/zookeeper/server/jersey/cfg/HostPortSet.java,51,0,0.0,0,0,0.0,0,0,0.0,0,0,0.0,0,0,0,0,NO
13,src/contrib/rest/src/java/org/apache/zookeeper/server/jersey/cfg/RestCfg.java,106,0,0.0,0,0,0.0,0,0,0.0,0,0,0.0,0,0,0,0,NO
13,src/contrib/rest/src/java/org/apache/zookeeper/server/jersey/filters/HTTPBasicAuth.java,87,0,0.0,0,0,0.0,0,0,0.0,0,0,0.0,0,0,0,0,NO
13,src/contrib/rest/src/java/org/apache/zookeeper/server/jersey/jaxb/ZChildren.java,80,0,0.0,0,0,0.0,0,0,0.0,0,0,0.0,0,0,0,0,NO
13,src/contrib/rest/src/java/org/apache/zookeeper/server/jersey/jaxb/ZChildrenJSON.java,76,0,0.0,0,0,0.0,0,0,0.0,0,0,0.0,0,0,0,0,NO
13,src/contrib/rest/src/java/org/apache/zookeeper/server/jersey/jaxb/ZError.java,41,0,0.0,0,0,0.0,0,0,0.0,0,0,0.0,0,0,0,0,NO
13,src/contrib/rest/src/java/org/apache/zookeeper/server/jersey/jaxb/ZPath.java,63,0,0.0,0,0,0.0,0,0,0.0,0,0,0.0,0,0,0,0,NO
13,src/contrib/rest/src/java/org/apache/zookeeper/server/jersey/jaxb/ZSession.java,55,0,0.0,0,0,0.0,0,0,0.0,0,0,0.0,0,0,0,0,NO
13,src/contrib/rest/src/java/org/apache/zookeeper/server/jersey/jaxb/ZStat.java,106,0,0.0,0,0,0.0,0,0,0.0,0,0,0.0,0,0,0,0,NO
13,src/contrib/rest/src/java/org/apache/zookeeper/server/jersey/resources/JAXBContextResolver.java,72,0,0.0,0,0,0.0,0,0,0.0,0,0,0.0,0,0,0,0,NO
13,src/contrib/rest/src/java/org/apache/zookeeper/server/jersey/resources/KeeperExceptionMapper.java,86,0,0.0,0,0,0.0,0,0,0.0,0,0,0.0,0,0,0,0,NO
13,src/contrib/rest/src/java/org/apache/zookeeper/server/jersey/resources/RuntimeExceptionMapper.java,55,0,0.0,0,0,0.0,0,0,0.0,0,0,0.0,0,0,0,0,NO
13,src/contrib/rest/src/java/org/apache/zookeeper/server/jersey/resources/SessionsResource.java,135,0,0.0,0,0,0.0,0,0,0.0,0,0,0.0,0,0,0,0,NO
13,src/contrib/rest/src/java/org/apache/zookeeper/server/jersey/resources/ZErrorWriter.java,63,0,0.0,0,0,0.0,0,0,0.0,0,0,0.0,0,0,0,0,NO
13,src/contrib/rest/src/java/org/apache/zookeeper/server/jersey/resources/ZNodeResource.java,412,0,0.0,0,0,0.0,0,0,0.0,0,0,0.0,0,0,0,0,NO
13,src/contrib/zooinspector/src/java/com/nitido/utils/toaster/Toaster.java,533,533,533.0,533,0,0.0,0,533,533.0,533,533,533.0,533,1,0,1,NO
13,src/contrib/zooinspector/src/java/org/apache/zookeeper/inspector/ZooInspector.java,67,2,2.0,2,1,1.0,1,3,3.0,3,1,1.0,1,1,0,1,NO
13,src/contrib/zooinspector/src/java/org/apache/zookeeper/inspector/encryption/BasicDataEncryptionManager.java,50,0,0.0,0,0,0.0,0,0,0.0,0,0,0.0,0,0,0,0,NO
13,src/contrib/zooinspector/src/java/org/apache/zookeeper/inspector/encryption/DataEncryptionManager.java,39,0,0.0,0,0,0.0,0,0,0.0,0,0,0.0,0,0,0,0,NO
13,src/contrib/zooinspector/src/java/org/apache/zookeeper/inspector/gui/IconResource.java,88,88,88.0,88,0,0.0,0,88,88.0,88,88,88.0,88,1,0,1,NO
13,src/contrib/zooinspector/src/java/org/apache/zookeeper/inspector/gui/NodeViewersChangeListener.java,37,0,0.0,0,0,0.0,0,0,0.0,0,0,0.0,0,0,0,0,NO
13,src/contrib/zooinspector/src/java/org/apache/zookeeper/inspector/gui/Toolbar.java,74,74,74.0,74,0,0.0,0,74,74.0,74,74,74.0,74,1,0,1,NO
13,src/contrib/zooinspector/src/java/org/apache/zookeeper/inspector/gui/ZooInspectorAboutDialog.java,79,2,2.0,2,3,3.0,3,5,5.0,5,1,1.0,1,1,0,1,NO
13,src/contrib/zooinspector/src/java/org/apache/zookeeper/inspector/gui/ZooInspectorConnectionPropertiesDialog.java,321,0,0.0,0,0,0.0,0,0,0.0,0,0,0.0,0,0,0,0,NO
13,src/contrib/zooinspector/src/java/org/apache/zookeeper/inspector/gui/ZooInspectorNodeViewersDialog.java,631,78,78.0,78,52,52.0,52,130,130.0,130,26,26.0,26,1,0,1,NO
13,src/contrib/zooinspector/src/java/org/apache/zookeeper/inspector/gui/ZooInspectorNodeViewersPanel.java,140,0,0.0,0,0,0.0,0,0,0.0,0,0,0.0,0,0,0,0,NO
13,src/contrib/zooinspector/src/java/org/apache/zookeeper/inspector/gui/ZooInspectorPanel.java,318,20,20.0,20,63,63.0,63,83,83.0,83,43,43.0,43,1,0,1,NO
13,src/contrib/zooinspector/src/java/org/apache/zookeeper/inspector/gui/ZooInspectorTreeViewer.java,356,10,10.0,10,16,16.0,16,26,26.0,26,6,6.0,6,1,0,1,NO
13,src/contrib/zooinspector/src/java/org/apache/zookeeper/inspector/gui/nodeviewer/NodeViewerACL.java,187,0,0.0,0,0,0.0,0,0,0.0,0,0,0.0,0,0,0,0,NO
13,src/contrib/zooinspector/src/java/org/apache/zookeeper/inspector/gui/nodeviewer/NodeViewerData.java,142,3,3.0,3,7,7.0,7,10,10.0,10,4,4.0,4,1,0,1,NO
13,src/contrib/zooinspector/src/java/org/apache/zookeeper/inspector/gui/nodeviewer/NodeViewerMetaData.java,186,0,0.0,0,0,0.0,0,0,0.0,0,0,0.0,0,0,0,0,NO
13,src/contrib/zooinspector/src/java/org/apache/zookeeper/inspector/gui/nodeviewer/ZooInspectorNodeViewer.java,138,0,0.0,0,0,0.0,0,0,0.0,0,0,0.0,0,0,0,0,NO
13,src/contrib/zooinspector/src/java/org/apache/zookeeper/inspector/logger/LoggerFactory.java,36,0,0.0,0,0,0.0,0,0,0.0,0,0,0.0,0,0,0,0,NO
13,src/contrib/zooinspector/src/java/org/apache/zookeeper/inspector/manager/NodeListener.java,37,0,0.0,0,0,0.0,0,0,0.0,0,0,0.0,0,0,0,0,NO
13,src/contrib/zooinspector/src/java/org/apache/zookeeper/inspector/manager/Pair.java,120,0,0.0,0,0,0.0,0,0,0.0,0,0,0.0,0,0,0,0,NO
13,src/contrib/zooinspector/src/java/org/apache/zookeeper/inspector/manager/ZooInspectorManager.java,139,0,0.0,0,0,0.0,0,0,0.0,0,0,0.0,0,0,0,0,NO
13,src/contrib/zooinspector/src/java/org/apache/zookeeper/inspector/manager/ZooInspectorManagerImpl.java,852,0,0.0,0,0,0.0,0,0,0.0,0,0,0.0,0,0,0,0,NO
13,src/contrib/zooinspector/src/java/org/apache/zookeeper/inspector/manager/ZooInspectorNodeManager.java,33,0,0.0,0,0,0.0,0,0,0.0,0,0,0.0,0,0,0,0,NO
13,src/contrib/zooinspector/src/java/org/apache/zookeeper/inspector/manager/ZooInspectorNodeTreeManager.java,43,0,0.0,0,0,0.0,0,0,0.0,0,0,0.0,0,0,0,0,NO
13,src/contrib/zooinspector/src/java/org/apache/zookeeper/inspector/manager/ZooInspectorReadOnlyManager.java,99,0,0.0,0,0,0.0,0,0,0.0,0,0,0.0,0,0,0,0,NO
13,src/contrib/zooinspector/src/java/org/apache/zookeeper/retry/ZooKeeperRetry.java,288,0,0.0,0,0,0.0,0,0,0.0,0,0,0.0,0,0,0,0,NO
13,src/java/main/org/apache/jute/BinaryInputArchive.java,131,0,0.0,0,0,0.0,0,0,0.0,0,0,0.0,0,0,0,0,NO
13,src/java/main/org/apache/jute/BinaryOutputArchive.java,146,0,0.0,0,0,0.0,0,0,0.0,0,0,0.0,0,0,0,0,NO
13,src/java/main/org/apache/jute/CsvInputArchive.java,204,0,0.0,0,0,0.0,0,0,0.0,0,0,0.0,0,0,0,0,NO
13,src/java/main/org/apache/jute/CsvOutputArchive.java,150,0,0.0,0,0,0.0,0,0,0.0,0,0,0.0,0,0,0,0,NO
13,src/java/main/org/apache/jute/Index.java,38,0,0.0,0,0,0.0,0,0,0.0,0,0,0.0,0,0,0,0,NO
13,src/java/main/org/apache/jute/InputArchive.java,43,0,0.0,0,0,0.0,0,0,0.0,0,0,0.0,0,0,0,0,NO
13,src/java/main/org/apache/jute/OutputArchive.java,47,0,0.0,0,0,0.0,0,0,0.0,0,0,0.0,0,0,0,0,NO
13,src/java/main/org/apache/jute/Record.java,32,0,0.0,0,0,0.0,0,0,0.0,0,0,0.0,0,0,0,0,NO
13,src/java/main/org/apache/jute/RecordReader.java,93,0,0.0,0,0,0.0,0,0,0.0,0,0,0.0,0,0,0,0,NO
13,src/java/main/org/apache/jute/RecordWriter.java,93,0,0.0,0,0,0.0,0,0,0.0,0,0,0.0,0,0,0,0,NO
13,src/java/main/org/apache/jute/Utils.java,282,0,0.0,0,0,0.0,0,0,0.0,0,0,0.0,0,0,0,0,NO
13,src/java/main/org/apache/jute/XmlInputArchive.java,251,0,0.0,0,0,0.0,0,0,0.0,0,0,0.0,0,0,0,0,NO
13,src/java/main/org/apache/jute/XmlOutputArchive.java,251,0,0.0,0,0,0.0,0,0,0.0,0,0,0.0,0,0,0,0,NO
13,src/java/main/org/apache/jute/compiler/CGenerator.java,130,0,0.0,0,0,0.0,0,0,0.0,0,0,0.0,0,0,0,0,NO
13,src/java/main/org/apache/jute/compiler/CSharpGenerator.java,53,0,0.0,0,0,0.0,0,0,0.0,0,0,0.0,0,0,0,0,NO
13,src/java/main/org/apache/jute/compiler/CppGenerator.java,125,0,0.0,0,0,0.0,0,0,0.0,0,0,0.0,0,0,0,0,NO
13,src/java/main/org/apache/jute/compiler/JBoolean.java,50,0,0.0,0,0,0.0,0,0,0.0,0,0,0.0,0,0,0,0,NO
13,src/java/main/org/apache/jute/compiler/JBuffer.java,106,0,0.0,0,0,0.0,0,0,0.0,0,0,0.0,0,0,0,0,NO
13,src/java/main/org/apache/jute/compiler/JByte.java,34,0,0.0,0,0,0.0,0,0,0.0,0,0,0.0,0,0,0,0,NO
13,src/java/main/org/apache/jute/compiler/JCompType.java,66,0,0.0,0,0,0.0,0,0,0.0,0,0,0.0,0,0,0,0,NO
13,src/java/main/org/apache/jute/compiler/JDouble.java,40,0,0.0,0,0,0.0,0,0,0.0,0,0,0.0,0,0,0,0,NO
13,src/java/main/org/apache/jute/compiler/JField.java,140,0,0.0,0,0,0.0,0,0,0.0,0,0,0.0,0,0,0,0,NO
13,src/java/main/org/apache/jute/compiler/JFile.java,84,0,0.0,0,0,0.0,0,0,0.0,0,0,0.0,0,0,0,0,NO
13,src/java/main/org/apache/jute/compiler/JFloat.java,39,0,0.0,0,0,0.0,0,0,0.0,0,0,0.0,0,0,0,0,NO
13,src/java/main/org/apache/jute/compiler/JInt.java,34,0,0.0,0,0,0.0,0,0,0.0,0,0,0.0,0,0,0,0,NO
13,src/java/main/org/apache/jute/compiler/JLong.java,38,0,0.0,0,0,0.0,0,0,0.0,0,0,0.0,0,0,0,0,NO
13,src/java/main/org/apache/jute/compiler/JMap.java,149,0,0.0,0,0,0.0,0,0,0.0,0,0,0.0,0,0,0,0,NO
13,src/java/main/org/apache/jute/compiler/JRecord.java,761,0,0.0,0,0,0.0,0,0,0.0,0,0,0.0,0,0,0,0,NO
13,src/java/main/org/apache/jute/compiler/JString.java,46,0,0.0,0,0,0.0,0,0,0.0,0,0,0.0,0,0,0,0,NO
13,src/java/main/org/apache/jute/compiler/JType.java,204,0,0.0,0,0,0.0,0,0,0.0,0,0,0.0,0,0,0,0,NO
13,src/java/main/org/apache/jute/compiler/JVector.java,153,0,0.0,0,0,0.0,0,0,0.0,0,0,0.0,0,0,0,0,NO
13,src/java/main/org/apache/jute/compiler/JavaGenerator.java,57,0,0.0,0,0,0.0,0,0,0.0,0,0,0.0,0,0,0,0,NO
13,src/java/main/org/apache/zookeeper/AsyncCallback.java,57,0,0.0,0,0,0.0,0,0,0.0,0,0,0.0,0,0,0,0,NO
13,src/java/main/org/apache/zookeeper/ClientCnxn.java,1307,0,0.0,0,0,0.0,0,0,0.0,0,0,0.0,0,0,0,0,YES
13,src/java/main/org/apache/zookeeper/ClientCnxnSocket.java,170,0,0.0,0,0,0.0,0,0,0.0,0,0,0.0,0,0,0,0,NO
13,src/java/main/org/apache/zookeeper/ClientCnxnSocketNIO.java,339,0,0.0,0,0,0.0,0,0,0.0,0,0,0.0,0,0,0,0,NO
13,src/java/main/org/apache/zookeeper/ClientWatchManager.java,40,0,0.0,0,0,0.0,0,0,0.0,0,0,0.0,0,0,0,0,NO
13,src/java/main/org/apache/zookeeper/CreateMode.java,90,0,0.0,0,0,0.0,0,0,0.0,0,0,0.0,0,0,0,0,YES
13,src/java/main/org/apache/zookeeper/Environment.java,100,0,0.0,0,0,0.0,0,0,0.0,0,0,0.0,0,0,0,0,NO
13,src/java/main/org/apache/zookeeper/JLineZNodeCompletor.java,84,0,0.0,0,0,0.0,0,0,0.0,0,0,0.0,0,0,0,0,NO
13,src/java/main/org/apache/zookeeper/KeeperException.java,699,0,0.0,0,0,0.0,0,0,0.0,0,0,0.0,0,0,0,0,YES
13,src/java/main/org/apache/zookeeper/Login.java,389,0,0.0,0,0,0.0,0,0,0.0,0,0,0.0,0,0,0,0,NO
13,src/java/main/org/apache/zookeeper/MultiResponse.java,165,0,0.0,0,0,0.0,0,0,0.0,0,0,0.0,0,0,0,0,NO
13,src/java/main/org/apache/zookeeper/MultiTransactionRecord.java,159,0,0.0,0,0,0.0,0,0,0.0,0,0,0.0,0,0,0,0,NO
13,src/java/main/org/apache/zookeeper/Op.java,305,0,0.0,0,0,0.0,0,0,0.0,0,0,0.0,0,0,0,0,YES
13,src/java/main/org/apache/zookeeper/OpResult.java,185,0,0.0,0,0,0.0,0,0,0.0,0,0,0.0,0,0,0,0,YES
13,src/java/main/org/apache/zookeeper/Quotas.java,68,0,0.0,0,0,0.0,0,0,0.0,0,0,0.0,0,0,0,0,NO
13,src/java/main/org/apache/zookeeper/ServerAdminClient.java,277,0,0.0,0,0,0.0,0,0,0.0,0,0,0.0,0,0,0,0,NO
13,src/java/main/org/apache/zookeeper/Shell.java,476,0,0.0,0,0,0.0,0,0,0.0,0,0,0.0,0,0,0,0,NO
13,src/java/main/org/apache/zookeeper/StatsTrack.java,101,0,0.0,0,0,0.0,0,0,0.0,0,0,0.0,0,0,0,0,NO
13,src/java/main/org/apache/zookeeper/Transaction.java,60,0,0.0,0,0,0.0,0,0,0.0,0,0,0.0,0,0,0,0,YES
13,src/java/main/org/apache/zookeeper/Version.java,79,0,0.0,0,0,0.0,0,0,0.0,0,0,0.0,0,0,0,0,NO
13,src/java/main/org/apache/zookeeper/WatchedEvent.java,79,0,0.0,0,0,0.0,0,0,0.0,0,0,0.0,0,0,0,0,NO
13,src/java/main/org/apache/zookeeper/Watcher.java,149,0,0.0,0,0,0.0,0,0,0.0,0,0,0.0,0,0,0,0,NO
13,src/java/main/org/apache/zookeeper/ZKUtil.java,124,0,0.0,0,0,0.0,0,0,0.0,0,0,0.0,0,0,0,0,NO
13,src/java/main/org/apache/zookeeper/ZooDefs.java,119,0,0.0,0,0,0.0,0,0,0.0,0,0,0.0,0,0,0,0,NO
13,src/java/main/org/apache/zookeeper/ZooKeeper.java,1746,0,0.0,0,0,0.0,0,0,0.0,0,0,0.0,0,0,0,0,YES
13,src/java/main/org/apache/zookeeper/ZooKeeperMain.java,868,0,0.0,0,0,0.0,0,0,0.0,0,0,0.0,0,0,0,0,YES
13,src/java/main/org/apache/zookeeper/client/ConnectStringParser.java,87,0,0.0,0,0,0.0,0,0,0.0,0,0,0.0,0,0,0,0,NO
13,src/java/main/org/apache/zookeeper/client/HostProvider.java,61,0,0.0,0,0,0.0,0,0,0.0,0,0,0.0,0,0,0,0,NO
13,src/java/main/org/apache/zookeeper/client/StaticHostProvider.java,101,0,0.0,0,0,0.0,0,0,0.0,0,0,0.0,0,0,0,0,NO
13,src/java/main/org/apache/zookeeper/client/ZooKeeperSaslClient.java,355,0,0.0,0,0,0.0,0,0,0.0,0,0,0.0,0,0,0,0,NO
13,src/java/main/org/apache/zookeeper/common/PathTrie.java,284,0,0.0,0,0,0.0,0,0,0.0,0,0,0.0,0,0,0,0,NO
13,src/java/main/org/apache/zookeeper/common/PathUtils.java,103,0,0.0,0,0,0.0,0,0,0.0,0,0,0.0,0,0,0,0,NO
13,src/java/main/org/apache/zookeeper/jmx/CommonNames.java,29,0,0.0,0,0,0.0,0,0,0.0,0,0,0.0,0,0,0,0,NO
13,src/java/main/org/apache/zookeeper/jmx/MBeanRegistry.java,215,0,0.0,0,0,0.0,0,0,0.0,0,0,0.0,0,0,0,0,NO
13,src/java/main/org/apache/zookeeper/jmx/ManagedUtil.java,71,0,0.0,0,0,0.0,0,0,0.0,0,0,0.0,0,0,0,0,NO
13,src/java/main/org/apache/zookeeper/jmx/ZKMBeanInfo.java,36,0,0.0,0,0,0.0,0,0,0.0,0,0,0.0,0,0,0,0,NO
13,src/java/main/org/apache/zookeeper/server/ByteBufferInputStream.java,82,0,0.0,0,0,0.0,0,0,0.0,0,0,0.0,0,0,0,0,NO
13,src/java/main/org/apache/zookeeper/server/ByteBufferOutputStream.java,51,0,0.0,0,0,0.0,0,0,0.0,0,0,0.0,0,0,0,0,NO
13,src/java/main/org/apache/zookeeper/server/ConnectionBean.java,173,0,0.0,0,0,0.0,0,0,0.0,0,0,0.0,0,0,0,0,NO
13,src/java/main/org/apache/zookeeper/server/ConnectionMXBean.java,98,0,0.0,0,0,0.0,0,0,0.0,0,0,0.0,0,0,0,0,NO
13,src/java/main/org/apache/zookeeper/server/DataNode.java,174,0,0.0,0,0,0.0,0,0,0.0,0,0,0.0,0,0,0,0,NO
13,src/java/main/org/apache/zookeeper/server/DataTree.java,1309,34,17.0,34,3,1.5,3,37,18.5,37,35,17.5,35,2,0,2,YES
13,src/java/main/org/apache/zookeeper/server/DataTreeBean.java,61,0,0.0,0,0,0.0,0,0,0.0,0,0,0.0,0,0,0,0,NO
13,src/java/main/org/apache/zookeeper/server/DataTreeMXBean.java,47,0,0.0,0,0,0.0,0,0,0.0,0,0,0.0,0,0,0,0,NO
13,src/java/main/org/apache/zookeeper/server/DatadirCleanupManager.java,192,0,0.0,0,0,0.0,0,0,0.0,0,0,0.0,0,0,0,0,NO
13,src/java/main/org/apache/zookeeper/server/FinalRequestProcessor.java,422,0,0.0,0,0,0.0,0,0,0.0,0,0,0.0,0,0,0,0,YES
13,src/java/main/org/apache/zookeeper/server/LogFormatter.java,104,0,0.0,0,0,0.0,0,0,0.0,0,0,0.0,0,0,0,0,NO
13,src/java/main/org/apache/zookeeper/server/NIOServerCnxn.java,1156,0,0.0,0,0,0.0,0,0,0.0,0,0,0.0,0,0,0,0,YES
13,src/java/main/org/apache/zookeeper/server/NIOServerCnxnFactory.java,326,0,0.0,0,0,0.0,0,0,0.0,0,0,0.0,0,0,0,0,NO
13,src/java/main/org/apache/zookeeper/server/NettyServerCnxn.java,851,0,0.0,0,0,0.0,0,0,0.0,0,0,0.0,0,0,0,0,YES
13,src/java/main/org/apache/zookeeper/server/NettyServerCnxnFactory.java,415,0,0.0,0,0,0.0,0,0,0.0,0,0,0.0,0,0,0,0,NO
13,src/java/main/org/apache/zookeeper/server/ObserverBean.java,45,0,0.0,0,0,0.0,0,0,0.0,0,0,0.0,0,0,0,0,NO
13,src/java/main/org/apache/zookeeper/server/PrepRequestProcessor.java,716,0,0.0,0,0,0.0,0,0,0.0,0,0,0.0,0,0,0,0,YES
13,src/java/main/org/apache/zookeeper/server/PurgeTxnLog.java,129,0,0.0,0,0,0.0,0,0,0.0,0,0,0.0,0,0,0,0,NO
13,src/java/main/org/apache/zookeeper/server/Request.java,256,0,0.0,0,0,0.0,0,0,0.0,0,0,0.0,0,0,0,0,NO
13,src/java/main/org/apache/zookeeper/server/RequestProcessor.java,37,0,0.0,0,0,0.0,0,0,0.0,0,0,0.0,0,0,0,0,YES
13,src/java/main/org/apache/zookeeper/server/ServerCnxn.java,452,0,0.0,0,0,0.0,0,0,0.0,0,0,0.0,0,0,0,0,NO
13,src/java/main/org/apache/zookeeper/server/ServerCnxnFactory.java,139,0,0.0,0,0,0.0,0,0,0.0,0,0,0.0,0,0,0,0,NO
13,src/java/main/org/apache/zookeeper/server/ServerConfig.java,112,0,0.0,0,0,0.0,0,0,0.0,0,0,0.0,0,0,0,0,NO
13,src/java/main/org/apache/zookeeper/server/ServerStats.java,132,0,0.0,0,0,0.0,0,0,0.0,0,0,0.0,0,0,0,0,NO
13,src/java/main/org/apache/zookeeper/server/SessionTracker.java,81,0,0.0,0,0,0.0,0,0,0.0,0,0,0.0,0,0,0,0,NO
13,src/java/main/org/apache/zookeeper/server/SessionTrackerImpl.java,274,0,0.0,0,0,0.0,0,0,0.0,0,0,0.0,0,0,0,0,YES
13,src/java/main/org/apache/zookeeper/server/Stats.java,68,0,0.0,0,0,0.0,0,0,0.0,0,0,0.0,0,0,0,0,NO
13,src/java/main/org/apache/zookeeper/server/SyncRequestProcessor.java,190,0,0.0,0,0,0.0,0,0,0.0,0,0,0.0,0,0,0,0,YES
13,src/java/main/org/apache/zookeeper/server/TraceFormatter.java,123,0,0.0,0,0,0.0,0,0,0.0,0,0,0.0,0,0,0,0,NO
13,src/java/main/org/apache/zookeeper/server/WatchManager.java,171,0,0.0,0,0,0.0,0,0,0.0,0,0,0.0,0,0,0,0,NO
13,src/java/main/org/apache/zookeeper/server/ZKDatabase.java,483,0,0.0,0,0,0.0,0,0,0.0,0,0,0.0,0,0,0,0,NO
13,src/java/main/org/apache/zookeeper/server/ZooKeeperSaslServer.java,127,0,0.0,0,0,0.0,0,0,0.0,0,0,0.0,0,0,0,0,NO
13,src/java/main/org/apache/zookeeper/server/ZooKeeperServer.java,921,0,0.0,0,0,0.0,0,0,0.0,0,0,0.0,0,0,0,0,YES
13,src/java/main/org/apache/zookeeper/server/ZooKeeperServerBean.java,143,0,0.0,0,0,0.0,0,0,0.0,0,0,0.0,0,0,0,0,NO
13,src/java/main/org/apache/zookeeper/server/ZooKeeperServerMXBean.java,106,0,0.0,0,0,0.0,0,0,0.0,0,0,0.0,0,0,0,0,NO
13,src/java/main/org/apache/zookeeper/server/ZooKeeperServerMain.java,123,0,0.0,0,0,0.0,0,0,0.0,0,0,0.0,0,0,0,0,NO
13,src/java/main/org/apache/zookeeper/server/ZooTrace.java,93,0,0.0,0,0,0.0,0,0,0.0,0,0,0.0,0,0,0,0,NO
13,src/java/main/org/apache/zookeeper/server/auth/AuthenticationProvider.java,82,0,0.0,0,0,0.0,0,0,0.0,0,0,0.0,0,0,0,0,NO
13,src/java/main/org/apache/zookeeper/server/auth/DigestAuthenticationProvider.java,139,0,0.0,0,0,0.0,0,0,0.0,0,0,0.0,0,0,0,0,NO
13,src/java/main/org/apache/zookeeper/server/auth/DigestLoginModule.java,59,0,0.0,0,0,0.0,0,0,0.0,0,0,0.0,0,0,0,0,NO
13,src/java/main/org/apache/zookeeper/server/auth/IPAuthenticationProvider.java,117,0,0.0,0,0,0.0,0,0,0.0,0,0,0.0,0,0,0,0,NO
13,src/java/main/org/apache/zookeeper/server/auth/KerberosName.java,418,0,0.0,0,0,0.0,0,0,0.0,0,0,0.0,0,0,0,0,YES
13,src/java/main/org/apache/zookeeper/server/auth/ProviderRegistry.java,77,0,0.0,0,0,0.0,0,0,0.0,0,0,0.0,0,0,0,0,NO
13,src/java/main/org/apache/zookeeper/server/auth/SASLAuthenticationProvider.java,70,0,0.0,0,0,0.0,0,0,0.0,0,0,0.0,0,0,0,0,NO
13,src/java/main/org/apache/zookeeper/server/auth/SaslServerCallbackHandler.java,148,0,0.0,0,0,0.0,0,0,0.0,0,0,0.0,0,0,0,0,NO
13,src/java/main/org/apache/zookeeper/server/persistence/FileSnap.java,250,0,0.0,0,0,0.0,0,0,0.0,0,0,0.0,0,0,0,0,NO
13,src/java/main/org/apache/zookeeper/server/persistence/FileTxnLog.java,660,0,0.0,0,0,0.0,0,0,0.0,0,0,0.0,0,0,0,0,NO
13,src/java/main/org/apache/zookeeper/server/persistence/FileTxnSnapLog.java,324,12,12.0,12,31,31.0,31,43,43.0,43,19,19.0,19,1,0,1,YES
13,src/java/main/org/apache/zookeeper/server/persistence/SnapShot.java,66,0,0.0,0,0,0.0,0,0,0.0,0,0,0.0,0,0,0,0,NO
13,src/java/main/org/apache/zookeeper/server/persistence/TxnLog.java,120,0,0.0,0,0,0.0,0,0,0.0,0,0,0.0,0,0,0,0,NO
13,src/java/main/org/apache/zookeeper/server/persistence/Util.java,326,0,0.0,0,0,0.0,0,0,0.0,0,0,0.0,0,0,0,0,NO
13,src/java/main/org/apache/zookeeper/server/quorum/AckRequestProcessor.java,54,0,0.0,0,0,0.0,0,0,0.0,0,0,0.0,0,0,0,0,NO
13,src/java/main/org/apache/zookeeper/server/quorum/AuthFastLeaderElection.java,972,0,0.0,0,0,0.0,0,0,0.0,0,0,0.0,0,0,0,0,NO
13,src/java/main/org/apache/zookeeper/server/quorum/CommitProcessor.java,185,0,0.0,0,0,0.0,0,0,0.0,0,0,0.0,0,0,0,0,NO
13,src/java/main/org/apache/zookeeper/server/quorum/Election.java,27,0,0.0,0,0,0.0,0,0,0.0,0,0,0.0,0,0,0,0,NO
13,src/java/main/org/apache/zookeeper/server/quorum/FastLeaderElection.java,890,0,0.0,0,0,0.0,0,0,0.0,0,0,0.0,0,0,0,0,NO
13,src/java/main/org/apache/zookeeper/server/quorum/Follower.java,167,0,0.0,0,0,0.0,0,0,0.0,0,0,0.0,0,0,0,0,NO
13,src/java/main/org/apache/zookeeper/server/quorum/FollowerBean.java,50,0,0.0,0,0,0.0,0,0,0.0,0,0,0.0,0,0,0,0,NO
13,src/java/main/org/apache/zookeeper/server/quorum/FollowerMXBean.java,41,0,0.0,0,0,0.0,0,0,0.0,0,0,0.0,0,0,0,0,NO
13,src/java/main/org/apache/zookeeper/server/quorum/FollowerRequestProcessor.java,113,0,0.0,0,0,0.0,0,0,0.0,0,0,0.0,0,0,0,0,NO
13,src/java/main/org/apache/zookeeper/server/quorum/FollowerZooKeeperServer.java,160,0,0.0,0,0,0.0,0,0,0.0,0,0,0.0,0,0,0,0,NO
13,src/java/main/org/apache/zookeeper/server/quorum/Leader.java,826,0,0.0,0,2,2.0,2,2,2.0,2,2,2.0,2,1,1,1,YES
13,src/java/main/org/apache/zookeeper/server/quorum/LeaderBean.java,53,0,0.0,0,0,0.0,0,0,0.0,0,0,0.0,0,0,0,0,NO
13,src/java/main/org/apache/zookeeper/server/quorum/LeaderElection.java,293,0,0.0,0,0,0.0,0,0,0.0,0,0,0.0,0,0,0,0,NO
13,src/java/main/org/apache/zookeeper/server/quorum/LeaderElectionBean.java,42,0,0.0,0,0,0.0,0,0,0.0,0,0,0.0,0,0,0,0,NO
13,src/java/main/org/apache/zookeeper/server/quorum/LeaderElectionMXBean.java,31,0,0.0,0,0,0.0,0,0,0.0,0,0,0.0,0,0,0,0,NO
13,src/java/main/org/apache/zookeeper/server/quorum/LeaderMXBean.java,36,0,0.0,0,0,0.0,0,0,0.0,0,0,0.0,0,0,0,0,NO
13,src/java/main/org/apache/zookeeper/server/quorum/LeaderZooKeeperServer.java,173,0,0.0,0,0,0.0,0,0,0.0,0,0,0.0,0,0,0,0,NO
13,src/java/main/org/apache/zookeeper/server/quorum/Learner.java,481,0,0.0,0,0,0.0,0,0,0.0,0,0,0.0,0,0,0,0,NO
13,src/java/main/org/apache/zookeeper/server/quorum/LearnerHandler.java,611,0,0.0,0,0,0.0,0,0,0.0,0,0,0.0,0,0,0,0,NO
13,src/java/main/org/apache/zookeeper/server/quorum/LearnerSessionTracker.java,96,0,0.0,0,0,0.0,0,0,0.0,0,0,0.0,0,0,0,0,NO
13,src/java/main/org/apache/zookeeper/server/quorum/LearnerSyncRequest.java,34,0,0.0,0,0,0.0,0,0,0.0,0,0,0.0,0,0,0,0,NO
13,src/java/main/org/apache/zookeeper/server/quorum/LearnerZooKeeperServer.java,141,0,0.0,0,0,0.0,0,0,0.0,0,0,0.0,0,0,0,0,NO
13,src/java/main/org/apache/zookeeper/server/quorum/LocalPeerBean.java,79,0,0.0,0,0,0.0,0,0,0.0,0,0,0.0,0,0,0,0,NO
13,src/java/main/org/apache/zookeeper/server/quorum/LocalPeerMXBean.java,77,0,0.0,0,0,0.0,0,0,0.0,0,0,0.0,0,0,0,0,NO
13,src/java/main/org/apache/zookeeper/server/quorum/Observer.java,134,0,0.0,0,0,0.0,0,0,0.0,0,0,0.0,0,0,0,0,NO
13,src/java/main/org/apache/zookeeper/server/quorum/ObserverMXBean.java,37,0,0.0,0,0,0.0,0,0,0.0,0,0,0.0,0,0,0,0,NO
13,src/java/main/org/apache/zookeeper/server/quorum/ObserverRequestProcessor.java,127,0,0.0,0,0,0.0,0,0,0.0,0,0,0.0,0,0,0,0,NO
13,src/java/main/org/apache/zookeeper/server/quorum/ObserverZooKeeperServer.java,115,0,0.0,0,0,0.0,0,0,0.0,0,0,0.0,0,0,0,0,NO
13,src/java/main/org/apache/zookeeper/server/quorum/ProposalRequestProcessor.java,88,0,0.0,0,0,0.0,0,0,0.0,0,0,0.0,0,0,0,0,YES
13,src/java/main/org/apache/zookeeper/server/quorum/QuorumBean.java,44,0,0.0,0,0,0.0,0,0,0.0,0,0,0.0,0,0,0,0,NO
13,src/java/main/org/apache/zookeeper/server/quorum/QuorumCnxManager.java,883,0,0.0,0,0,0.0,0,0,0.0,0,0,0.0,0,0,0,0,YES
13,src/java/main/org/apache/zookeeper/server/quorum/QuorumMXBean.java,34,0,0.0,0,0,0.0,0,0,0.0,0,0,0.0,0,0,0,0,NO
13,src/java/main/org/apache/zookeeper/server/quorum/QuorumPeer.java,1123,0,0.0,0,0,0.0,0,0,0.0,0,0,0.0,0,0,0,0,NO
13,src/java/main/org/apache/zookeeper/server/quorum/QuorumPeerConfig.java,411,0,0.0,0,0,0.0,0,0,0.0,0,0,0.0,0,0,0,0,NO
13,src/java/main/org/apache/zookeeper/server/quorum/QuorumPeerMain.java,157,0,0.0,0,0,0.0,0,0,0.0,0,0,0.0,0,0,0,0,NO
13,src/java/main/org/apache/zookeeper/server/quorum/QuorumStats.java,68,0,0.0,0,0,0.0,0,0,0.0,0,0,0.0,0,0,0,0,NO
13,src/java/main/org/apache/zookeeper/server/quorum/QuorumZooKeeperServer.java,59,0,0.0,0,0,0.0,0,0,0.0,0,0,0.0,0,0,0,0,NO
13,src/java/main/org/apache/zookeeper/server/quorum/ReadOnlyBean.java,38,0,0.0,0,0,0.0,0,0,0.0,0,0,0.0,0,0,0,0,NO
13,src/java/main/org/apache/zookeeper/server/quorum/ReadOnlyRequestProcessor.java,120,0,0.0,0,0,0.0,0,0,0.0,0,0,0.0,0,0,0,0,YES
13,src/java/main/org/apache/zookeeper/server/quorum/ReadOnlyZooKeeperServer.java,144,0,0.0,0,0,0.0,0,0,0.0,0,0,0.0,0,0,0,0,NO
13,src/java/main/org/apache/zookeeper/server/quorum/RemotePeerBean.java,45,0,0.0,0,0,0.0,0,0,0.0,0,0,0.0,0,0,0,0,NO
13,src/java/main/org/apache/zookeeper/server/quorum/RemotePeerMXBean.java,33,0,0.0,0,0,0.0,0,0,0.0,0,0,0.0,0,0,0,0,NO
13,src/java/main/org/apache/zookeeper/server/quorum/SendAckRequestProcessor.java,80,0,0.0,0,0,0.0,0,0,0.0,0,0,0.0,0,0,0,0,NO
13,src/java/main/org/apache/zookeeper/server/quorum/ServerBean.java,38,0,0.0,0,0,0.0,0,0,0.0,0,0,0.0,0,0,0,0,NO
13,src/java/main/org/apache/zookeeper/server/quorum/ServerMXBean.java,33,0,0.0,0,0,0.0,0,0,0.0,0,0,0.0,0,0,0,0,NO
13,src/java/main/org/apache/zookeeper/server/quorum/StateSummary.java,57,0,0.0,0,0,0.0,0,0,0.0,0,0,0.0,0,0,0,0,NO
13,src/java/main/org/apache/zookeeper/server/quorum/Vote.java,106,0,0.0,0,0,0.0,0,0,0.0,0,0,0.0,0,0,0,0,NO
13,src/java/main/org/apache/zookeeper/server/quorum/flexible/QuorumHierarchical.java,271,0,0.0,0,0,0.0,0,0,0.0,0,0,0.0,0,0,0,0,NO
13,src/java/main/org/apache/zookeeper/server/quorum/flexible/QuorumMaj.java,57,0,0.0,0,0,0.0,0,0,0.0,0,0,0.0,0,0,0,0,NO
13,src/java/main/org/apache/zookeeper/server/quorum/flexible/QuorumVerifier.java,33,0,0.0,0,0,0.0,0,0,0.0,0,0,0.0,0,0,0,0,NO
13,src/java/main/org/apache/zookeeper/server/util/SerializeUtils.java,141,0,0.0,0,0,0.0,0,0,0.0,0,0,0.0,0,0,0,0,NO
13,src/java/main/org/apache/zookeeper/server/util/VerifyingFileFactory.java,82,0,0.0,0,0,0.0,0,0,0.0,0,0,0.0,0,0,0,0,NO
13,src/java/main/org/apache/zookeeper/server/util/ZxidUtils.java,34,0,0.0,0,0,0.0,0,0,0.0,0,0,0.0,0,0,0,0,NO
13,src/java/main/org/apache/zookeeper/version/util/VerGen.java,177,0,0.0,0,0,0.0,0,0,0.0,0,0,0.0,0,0,0,0,NO
13,src/recipes/election/src/java/org/apache/zookeeper/recipes/leader/LeaderElectionAware.java,37,0,0.0,0,0,0.0,0,0,0.0,0,0,0.0,0,0,0,0,NO
13,src/recipes/election/src/java/org/apache/zookeeper/recipes/leader/LeaderElectionSupport.java,461,0,0.0,0,0,0.0,0,0,0.0,0,0,0.0,0,0,0,0,NO
13,src/recipes/election/src/java/org/apache/zookeeper/recipes/leader/LeaderOffer.java,84,0,0.0,0,0,0.0,0,0,0.0,0,0,0.0,0,0,0,0,NO
13,src/recipes/lock/src/java/org/apache/zookeeper/recipes/lock/LockListener.java,38,0,0.0,0,0,0.0,0,0,0.0,0,0,0.0,0,0,0,0,NO
13,src/recipes/lock/src/java/org/apache/zookeeper/recipes/lock/ProtocolSupport.java,193,0,0.0,0,0,0.0,0,0,0.0,0,0,0.0,0,0,0,0,NO
13,src/recipes/lock/src/java/org/apache/zookeeper/recipes/lock/WriteLock.java,295,0,0.0,0,0,0.0,0,0,0.0,0,0,0.0,0,0,0,0,NO
13,src/recipes/lock/src/java/org/apache/zookeeper/recipes/lock/ZNodeName.java,110,0,0.0,0,0,0.0,0,0,0.0,0,0,0.0,0,0,0,0,NO
13,src/recipes/lock/src/java/org/apache/zookeeper/recipes/lock/ZooKeeperOperation.java,38,0,0.0,0,0,0.0,0,0,0.0,0,0,0.0,0,0,0,0,NO
13,src/recipes/queue/src/java/org/apache/zookeeper/recipes/queue/DistributedQueue.java,313,0,0.0,0,0,0.0,0,0,0.0,0,0,0.0,0,0,0,0,NO
14,src/contrib/fatjar/src/java/org/apache/zookeeper/util/FatJarMain.java,126,0,0.0,0,0,0.0,0,0,0.0,0,0,0.0,0,0,0,0,NO
14,src/contrib/loggraph/src/java/org/apache/zookeeper/graph/FilterException.java,22,0,0.0,0,0,0.0,0,0,0.0,0,0,0.0,0,0,0,0,NO
14,src/contrib/loggraph/src/java/org/apache/zookeeper/graph/FilterOp.java,75,0,0.0,0,0,0.0,0,0,0.0,0,0,0.0,0,0,0,0,NO
14,src/contrib/loggraph/src/java/org/apache/zookeeper/graph/FilterParser.java,131,0,0.0,0,0,0.0,0,0,0.0,0,0,0.0,0,0,0,0,NO
14,src/contrib/loggraph/src/java/org/apache/zookeeper/graph/JsonGenerator.java,223,0,0.0,0,0,0.0,0,0,0.0,0,0,0.0,0,0,0,0,NO
14,src/contrib/loggraph/src/java/org/apache/zookeeper/graph/Log4JEntry.java,40,0,0.0,0,0,0.0,0,0,0.0,0,0,0.0,0,0,0,0,NO
14,src/contrib/loggraph/src/java/org/apache/zookeeper/graph/Log4JSource.java,381,0,0.0,0,0,0.0,0,0,0.0,0,0,0.0,0,0,0,0,NO
14,src/contrib/loggraph/src/java/org/apache/zookeeper/graph/LogEntry.java,46,0,0.0,0,0,0.0,0,0,0.0,0,0,0.0,0,0,0,0,NO
14,src/contrib/loggraph/src/java/org/apache/zookeeper/graph/LogIterator.java,26,0,0.0,0,0,0.0,0,0,0.0,0,0,0.0,0,0,0,0,NO
14,src/contrib/loggraph/src/java/org/apache/zookeeper/graph/LogServer.java,66,0,0.0,0,0,0.0,0,0,0.0,0,0,0.0,0,0,0,0,NO
14,src/contrib/loggraph/src/java/org/apache/zookeeper/graph/LogSkipList.java,95,0,0.0,0,0,0.0,0,0,0.0,0,0,0.0,0,0,0,0,NO
14,src/contrib/loggraph/src/java/org/apache/zookeeper/graph/LogSource.java,33,0,0.0,0,0,0.0,0,0,0.0,0,0,0.0,0,0,0,0,NO
14,src/contrib/loggraph/src/java/org/apache/zookeeper/graph/MeasureThroughput.java,103,0,0.0,0,0,0.0,0,0,0.0,0,0,0.0,0,0,0,0,NO
14,src/contrib/loggraph/src/java/org/apache/zookeeper/graph/MergedLogSource.java,219,0,0.0,0,0,0.0,0,0,0.0,0,0,0.0,0,0,0,0,NO
14,src/contrib/loggraph/src/java/org/apache/zookeeper/graph/RandomAccessFileReader.java,328,0,0.0,0,0,0.0,0,0,0.0,0,0,0.0,0,0,0,0,NO
14,src/contrib/loggraph/src/java/org/apache/zookeeper/graph/TransactionEntry.java,59,0,0.0,0,0,0.0,0,0,0.0,0,0,0.0,0,0,0,0,NO
14,src/contrib/loggraph/src/java/org/apache/zookeeper/graph/TxnLogSource.java,376,0,0.0,0,0,0.0,0,0,0.0,0,0,0.0,0,0,0,0,NO
14,src/contrib/loggraph/src/java/org/apache/zookeeper/graph/filterops/AndOp.java,33,0,0.0,0,0,0.0,0,0,0.0,0,0,0.0,0,0,0,0,NO
14,src/contrib/loggraph/src/java/org/apache/zookeeper/graph/filterops/Arg.java,36,0,0.0,0,0,0.0,0,0,0.0,0,0,0.0,0,0,0,0,NO
14,src/contrib/loggraph/src/java/org/apache/zookeeper/graph/filterops/EqualsOp.java,44,0,0.0,0,0,0.0,0,0,0.0,0,0,0.0,0,0,0,0,NO
14,src/contrib/loggraph/src/java/org/apache/zookeeper/graph/filterops/GreaterThanOp.java,70,0,0.0,0,0,0.0,0,0,0.0,0,0,0.0,0,0,0,0,NO
14,src/contrib/loggraph/src/java/org/apache/zookeeper/graph/filterops/LessThanOp.java,69,0,0.0,0,0,0.0,0,0,0.0,0,0,0.0,0,0,0,0,NO
14,src/contrib/loggraph/src/java/org/apache/zookeeper/graph/filterops/NotOp.java,31,0,0.0,0,0,0.0,0,0,0.0,0,0,0.0,0,0,0,0,NO
14,src/contrib/loggraph/src/java/org/apache/zookeeper/graph/filterops/NumberArg.java,27,0,0.0,0,0,0.0,0,0,0.0,0,0,0.0,0,0,0,0,NO
14,src/contrib/loggraph/src/java/org/apache/zookeeper/graph/filterops/OrOp.java,33,0,0.0,0,0,0.0,0,0,0.0,0,0,0.0,0,0,0,0,NO
14,src/contrib/loggraph/src/java/org/apache/zookeeper/graph/filterops/StringArg.java,27,0,0.0,0,0,0.0,0,0,0.0,0,0,0.0,0,0,0,0,NO
14,src/contrib/loggraph/src/java/org/apache/zookeeper/graph/filterops/SymbolArg.java,27,0,0.0,0,0,0.0,0,0,0.0,0,0,0.0,0,0,0,0,NO
14,src/contrib/loggraph/src/java/org/apache/zookeeper/graph/filterops/XorOp.java,40,0,0.0,0,0,0.0,0,0,0.0,0,0,0.0,0,0,0,0,NO
14,src/contrib/loggraph/src/java/org/apache/zookeeper/graph/servlets/FileLoader.java,60,0,0.0,0,0,0.0,0,0,0.0,0,0,0.0,0,0,0,0,NO
14,src/contrib/loggraph/src/java/org/apache/zookeeper/graph/servlets/Fs.java,69,0,0.0,0,0,0.0,0,0,0.0,0,0,0.0,0,0,0,0,NO
14,src/contrib/loggraph/src/java/org/apache/zookeeper/graph/servlets/GraphData.java,85,0,0.0,0,0,0.0,0,0,0.0,0,0,0.0,0,0,0,0,NO
14,src/contrib/loggraph/src/java/org/apache/zookeeper/graph/servlets/JsonServlet.java,85,0,0.0,0,0,0.0,0,0,0.0,0,0,0.0,0,0,0,0,NO
14,src/contrib/loggraph/src/java/org/apache/zookeeper/graph/servlets/NumEvents.java,86,0,0.0,0,0,0.0,0,0,0.0,0,0,0.0,0,0,0,0,NO
14,src/contrib/loggraph/src/java/org/apache/zookeeper/graph/servlets/StaticContent.java,50,0,0.0,0,0,0.0,0,0,0.0,0,0,0.0,0,0,0,0,NO
14,src/contrib/loggraph/src/java/org/apache/zookeeper/graph/servlets/Throughput.java,125,0,0.0,0,0,0.0,0,0,0.0,0,0,0.0,0,0,0,0,NO
14,src/contrib/rest/src/java/org/apache/zookeeper/server/jersey/RestMain.java,151,0,0.0,0,0,0.0,0,0,0.0,0,0,0.0,0,0,0,0,NO
14,src/contrib/rest/src/java/org/apache/zookeeper/server/jersey/ZooKeeperService.java,242,0,0.0,0,0,0.0,0,0,0.0,0,0,0.0,0,0,0,0,NO
14,src/contrib/rest/src/java/org/apache/zookeeper/server/jersey/cfg/Credentials.java,47,0,0.0,0,0,0.0,0,0,0.0,0,0,0.0,0,0,0,0,NO
14,src/contrib/rest/src/java/org/apache/zookeeper/server/jersey/cfg/Endpoint.java,72,0,0.0,0,0,0.0,0,0,0.0,0,0,0.0,0,0,0,0,NO
14,src/contrib/rest/src/java/org/apache/zookeeper/server/jersey/cfg/HostPort.java,51,0,0.0,0,0,0.0,0,0,0.0,0,0,0.0,0,0,0,0,NO
14,src/contrib/rest/src/java/org/apache/zookeeper/server/jersey/cfg/HostPortSet.java,51,0,0.0,0,0,0.0,0,0,0.0,0,0,0.0,0,0,0,0,NO
14,src/contrib/rest/src/java/org/apache/zookeeper/server/jersey/cfg/RestCfg.java,106,0,0.0,0,0,0.0,0,0,0.0,0,0,0.0,0,0,0,0,NO
14,src/contrib/rest/src/java/org/apache/zookeeper/server/jersey/filters/HTTPBasicAuth.java,87,0,0.0,0,0,0.0,0,0,0.0,0,0,0.0,0,0,0,0,NO
14,src/contrib/rest/src/java/org/apache/zookeeper/server/jersey/jaxb/ZChildren.java,80,0,0.0,0,0,0.0,0,0,0.0,0,0,0.0,0,0,0,0,NO
14,src/contrib/rest/src/java/org/apache/zookeeper/server/jersey/jaxb/ZChildrenJSON.java,76,0,0.0,0,0,0.0,0,0,0.0,0,0,0.0,0,0,0,0,NO
14,src/contrib/rest/src/java/org/apache/zookeeper/server/jersey/jaxb/ZError.java,41,0,0.0,0,0,0.0,0,0,0.0,0,0,0.0,0,0,0,0,NO
14,src/contrib/rest/src/java/org/apache/zookeeper/server/jersey/jaxb/ZPath.java,63,0,0.0,0,0,0.0,0,0,0.0,0,0,0.0,0,0,0,0,NO
14,src/contrib/rest/src/java/org/apache/zookeeper/server/jersey/jaxb/ZSession.java,55,0,0.0,0,0,0.0,0,0,0.0,0,0,0.0,0,0,0,0,NO
14,src/contrib/rest/src/java/org/apache/zookeeper/server/jersey/jaxb/ZStat.java,106,0,0.0,0,0,0.0,0,0,0.0,0,0,0.0,0,0,0,0,NO
14,src/contrib/rest/src/java/org/apache/zookeeper/server/jersey/resources/JAXBContextResolver.java,72,0,0.0,0,0,0.0,0,0,0.0,0,0,0.0,0,0,0,0,NO
14,src/contrib/rest/src/java/org/apache/zookeeper/server/jersey/resources/KeeperExceptionMapper.java,86,0,0.0,0,0,0.0,0,0,0.0,0,0,0.0,0,0,0,0,NO
14,src/contrib/rest/src/java/org/apache/zookeeper/server/jersey/resources/RuntimeExceptionMapper.java,55,0,0.0,0,0,0.0,0,0,0.0,0,0,0.0,0,0,0,0,NO
14,src/contrib/rest/src/java/org/apache/zookeeper/server/jersey/resources/SessionsResource.java,135,0,0.0,0,0,0.0,0,0,0.0,0,0,0.0,0,0,0,0,NO
14,src/contrib/rest/src/java/org/apache/zookeeper/server/jersey/resources/ZErrorWriter.java,63,0,0.0,0,0,0.0,0,0,0.0,0,0,0.0,0,0,0,0,NO
14,src/contrib/rest/src/java/org/apache/zookeeper/server/jersey/resources/ZNodeResource.java,412,0,0.0,0,0,0.0,0,0,0.0,0,0,0.0,0,0,0,0,NO
14,src/contrib/zooinspector/src/java/com/nitido/utils/toaster/Toaster.java,533,0,0.0,0,0,0.0,0,0,0.0,0,0,0.0,0,0,0,0,NO
14,src/contrib/zooinspector/src/java/org/apache/zookeeper/inspector/ZooInspector.java,67,0,0.0,0,0,0.0,0,0,0.0,0,0,0.0,0,0,0,0,NO
14,src/contrib/zooinspector/src/java/org/apache/zookeeper/inspector/encryption/BasicDataEncryptionManager.java,50,0,0.0,0,0,0.0,0,0,0.0,0,0,0.0,0,0,0,0,NO
14,src/contrib/zooinspector/src/java/org/apache/zookeeper/inspector/encryption/DataEncryptionManager.java,39,0,0.0,0,0,0.0,0,0,0.0,0,0,0.0,0,0,0,0,NO
14,src/contrib/zooinspector/src/java/org/apache/zookeeper/inspector/gui/IconResource.java,88,0,0.0,0,0,0.0,0,0,0.0,0,0,0.0,0,0,0,0,NO
14,src/contrib/zooinspector/src/java/org/apache/zookeeper/inspector/gui/NodeViewersChangeListener.java,37,0,0.0,0,0,0.0,0,0,0.0,0,0,0.0,0,0,0,0,NO
14,src/contrib/zooinspector/src/java/org/apache/zookeeper/inspector/gui/Toolbar.java,74,0,0.0,0,0,0.0,0,0,0.0,0,0,0.0,0,0,0,0,NO
14,src/contrib/zooinspector/src/java/org/apache/zookeeper/inspector/gui/ZooInspectorAboutDialog.java,79,0,0.0,0,0,0.0,0,0,0.0,0,0,0.0,0,0,0,0,NO
14,src/contrib/zooinspector/src/java/org/apache/zookeeper/inspector/gui/ZooInspectorConnectionPropertiesDialog.java,321,0,0.0,0,0,0.0,0,0,0.0,0,0,0.0,0,0,0,0,NO
14,src/contrib/zooinspector/src/java/org/apache/zookeeper/inspector/gui/ZooInspectorNodeViewersDialog.java,631,0,0.0,0,0,0.0,0,0,0.0,0,0,0.0,0,0,0,0,NO
14,src/contrib/zooinspector/src/java/org/apache/zookeeper/inspector/gui/ZooInspectorNodeViewersPanel.java,140,0,0.0,0,0,0.0,0,0,0.0,0,0,0.0,0,0,0,0,NO
14,src/contrib/zooinspector/src/java/org/apache/zookeeper/inspector/gui/ZooInspectorPanel.java,318,0,0.0,0,0,0.0,0,0,0.0,0,0,0.0,0,0,0,0,NO
14,src/contrib/zooinspector/src/java/org/apache/zookeeper/inspector/gui/ZooInspectorTreeViewer.java,356,0,0.0,0,0,0.0,0,0,0.0,0,0,0.0,0,0,0,0,NO
14,src/contrib/zooinspector/src/java/org/apache/zookeeper/inspector/gui/nodeviewer/NodeViewerACL.java,187,0,0.0,0,0,0.0,0,0,0.0,0,0,0.0,0,0,0,0,NO
14,src/contrib/zooinspector/src/java/org/apache/zookeeper/inspector/gui/nodeviewer/NodeViewerData.java,142,0,0.0,0,0,0.0,0,0,0.0,0,0,0.0,0,0,0,0,NO
14,src/contrib/zooinspector/src/java/org/apache/zookeeper/inspector/gui/nodeviewer/NodeViewerMetaData.java,186,0,0.0,0,0,0.0,0,0,0.0,0,0,0.0,0,0,0,0,NO
14,src/contrib/zooinspector/src/java/org/apache/zookeeper/inspector/gui/nodeviewer/ZooInspectorNodeViewer.java,138,0,0.0,0,0,0.0,0,0,0.0,0,0,0.0,0,0,0,0,NO
14,src/contrib/zooinspector/src/java/org/apache/zookeeper/inspector/logger/LoggerFactory.java,36,0,0.0,0,0,0.0,0,0,0.0,0,0,0.0,0,0,0,0,NO
14,src/contrib/zooinspector/src/java/org/apache/zookeeper/inspector/manager/NodeListener.java,37,0,0.0,0,0,0.0,0,0,0.0,0,0,0.0,0,0,0,0,NO
14,src/contrib/zooinspector/src/java/org/apache/zookeeper/inspector/manager/Pair.java,120,0,0.0,0,0,0.0,0,0,0.0,0,0,0.0,0,0,0,0,NO
14,src/contrib/zooinspector/src/java/org/apache/zookeeper/inspector/manager/ZooInspectorManager.java,139,0,0.0,0,0,0.0,0,0,0.0,0,0,0.0,0,0,0,0,NO
14,src/contrib/zooinspector/src/java/org/apache/zookeeper/inspector/manager/ZooInspectorManagerImpl.java,852,0,0.0,0,0,0.0,0,0,0.0,0,0,0.0,0,0,0,0,NO
14,src/contrib/zooinspector/src/java/org/apache/zookeeper/inspector/manager/ZooInspectorNodeManager.java,33,0,0.0,0,0,0.0,0,0,0.0,0,0,0.0,0,0,0,0,NO
14,src/contrib/zooinspector/src/java/org/apache/zookeeper/inspector/manager/ZooInspectorNodeTreeManager.java,43,0,0.0,0,0,0.0,0,0,0.0,0,0,0.0,0,0,0,0,NO
14,src/contrib/zooinspector/src/java/org/apache/zookeeper/inspector/manager/ZooInspectorReadOnlyManager.java,99,0,0.0,0,0,0.0,0,0,0.0,0,0,0.0,0,0,0,0,NO
14,src/contrib/zooinspector/src/java/org/apache/zookeeper/retry/ZooKeeperRetry.java,288,0,0.0,0,0,0.0,0,0,0.0,0,0,0.0,0,0,0,0,NO
14,src/java/main/org/apache/jute/BinaryInputArchive.java,131,0,0.0,0,0,0.0,0,0,0.0,0,0,0.0,0,0,0,0,YES
14,src/java/main/org/apache/jute/BinaryOutputArchive.java,146,0,0.0,0,0,0.0,0,0,0.0,0,0,0.0,0,0,0,0,NO
14,src/java/main/org/apache/jute/CsvInputArchive.java,204,0,0.0,0,0,0.0,0,0,0.0,0,0,0.0,0,0,0,0,NO
14,src/java/main/org/apache/jute/CsvOutputArchive.java,150,0,0.0,0,0,0.0,0,0,0.0,0,0,0.0,0,0,0,0,NO
14,src/java/main/org/apache/jute/Index.java,38,0,0.0,0,0,0.0,0,0,0.0,0,0,0.0,0,0,0,0,NO
14,src/java/main/org/apache/jute/InputArchive.java,43,0,0.0,0,0,0.0,0,0,0.0,0,0,0.0,0,0,0,0,NO
14,src/java/main/org/apache/jute/OutputArchive.java,47,0,0.0,0,0,0.0,0,0,0.0,0,0,0.0,0,0,0,0,NO
14,src/java/main/org/apache/jute/Record.java,32,0,0.0,0,0,0.0,0,0,0.0,0,0,0.0,0,0,0,0,NO
14,src/java/main/org/apache/jute/RecordReader.java,93,0,0.0,0,0,0.0,0,0,0.0,0,0,0.0,0,0,0,0,NO
14,src/java/main/org/apache/jute/RecordWriter.java,93,0,0.0,0,0,0.0,0,0,0.0,0,0,0.0,0,0,0,0,NO
14,src/java/main/org/apache/jute/Utils.java,282,0,0.0,0,0,0.0,0,0,0.0,0,0,0.0,0,0,0,0,NO
14,src/java/main/org/apache/jute/XmlInputArchive.java,251,0,0.0,0,0,0.0,0,0,0.0,0,0,0.0,0,0,0,0,NO
14,src/java/main/org/apache/jute/XmlOutputArchive.java,251,0,0.0,0,0,0.0,0,0,0.0,0,0,0.0,0,0,0,0,NO
14,src/java/main/org/apache/jute/compiler/CGenerator.java,130,0,0.0,0,0,0.0,0,0,0.0,0,0,0.0,0,0,0,0,NO
14,src/java/main/org/apache/jute/compiler/CSharpGenerator.java,53,0,0.0,0,0,0.0,0,0,0.0,0,0,0.0,0,0,0,0,NO
14,src/java/main/org/apache/jute/compiler/CppGenerator.java,125,0,0.0,0,0,0.0,0,0,0.0,0,0,0.0,0,0,0,0,NO
14,src/java/main/org/apache/jute/compiler/JBoolean.java,50,0,0.0,0,0,0.0,0,0,0.0,0,0,0.0,0,0,0,0,NO
14,src/java/main/org/apache/jute/compiler/JBuffer.java,106,0,0.0,0,0,0.0,0,0,0.0,0,0,0.0,0,0,0,0,NO
14,src/java/main/org/apache/jute/compiler/JByte.java,34,0,0.0,0,0,0.0,0,0,0.0,0,0,0.0,0,0,0,0,NO
14,src/java/main/org/apache/jute/compiler/JCompType.java,66,0,0.0,0,0,0.0,0,0,0.0,0,0,0.0,0,0,0,0,NO
14,src/java/main/org/apache/jute/compiler/JDouble.java,40,0,0.0,0,0,0.0,0,0,0.0,0,0,0.0,0,0,0,0,NO
14,src/java/main/org/apache/jute/compiler/JField.java,140,0,0.0,0,0,0.0,0,0,0.0,0,0,0.0,0,0,0,0,NO
14,src/java/main/org/apache/jute/compiler/JFile.java,84,0,0.0,0,0,0.0,0,0,0.0,0,0,0.0,0,0,0,0,NO
14,src/java/main/org/apache/jute/compiler/JFloat.java,39,0,0.0,0,0,0.0,0,0,0.0,0,0,0.0,0,0,0,0,NO
14,src/java/main/org/apache/jute/compiler/JInt.java,34,0,0.0,0,0,0.0,0,0,0.0,0,0,0.0,0,0,0,0,NO
14,src/java/main/org/apache/jute/compiler/JLong.java,38,0,0.0,0,0,0.0,0,0,0.0,0,0,0.0,0,0,0,0,NO
14,src/java/main/org/apache/jute/compiler/JMap.java,149,0,0.0,0,0,0.0,0,0,0.0,0,0,0.0,0,0,0,0,NO
14,src/java/main/org/apache/jute/compiler/JRecord.java,761,0,0.0,0,0,0.0,0,0,0.0,0,0,0.0,0,0,0,0,NO
14,src/java/main/org/apache/jute/compiler/JString.java,46,0,0.0,0,0,0.0,0,0,0.0,0,0,0.0,0,0,0,0,NO
14,src/java/main/org/apache/jute/compiler/JType.java,204,0,0.0,0,0,0.0,0,0,0.0,0,0,0.0,0,0,0,0,NO
14,src/java/main/org/apache/jute/compiler/JVector.java,153,0,0.0,0,0,0.0,0,0,0.0,0,0,0.0,0,0,0,0,NO
14,src/java/main/org/apache/jute/compiler/JavaGenerator.java,57,0,0.0,0,0,0.0,0,0,0.0,0,0,0.0,0,0,0,0,NO
14,src/java/main/org/apache/zookeeper/AsyncCallback.java,57,0,0.0,0,0,0.0,0,0,0.0,0,0,0.0,0,0,0,0,NO
14,src/java/main/org/apache/zookeeper/ClientCnxn.java,1307,0,0.0,0,0,0.0,0,0,0.0,0,0,0.0,0,0,0,0,YES
14,src/java/main/org/apache/zookeeper/ClientCnxnSocket.java,170,0,0.0,0,0,0.0,0,0,0.0,0,0,0.0,0,0,0,0,NO
14,src/java/main/org/apache/zookeeper/ClientCnxnSocketNIO.java,339,0,0.0,0,0,0.0,0,0,0.0,0,0,0.0,0,0,0,0,NO
14,src/java/main/org/apache/zookeeper/ClientWatchManager.java,40,0,0.0,0,0,0.0,0,0,0.0,0,0,0.0,0,0,0,0,NO
14,src/java/main/org/apache/zookeeper/CreateMode.java,90,0,0.0,0,0,0.0,0,0,0.0,0,0,0.0,0,0,0,0,YES
14,src/java/main/org/apache/zookeeper/Environment.java,100,0,0.0,0,0,0.0,0,0,0.0,0,0,0.0,0,0,0,0,NO
14,src/java/main/org/apache/zookeeper/JLineZNodeCompletor.java,84,0,0.0,0,0,0.0,0,0,0.0,0,0,0.0,0,0,0,0,NO
14,src/java/main/org/apache/zookeeper/KeeperException.java,699,0,0.0,0,0,0.0,0,0,0.0,0,0,0.0,0,0,0,0,YES
14,src/java/main/org/apache/zookeeper/Login.java,389,0,0.0,0,0,0.0,0,0,0.0,0,0,0.0,0,0,0,0,YES
14,src/java/main/org/apache/zookeeper/MultiResponse.java,165,0,0.0,0,0,0.0,0,0,0.0,0,0,0.0,0,0,0,0,NO
14,src/java/main/org/apache/zookeeper/MultiTransactionRecord.java,159,0,0.0,0,0,0.0,0,0,0.0,0,0,0.0,0,0,0,0,NO
14,src/java/main/org/apache/zookeeper/Op.java,305,0,0.0,0,0,0.0,0,0,0.0,0,0,0.0,0,0,0,0,YES
14,src/java/main/org/apache/zookeeper/OpResult.java,185,0,0.0,0,0,0.0,0,0,0.0,0,0,0.0,0,0,0,0,YES
14,src/java/main/org/apache/zookeeper/Quotas.java,68,0,0.0,0,0,0.0,0,0,0.0,0,0,0.0,0,0,0,0,NO
14,src/java/main/org/apache/zookeeper/ServerAdminClient.java,277,0,0.0,0,0,0.0,0,0,0.0,0,0,0.0,0,0,0,0,NO
14,src/java/main/org/apache/zookeeper/Shell.java,476,0,0.0,0,0,0.0,0,0,0.0,0,0,0.0,0,0,0,0,NO
14,src/java/main/org/apache/zookeeper/StatsTrack.java,101,0,0.0,0,0,0.0,0,0,0.0,0,0,0.0,0,0,0,0,NO
14,src/java/main/org/apache/zookeeper/Transaction.java,60,0,0.0,0,0,0.0,0,0,0.0,0,0,0.0,0,0,0,0,YES
14,src/java/main/org/apache/zookeeper/Version.java,79,0,0.0,0,0,0.0,0,0,0.0,0,0,0.0,0,0,0,0,NO
14,src/java/main/org/apache/zookeeper/WatchedEvent.java,79,0,0.0,0,0,0.0,0,0,0.0,0,0,0.0,0,0,0,0,NO
14,src/java/main/org/apache/zookeeper/Watcher.java,149,0,0.0,0,0,0.0,0,0,0.0,0,0,0.0,0,0,0,0,NO
14,src/java/main/org/apache/zookeeper/ZKUtil.java,124,0,0.0,0,0,0.0,0,0,0.0,0,0,0.0,0,0,0,0,NO
14,src/java/main/org/apache/zookeeper/ZooDefs.java,119,0,0.0,0,0,0.0,0,0,0.0,0,0,0.0,0,0,0,0,NO
14,src/java/main/org/apache/zookeeper/ZooKeeper.java,1746,0,0.0,0,0,0.0,0,0,0.0,0,0,0.0,0,0,0,0,YES
14,src/java/main/org/apache/zookeeper/ZooKeeperMain.java,875,9,9.0,9,2,2.0,2,11,11.0,11,7,7.0,7,1,0,1,YES
14,src/java/main/org/apache/zookeeper/client/ConnectStringParser.java,87,0,0.0,0,0,0.0,0,0,0.0,0,0,0.0,0,0,0,0,NO
14,src/java/main/org/apache/zookeeper/client/FourLetterWordMain.java,79,79,79.0,79,0,0.0,0,79,79.0,79,79,79.0,79,1,0,1,NO
14,src/java/main/org/apache/zookeeper/client/HostProvider.java,61,0,0.0,0,0,0.0,0,0,0.0,0,0,0.0,0,0,0,0,NO
14,src/java/main/org/apache/zookeeper/client/StaticHostProvider.java,101,0,0.0,0,0,0.0,0,0,0.0,0,0,0.0,0,0,0,0,NO
14,src/java/main/org/apache/zookeeper/client/ZooKeeperSaslClient.java,355,0,0.0,0,0,0.0,0,0,0.0,0,0,0.0,0,0,0,0,YES
14,src/java/main/org/apache/zookeeper/common/PathTrie.java,284,0,0.0,0,0,0.0,0,0,0.0,0,0,0.0,0,0,0,0,NO
14,src/java/main/org/apache/zookeeper/common/PathUtils.java,103,0,0.0,0,0,0.0,0,0,0.0,0,0,0.0,0,0,0,0,NO
14,src/java/main/org/apache/zookeeper/jmx/CommonNames.java,29,0,0.0,0,0,0.0,0,0,0.0,0,0,0.0,0,0,0,0,NO
14,src/java/main/org/apache/zookeeper/jmx/MBeanRegistry.java,215,0,0.0,0,0,0.0,0,0,0.0,0,0,0.0,0,0,0,0,NO
14,src/java/main/org/apache/zookeeper/jmx/ManagedUtil.java,71,0,0.0,0,0,0.0,0,0,0.0,0,0,0.0,0,0,0,0,NO
14,src/java/main/org/apache/zookeeper/jmx/ZKMBeanInfo.java,36,0,0.0,0,0,0.0,0,0,0.0,0,0,0.0,0,0,0,0,NO
14,src/java/main/org/apache/zookeeper/server/ByteBufferInputStream.java,82,0,0.0,0,0,0.0,0,0,0.0,0,0,0.0,0,0,0,0,NO
14,src/java/main/org/apache/zookeeper/server/ByteBufferOutputStream.java,51,0,0.0,0,0,0.0,0,0,0.0,0,0,0.0,0,0,0,0,NO
14,src/java/main/org/apache/zookeeper/server/ConnectionBean.java,173,0,0.0,0,0,0.0,0,0,0.0,0,0,0.0,0,0,0,0,NO
14,src/java/main/org/apache/zookeeper/server/ConnectionMXBean.java,98,0,0.0,0,0,0.0,0,0,0.0,0,0,0.0,0,0,0,0,NO
14,src/java/main/org/apache/zookeeper/server/DataNode.java,174,0,0.0,0,0,0.0,0,0,0.0,0,0,0.0,0,0,0,0,NO
14,src/java/main/org/apache/zookeeper/server/DataTree.java,1311,11,11.0,11,9,9.0,9,20,20.0,20,2,2.0,2,1,1,1,YES
14,src/java/main/org/apache/zookeeper/server/DataTreeBean.java,61,0,0.0,0,0,0.0,0,0,0.0,0,0,0.0,0,0,0,0,NO
14,src/java/main/org/apache/zookeeper/server/DataTreeMXBean.java,47,0,0.0,0,0,0.0,0,0,0.0,0,0,0.0,0,0,0,0,NO
14,src/java/main/org/apache/zookeeper/server/DatadirCleanupManager.java,192,0,0.0,0,0,0.0,0,0,0.0,0,0,0.0,0,0,0,0,NO
14,src/java/main/org/apache/zookeeper/server/FinalRequestProcessor.java,422,0,0.0,0,0,0.0,0,0,0.0,0,0,0.0,0,0,0,0,YES
14,src/java/main/org/apache/zookeeper/server/LogFormatter.java,104,0,0.0,0,0,0.0,0,0,0.0,0,0,0.0,0,0,0,0,NO
14,src/java/main/org/apache/zookeeper/server/NIOServerCnxn.java,1156,3,1.5,3,3,1.5,3,6,3.0,6,2,1.0,2,2,0,1,YES
14,src/java/main/org/apache/zookeeper/server/NIOServerCnxnFactory.java,326,15,7.5,15,15,7.5,15,30,15.0,30,6,3.0,6,2,0,1,NO
14,src/java/main/org/apache/zookeeper/server/NettyServerCnxn.java,851,3,1.5,3,3,1.5,3,6,3.0,6,2,1.0,2,2,0,1,YES
14,src/java/main/org/apache/zookeeper/server/NettyServerCnxnFactory.java,415,5,2.5,5,5,2.5,5,10,5.0,10,10,5.0,10,2,0,1,NO
14,src/java/main/org/apache/zookeeper/server/ObserverBean.java,45,0,0.0,0,0,0.0,0,0,0.0,0,0,0.0,0,0,0,0,NO
14,src/java/main/org/apache/zookeeper/server/PrepRequestProcessor.java,716,0,0.0,0,0,0.0,0,0,0.0,0,0,0.0,0,0,0,0,YES
14,src/java/main/org/apache/zookeeper/server/PurgeTxnLog.java,129,0,0.0,0,0,0.0,0,0,0.0,0,0,0.0,0,0,0,0,NO
14,src/java/main/org/apache/zookeeper/server/Request.java,256,0,0.0,0,0,0.0,0,0,0.0,0,0,0.0,0,0,0,0,NO
14,src/java/main/org/apache/zookeeper/server/RequestProcessor.java,37,0,0.0,0,0,0.0,0,0,0.0,0,0,0.0,0,0,0,0,YES
14,src/java/main/org/apache/zookeeper/server/ServerCnxn.java,452,0,0.0,0,0,0.0,0,0,0.0,0,0,0.0,0,0,0,0,NO
14,src/java/main/org/apache/zookeeper/server/ServerCnxnFactory.java,139,11,5.5,11,11,5.5,11,22,11.0,22,6,3.0,6,2,0,1,NO
14,src/java/main/org/apache/zookeeper/server/ServerConfig.java,112,0,0.0,0,0,0.0,0,0,0.0,0,0,0.0,0,0,0,0,NO
14,src/java/main/org/apache/zookeeper/server/ServerStats.java,132,16,8.0,16,16,8.0,16,32,16.0,32,16,8.0,16,2,0,1,NO
14,src/java/main/org/apache/zookeeper/server/SessionTracker.java,81,0,0.0,0,0,0.0,0,0,0.0,0,0,0.0,0,0,0,0,NO
14,src/java/main/org/apache/zookeeper/server/SessionTrackerImpl.java,274,0,0.0,0,0,0.0,0,0,0.0,0,0,0.0,0,0,0,0,YES
14,src/java/main/org/apache/zookeeper/server/Stats.java,68,0,0.0,0,0,0.0,0,0,0.0,0,0,0.0,0,0,0,0,NO
14,src/java/main/org/apache/zookeeper/server/SyncRequestProcessor.java,190,0,0.0,0,0,0.0,0,0,0.0,0,0,0.0,0,0,0,0,YES
14,src/java/main/org/apache/zookeeper/server/TraceFormatter.java,123,0,0.0,0,0,0.0,0,0,0.0,0,0,0.0,0,0,0,0,NO
14,src/java/main/org/apache/zookeeper/server/WatchManager.java,171,0,0.0,0,0,0.0,0,0,0.0,0,0,0.0,0,0,0,0,NO
14,src/java/main/org/apache/zookeeper/server/ZKDatabase.java,483,0,0.0,0,0,0.0,0,0,0.0,0,0,0.0,0,0,0,0,NO
14,src/java/main/org/apache/zookeeper/server/ZooKeeperSaslServer.java,127,0,0.0,0,0,0.0,0,0,0.0,0,0,0.0,0,0,0,0,NO
14,src/java/main/org/apache/zookeeper/server/ZooKeeperServer.java,921,11,5.5,11,11,5.5,11,22,11.0,22,14,7.0,14,2,0,1,YES
14,src/java/main/org/apache/zookeeper/server/ZooKeeperServerBean.java,143,4,2.0,4,4,2.0,4,8,4.0,8,8,4.0,8,2,0,1,NO
14,src/java/main/org/apache/zookeeper/server/ZooKeeperServerMXBean.java,106,4,2.0,4,4,2.0,4,8,4.0,8,8,4.0,8,2,0,1,NO
14,src/java/main/org/apache/zookeeper/server/ZooKeeperServerMain.java,123,0,0.0,0,0,0.0,0,0,0.0,0,0,0.0,0,0,0,0,NO
14,src/java/main/org/apache/zookeeper/server/ZooTrace.java,93,0,0.0,0,0,0.0,0,0,0.0,0,0,0.0,0,0,0,0,NO
14,src/java/main/org/apache/zookeeper/server/auth/AuthenticationProvider.java,82,0,0.0,0,0,0.0,0,0,0.0,0,0,0.0,0,0,0,0,NO
14,src/java/main/org/apache/zookeeper/server/auth/DigestAuthenticationProvider.java,139,0,0.0,0,0,0.0,0,0,0.0,0,0,0.0,0,0,0,0,NO
14,src/java/main/org/apache/zookeeper/server/auth/DigestLoginModule.java,59,0,0.0,0,0,0.0,0,0,0.0,0,0,0.0,0,0,0,0,NO
14,src/java/main/org/apache/zookeeper/server/auth/IPAuthenticationProvider.java,117,0,0.0,0,0,0.0,0,0,0.0,0,0,0.0,0,0,0,0,NO
14,src/java/main/org/apache/zookeeper/server/auth/KerberosName.java,418,0,0.0,0,0,0.0,0,0,0.0,0,0,0.0,0,0,0,0,YES
14,src/java/main/org/apache/zookeeper/server/auth/ProviderRegistry.java,77,0,0.0,0,0,0.0,0,0,0.0,0,0,0.0,0,0,0,0,NO
14,src/java/main/org/apache/zookeeper/server/auth/SASLAuthenticationProvider.java,70,0,0.0,0,0,0.0,0,0,0.0,0,0,0.0,0,0,0,0,NO
14,src/java/main/org/apache/zookeeper/server/auth/SaslServerCallbackHandler.java,148,0,0.0,0,0,0.0,0,0,0.0,0,0,0.0,0,0,0,0,NO
14,src/java/main/org/apache/zookeeper/server/persistence/FileSnap.java,250,0,0.0,0,0,0.0,0,0,0.0,0,0,0.0,0,0,0,0,NO
14,src/java/main/org/apache/zookeeper/server/persistence/FileTxnLog.java,660,0,0.0,0,0,0.0,0,0,0.0,0,0,0.0,0,0,0,0,NO
14,src/java/main/org/apache/zookeeper/server/persistence/FileTxnSnapLog.java,325,12,12.0,12,11,11.0,11,23,23.0,23,1,1.0,1,1,1,1,NO
14,src/java/main/org/apache/zookeeper/server/persistence/SnapShot.java,66,0,0.0,0,0,0.0,0,0,0.0,0,0,0.0,0,0,0,0,NO
14,src/java/main/org/apache/zookeeper/server/persistence/TxnLog.java,120,0,0.0,0,0,0.0,0,0,0.0,0,0,0.0,0,0,0,0,NO
14,src/java/main/org/apache/zookeeper/server/persistence/Util.java,326,0,0.0,0,0,0.0,0,0,0.0,0,0,0.0,0,0,0,0,NO
14,src/java/main/org/apache/zookeeper/server/quorum/AckRequestProcessor.java,54,0,0.0,0,0,0.0,0,0,0.0,0,0,0.0,0,0,0,0,NO
14,src/java/main/org/apache/zookeeper/server/quorum/AuthFastLeaderElection.java,972,0,0.0,0,0,0.0,0,0,0.0,0,0,0.0,0,0,0,0,NO
14,src/java/main/org/apache/zookeeper/server/quorum/CommitProcessor.java,185,0,0.0,0,0,0.0,0,0,0.0,0,0,0.0,0,0,0,0,NO
14,src/java/main/org/apache/zookeeper/server/quorum/Election.java,27,0,0.0,0,0,0.0,0,0,0.0,0,0,0.0,0,0,0,0,NO
14,src/java/main/org/apache/zookeeper/server/quorum/FastLeaderElection.java,890,0,0.0,0,0,0.0,0,0,0.0,0,0,0.0,0,0,0,0,NO
14,src/java/main/org/apache/zookeeper/server/quorum/Follower.java,167,0,0.0,0,0,0.0,0,0,0.0,0,0,0.0,0,0,0,0,NO
14,src/java/main/org/apache/zookeeper/server/quorum/FollowerBean.java,50,0,0.0,0,0,0.0,0,0,0.0,0,0,0.0,0,0,0,0,NO
14,src/java/main/org/apache/zookeeper/server/quorum/FollowerMXBean.java,41,0,0.0,0,0,0.0,0,0,0.0,0,0,0.0,0,0,0,0,NO
14,src/java/main/org/apache/zookeeper/server/quorum/FollowerRequestProcessor.java,113,0,0.0,0,0,0.0,0,0,0.0,0,0,0.0,0,0,0,0,NO
14,src/java/main/org/apache/zookeeper/server/quorum/FollowerZooKeeperServer.java,160,0,0.0,0,0,0.0,0,0,0.0,0,0,0.0,0,0,0,0,NO
14,src/java/main/org/apache/zookeeper/server/quorum/Leader.java,827,3,3.0,3,2,2.0,2,5,5.0,5,1,1.0,1,1,0,1,YES
14,src/java/main/org/apache/zookeeper/server/quorum/LeaderBean.java,53,0,0.0,0,0,0.0,0,0,0.0,0,0,0.0,0,0,0,0,YES
14,src/java/main/org/apache/zookeeper/server/quorum/LeaderElection.java,293,0,0.0,0,0,0.0,0,0,0.0,0,0,0.0,0,0,0,0,NO
14,src/java/main/org/apache/zookeeper/server/quorum/LeaderElectionBean.java,42,0,0.0,0,0,0.0,0,0,0.0,0,0,0.0,0,0,0,0,NO
14,src/java/main/org/apache/zookeeper/server/quorum/LeaderElectionMXBean.java,31,0,0.0,0,0,0.0,0,0,0.0,0,0,0.0,0,0,0,0,NO
14,src/java/main/org/apache/zookeeper/server/quorum/LeaderMXBean.java,36,0,0.0,0,0,0.0,0,0,0.0,0,0,0.0,0,0,0,0,NO
14,src/java/main/org/apache/zookeeper/server/quorum/LeaderZooKeeperServer.java,173,0,0.0,0,0,0.0,0,0,0.0,0,0,0.0,0,0,0,0,YES
14,src/java/main/org/apache/zookeeper/server/quorum/Learner.java,481,0,0.0,0,0,0.0,0,0,0.0,0,0,0.0,0,0,0,0,YES
14,src/java/main/org/apache/zookeeper/server/quorum/LearnerHandler.java,611,0,0.0,0,0,0.0,0,0,0.0,0,0,0.0,0,0,0,0,NO
14,src/java/main/org/apache/zookeeper/server/quorum/LearnerSessionTracker.java,96,0,0.0,0,0,0.0,0,0,0.0,0,0,0.0,0,0,0,0,NO
14,src/java/main/org/apache/zookeeper/server/quorum/LearnerSyncRequest.java,34,0,0.0,0,0,0.0,0,0,0.0,0,0,0.0,0,0,0,0,NO
14,src/java/main/org/apache/zookeeper/server/quorum/LearnerZooKeeperServer.java,141,0,0.0,0,0,0.0,0,0,0.0,0,0,0.0,0,0,0,0,YES
14,src/java/main/org/apache/zookeeper/server/quorum/LocalPeerBean.java,79,0,0.0,0,0,0.0,0,0,0.0,0,0,0.0,0,0,0,0,NO
14,src/java/main/org/apache/zookeeper/server/quorum/LocalPeerMXBean.java,77,0,0.0,0,0,0.0,0,0,0.0,0,0,0.0,0,0,0,0,NO
14,src/java/main/org/apache/zookeeper/server/quorum/Observer.java,134,0,0.0,0,0,0.0,0,0,0.0,0,0,0.0,0,0,0,0,NO
14,src/java/main/org/apache/zookeeper/server/quorum/ObserverMXBean.java,37,0,0.0,0,0,0.0,0,0,0.0,0,0,0.0,0,0,0,0,NO
14,src/java/main/org/apache/zookeeper/server/quorum/ObserverRequestProcessor.java,127,0,0.0,0,0,0.0,0,0,0.0,0,0,0.0,0,0,0,0,NO
14,src/java/main/org/apache/zookeeper/server/quorum/ObserverZooKeeperServer.java,115,0,0.0,0,0,0.0,0,0,0.0,0,0,0.0,0,0,0,0,NO
14,src/java/main/org/apache/zookeeper/server/quorum/ProposalRequestProcessor.java,88,0,0.0,0,0,0.0,0,0,0.0,0,0,0.0,0,0,0,0,YES
14,src/java/main/org/apache/zookeeper/server/quorum/QuorumBean.java,44,0,0.0,0,0,0.0,0,0,0.0,0,0,0.0,0,0,0,0,NO
14,src/java/main/org/apache/zookeeper/server/quorum/QuorumCnxManager.java,884,1,1.0,1,0,0.0,0,1,1.0,1,1,1.0,1,1,0,1,YES
14,src/java/main/org/apache/zookeeper/server/quorum/QuorumMXBean.java,34,0,0.0,0,0,0.0,0,0,0.0,0,0,0.0,0,0,0,0,NO
14,src/java/main/org/apache/zookeeper/server/quorum/QuorumPeer.java,1123,0,0.0,0,0,0.0,0,0,0.0,0,0,0.0,0,0,0,0,YES
14,src/java/main/org/apache/zookeeper/server/quorum/QuorumPeerConfig.java,411,0,0.0,0,0,0.0,0,0,0.0,0,0,0.0,0,0,0,0,NO
14,src/java/main/org/apache/zookeeper/server/quorum/QuorumPeerMain.java,157,0,0.0,0,0,0.0,0,0,0.0,0,0,0.0,0,0,0,0,NO
14,src/java/main/org/apache/zookeeper/server/quorum/QuorumStats.java,68,0,0.0,0,0,0.0,0,0,0.0,0,0,0.0,0,0,0,0,NO
14,src/java/main/org/apache/zookeeper/server/quorum/QuorumZooKeeperServer.java,59,0,0.0,0,0,0.0,0,0,0.0,0,0,0.0,0,0,0,0,NO
14,src/java/main/org/apache/zookeeper/server/quorum/ReadOnlyBean.java,38,0,0.0,0,0,0.0,0,0,0.0,0,0,0.0,0,0,0,0,NO
14,src/java/main/org/apache/zookeeper/server/quorum/ReadOnlyRequestProcessor.java,120,0,0.0,0,0,0.0,0,0,0.0,0,0,0.0,0,0,0,0,YES
14,src/java/main/org/apache/zookeeper/server/quorum/ReadOnlyZooKeeperServer.java,144,0,0.0,0,0,0.0,0,0,0.0,0,0,0.0,0,0,0,0,NO
14,src/java/main/org/apache/zookeeper/server/quorum/RemotePeerBean.java,45,0,0.0,0,0,0.0,0,0,0.0,0,0,0.0,0,0,0,0,NO
14,src/java/main/org/apache/zookeeper/server/quorum/RemotePeerMXBean.java,33,0,0.0,0,0,0.0,0,0,0.0,0,0,0.0,0,0,0,0,NO
14,src/java/main/org/apache/zookeeper/server/quorum/SendAckRequestProcessor.java,80,0,0.0,0,0,0.0,0,0,0.0,0,0,0.0,0,0,0,0,NO
14,src/java/main/org/apache/zookeeper/server/quorum/ServerBean.java,38,0,0.0,0,0,0.0,0,0,0.0,0,0,0.0,0,0,0,0,NO
14,src/java/main/org/apache/zookeeper/server/quorum/ServerMXBean.java,33,0,0.0,0,0,0.0,0,0,0.0,0,0,0.0,0,0,0,0,NO
14,src/java/main/org/apache/zookeeper/server/quorum/StateSummary.java,57,0,0.0,0,0,0.0,0,0,0.0,0,0,0.0,0,0,0,0,NO
14,src/java/main/org/apache/zookeeper/server/quorum/Vote.java,106,0,0.0,0,0,0.0,0,0,0.0,0,0,0.0,0,0,0,0,NO
14,src/java/main/org/apache/zookeeper/server/quorum/flexible/QuorumHierarchical.java,271,0,0.0,0,0,0.0,0,0,0.0,0,0,0.0,0,0,0,0,NO
14,src/java/main/org/apache/zookeeper/server/quorum/flexible/QuorumMaj.java,57,0,0.0,0,0,0.0,0,0,0.0,0,0,0.0,0,0,0,0,NO
14,src/java/main/org/apache/zookeeper/server/quorum/flexible/QuorumVerifier.java,33,0,0.0,0,0,0.0,0,0,0.0,0,0,0.0,0,0,0,0,NO
14,src/java/main/org/apache/zookeeper/server/util/SerializeUtils.java,141,0,0.0,0,0,0.0,0,0,0.0,0,0,0.0,0,0,0,0,NO
14,src/java/main/org/apache/zookeeper/server/util/VerifyingFileFactory.java,82,0,0.0,0,0,0.0,0,0,0.0,0,0,0.0,0,0,0,0,NO
14,src/java/main/org/apache/zookeeper/server/util/ZxidUtils.java,34,0,0.0,0,0,0.0,0,0,0.0,0,0,0.0,0,0,0,0,NO
14,src/java/main/org/apache/zookeeper/version/util/VerGen.java,177,0,0.0,0,0,0.0,0,0,0.0,0,0,0.0,0,0,0,0,NO
14,src/recipes/election/src/java/org/apache/zookeeper/recipes/leader/LeaderElectionAware.java,37,0,0.0,0,0,0.0,0,0,0.0,0,0,0.0,0,0,0,0,NO
14,src/recipes/election/src/java/org/apache/zookeeper/recipes/leader/LeaderElectionSupport.java,461,0,0.0,0,0,0.0,0,0,0.0,0,0,0.0,0,0,0,0,NO
14,src/recipes/election/src/java/org/apache/zookeeper/recipes/leader/LeaderOffer.java,84,0,0.0,0,0,0.0,0,0,0.0,0,0,0.0,0,0,0,0,NO
14,src/recipes/lock/src/java/org/apache/zookeeper/recipes/lock/LockListener.java,38,0,0.0,0,0,0.0,0,0,0.0,0,0,0.0,0,0,0,0,NO
14,src/recipes/lock/src/java/org/apache/zookeeper/recipes/lock/ProtocolSupport.java,193,0,0.0,0,0,0.0,0,0,0.0,0,0,0.0,0,0,0,0,NO
14,src/recipes/lock/src/java/org/apache/zookeeper/recipes/lock/WriteLock.java,295,0,0.0,0,0,0.0,0,0,0.0,0,0,0.0,0,0,0,0,NO
14,src/recipes/lock/src/java/org/apache/zookeeper/recipes/lock/ZNodeName.java,110,0,0.0,0,0,0.0,0,0,0.0,0,0,0.0,0,0,0,0,NO
14,src/recipes/lock/src/java/org/apache/zookeeper/recipes/lock/ZooKeeperOperation.java,38,0,0.0,0,0,0.0,0,0,0.0,0,0,0.0,0,0,0,0,NO
14,src/recipes/queue/src/java/org/apache/zookeeper/recipes/queue/DistributedQueue.java,313,0,0.0,0,0,0.0,0,0,0.0,0,0,0.0,0,0,0,0,NO
15,src/contrib/fatjar/src/java/org/apache/zookeeper/util/FatJarMain.java,126,0,0.0,0,0,0.0,0,0,0.0,0,0,0.0,0,0,0,0,NO
15,src/contrib/loggraph/src/java/org/apache/zookeeper/graph/FilterException.java,22,0,0.0,0,0,0.0,0,0,0.0,0,0,0.0,0,0,0,0,NO
15,src/contrib/loggraph/src/java/org/apache/zookeeper/graph/FilterOp.java,75,0,0.0,0,0,0.0,0,0,0.0,0,0,0.0,0,0,0,0,NO
15,src/contrib/loggraph/src/java/org/apache/zookeeper/graph/FilterParser.java,131,0,0.0,0,0,0.0,0,0,0.0,0,0,0.0,0,0,0,0,NO
15,src/contrib/loggraph/src/java/org/apache/zookeeper/graph/JsonGenerator.java,223,0,0.0,0,0,0.0,0,0,0.0,0,0,0.0,0,0,0,0,NO
15,src/contrib/loggraph/src/java/org/apache/zookeeper/graph/Log4JEntry.java,40,0,0.0,0,0,0.0,0,0,0.0,0,0,0.0,0,0,0,0,NO
15,src/contrib/loggraph/src/java/org/apache/zookeeper/graph/Log4JSource.java,381,0,0.0,0,0,0.0,0,0,0.0,0,0,0.0,0,0,0,0,NO
15,src/contrib/loggraph/src/java/org/apache/zookeeper/graph/LogEntry.java,46,0,0.0,0,0,0.0,0,0,0.0,0,0,0.0,0,0,0,0,NO
15,src/contrib/loggraph/src/java/org/apache/zookeeper/graph/LogIterator.java,26,0,0.0,0,0,0.0,0,0,0.0,0,0,0.0,0,0,0,0,NO
15,src/contrib/loggraph/src/java/org/apache/zookeeper/graph/LogServer.java,66,0,0.0,0,0,0.0,0,0,0.0,0,0,0.0,0,0,0,0,NO
15,src/contrib/loggraph/src/java/org/apache/zookeeper/graph/LogSkipList.java,95,0,0.0,0,0,0.0,0,0,0.0,0,0,0.0,0,0,0,0,NO
15,src/contrib/loggraph/src/java/org/apache/zookeeper/graph/LogSource.java,33,0,0.0,0,0,0.0,0,0,0.0,0,0,0.0,0,0,0,0,NO
15,src/contrib/loggraph/src/java/org/apache/zookeeper/graph/MeasureThroughput.java,103,0,0.0,0,0,0.0,0,0,0.0,0,0,0.0,0,0,0,0,NO
15,src/contrib/loggraph/src/java/org/apache/zookeeper/graph/MergedLogSource.java,219,0,0.0,0,0,0.0,0,0,0.0,0,0,0.0,0,0,0,0,NO
15,src/contrib/loggraph/src/java/org/apache/zookeeper/graph/RandomAccessFileReader.java,328,0,0.0,0,0,0.0,0,0,0.0,0,0,0.0,0,0,0,0,NO
15,src/contrib/loggraph/src/java/org/apache/zookeeper/graph/TransactionEntry.java,59,0,0.0,0,0,0.0,0,0,0.0,0,0,0.0,0,0,0,0,NO
15,src/contrib/loggraph/src/java/org/apache/zookeeper/graph/TxnLogSource.java,376,0,0.0,0,0,0.0,0,0,0.0,0,0,0.0,0,0,0,0,NO
15,src/contrib/loggraph/src/java/org/apache/zookeeper/graph/filterops/AndOp.java,33,0,0.0,0,0,0.0,0,0,0.0,0,0,0.0,0,0,0,0,NO
15,src/contrib/loggraph/src/java/org/apache/zookeeper/graph/filterops/Arg.java,36,0,0.0,0,0,0.0,0,0,0.0,0,0,0.0,0,0,0,0,NO
15,src/contrib/loggraph/src/java/org/apache/zookeeper/graph/filterops/EqualsOp.java,44,0,0.0,0,0,0.0,0,0,0.0,0,0,0.0,0,0,0,0,NO
15,src/contrib/loggraph/src/java/org/apache/zookeeper/graph/filterops/GreaterThanOp.java,70,0,0.0,0,0,0.0,0,0,0.0,0,0,0.0,0,0,0,0,NO
15,src/contrib/loggraph/src/java/org/apache/zookeeper/graph/filterops/LessThanOp.java,69,0,0.0,0,0,0.0,0,0,0.0,0,0,0.0,0,0,0,0,NO
15,src/contrib/loggraph/src/java/org/apache/zookeeper/graph/filterops/NotOp.java,31,0,0.0,0,0,0.0,0,0,0.0,0,0,0.0,0,0,0,0,NO
15,src/contrib/loggraph/src/java/org/apache/zookeeper/graph/filterops/NumberArg.java,27,0,0.0,0,0,0.0,0,0,0.0,0,0,0.0,0,0,0,0,NO
15,src/contrib/loggraph/src/java/org/apache/zookeeper/graph/filterops/OrOp.java,33,0,0.0,0,0,0.0,0,0,0.0,0,0,0.0,0,0,0,0,NO
15,src/contrib/loggraph/src/java/org/apache/zookeeper/graph/filterops/StringArg.java,27,0,0.0,0,0,0.0,0,0,0.0,0,0,0.0,0,0,0,0,NO
15,src/contrib/loggraph/src/java/org/apache/zookeeper/graph/filterops/SymbolArg.java,27,0,0.0,0,0,0.0,0,0,0.0,0,0,0.0,0,0,0,0,NO
15,src/contrib/loggraph/src/java/org/apache/zookeeper/graph/filterops/XorOp.java,40,0,0.0,0,0,0.0,0,0,0.0,0,0,0.0,0,0,0,0,NO
15,src/contrib/loggraph/src/java/org/apache/zookeeper/graph/servlets/FileLoader.java,60,0,0.0,0,0,0.0,0,0,0.0,0,0,0.0,0,0,0,0,NO
15,src/contrib/loggraph/src/java/org/apache/zookeeper/graph/servlets/Fs.java,69,0,0.0,0,0,0.0,0,0,0.0,0,0,0.0,0,0,0,0,NO
15,src/contrib/loggraph/src/java/org/apache/zookeeper/graph/servlets/GraphData.java,85,0,0.0,0,0,0.0,0,0,0.0,0,0,0.0,0,0,0,0,NO
15,src/contrib/loggraph/src/java/org/apache/zookeeper/graph/servlets/JsonServlet.java,85,0,0.0,0,0,0.0,0,0,0.0,0,0,0.0,0,0,0,0,NO
15,src/contrib/loggraph/src/java/org/apache/zookeeper/graph/servlets/NumEvents.java,86,0,0.0,0,0,0.0,0,0,0.0,0,0,0.0,0,0,0,0,NO
15,src/contrib/loggraph/src/java/org/apache/zookeeper/graph/servlets/StaticContent.java,50,0,0.0,0,0,0.0,0,0,0.0,0,0,0.0,0,0,0,0,NO
15,src/contrib/loggraph/src/java/org/apache/zookeeper/graph/servlets/Throughput.java,125,0,0.0,0,0,0.0,0,0,0.0,0,0,0.0,0,0,0,0,NO
15,src/contrib/rest/src/java/org/apache/zookeeper/server/jersey/RestMain.java,151,0,0.0,0,0,0.0,0,0,0.0,0,0,0.0,0,0,0,0,NO
15,src/contrib/rest/src/java/org/apache/zookeeper/server/jersey/ZooKeeperService.java,242,0,0.0,0,0,0.0,0,0,0.0,0,0,0.0,0,0,0,0,NO
15,src/contrib/rest/src/java/org/apache/zookeeper/server/jersey/cfg/Credentials.java,47,0,0.0,0,0,0.0,0,0,0.0,0,0,0.0,0,0,0,0,NO
15,src/contrib/rest/src/java/org/apache/zookeeper/server/jersey/cfg/Endpoint.java,72,0,0.0,0,0,0.0,0,0,0.0,0,0,0.0,0,0,0,0,NO
15,src/contrib/rest/src/java/org/apache/zookeeper/server/jersey/cfg/HostPort.java,51,0,0.0,0,0,0.0,0,0,0.0,0,0,0.0,0,0,0,0,NO
15,src/contrib/rest/src/java/org/apache/zookeeper/server/jersey/cfg/HostPortSet.java,51,0,0.0,0,0,0.0,0,0,0.0,0,0,0.0,0,0,0,0,NO
15,src/contrib/rest/src/java/org/apache/zookeeper/server/jersey/cfg/RestCfg.java,106,0,0.0,0,0,0.0,0,0,0.0,0,0,0.0,0,0,0,0,NO
15,src/contrib/rest/src/java/org/apache/zookeeper/server/jersey/filters/HTTPBasicAuth.java,87,0,0.0,0,0,0.0,0,0,0.0,0,0,0.0,0,0,0,0,NO
15,src/contrib/rest/src/java/org/apache/zookeeper/server/jersey/jaxb/ZChildren.java,80,0,0.0,0,0,0.0,0,0,0.0,0,0,0.0,0,0,0,0,NO
15,src/contrib/rest/src/java/org/apache/zookeeper/server/jersey/jaxb/ZChildrenJSON.java,76,0,0.0,0,0,0.0,0,0,0.0,0,0,0.0,0,0,0,0,NO
15,src/contrib/rest/src/java/org/apache/zookeeper/server/jersey/jaxb/ZError.java,41,0,0.0,0,0,0.0,0,0,0.0,0,0,0.0,0,0,0,0,NO
15,src/contrib/rest/src/java/org/apache/zookeeper/server/jersey/jaxb/ZPath.java,63,0,0.0,0,0,0.0,0,0,0.0,0,0,0.0,0,0,0,0,NO
15,src/contrib/rest/src/java/org/apache/zookeeper/server/jersey/jaxb/ZSession.java,55,0,0.0,0,0,0.0,0,0,0.0,0,0,0.0,0,0,0,0,NO
15,src/contrib/rest/src/java/org/apache/zookeeper/server/jersey/jaxb/ZStat.java,106,0,0.0,0,0,0.0,0,0,0.0,0,0,0.0,0,0,0,0,NO
15,src/contrib/rest/src/java/org/apache/zookeeper/server/jersey/resources/JAXBContextResolver.java,72,0,0.0,0,0,0.0,0,0,0.0,0,0,0.0,0,0,0,0,NO
15,src/contrib/rest/src/java/org/apache/zookeeper/server/jersey/resources/KeeperExceptionMapper.java,86,0,0.0,0,0,0.0,0,0,0.0,0,0,0.0,0,0,0,0,NO
15,src/contrib/rest/src/java/org/apache/zookeeper/server/jersey/resources/RuntimeExceptionMapper.java,55,0,0.0,0,0,0.0,0,0,0.0,0,0,0.0,0,0,0,0,NO
15,src/contrib/rest/src/java/org/apache/zookeeper/server/jersey/resources/SessionsResource.java,135,0,0.0,0,0,0.0,0,0,0.0,0,0,0.0,0,0,0,0,NO
15,src/contrib/rest/src/java/org/apache/zookeeper/server/jersey/resources/ZErrorWriter.java,63,0,0.0,0,0,0.0,0,0,0.0,0,0,0.0,0,0,0,0,NO
15,src/contrib/rest/src/java/org/apache/zookeeper/server/jersey/resources/ZNodeResource.java,412,0,0.0,0,0,0.0,0,0,0.0,0,0,0.0,0,0,0,0,NO
15,src/contrib/zooinspector/src/java/com/nitido/utils/toaster/Toaster.java,533,0,0.0,0,0,0.0,0,0,0.0,0,0,0.0,0,0,0,0,NO
15,src/contrib/zooinspector/src/java/org/apache/zookeeper/inspector/ZooInspector.java,67,0,0.0,0,0,0.0,0,0,0.0,0,0,0.0,0,0,0,0,NO
15,src/contrib/zooinspector/src/java/org/apache/zookeeper/inspector/encryption/BasicDataEncryptionManager.java,50,0,0.0,0,0,0.0,0,0,0.0,0,0,0.0,0,0,0,0,NO
15,src/contrib/zooinspector/src/java/org/apache/zookeeper/inspector/encryption/DataEncryptionManager.java,39,0,0.0,0,0,0.0,0,0,0.0,0,0,0.0,0,0,0,0,NO
15,src/contrib/zooinspector/src/java/org/apache/zookeeper/inspector/gui/IconResource.java,88,0,0.0,0,0,0.0,0,0,0.0,0,0,0.0,0,0,0,0,NO
15,src/contrib/zooinspector/src/java/org/apache/zookeeper/inspector/gui/NodeViewersChangeListener.java,37,0,0.0,0,0,0.0,0,0,0.0,0,0,0.0,0,0,0,0,NO
15,src/contrib/zooinspector/src/java/org/apache/zookeeper/inspector/gui/Toolbar.java,74,0,0.0,0,0,0.0,0,0,0.0,0,0,0.0,0,0,0,0,NO
15,src/contrib/zooinspector/src/java/org/apache/zookeeper/inspector/gui/ZooInspectorAboutDialog.java,79,0,0.0,0,0,0.0,0,0,0.0,0,0,0.0,0,0,0,0,NO
15,src/contrib/zooinspector/src/java/org/apache/zookeeper/inspector/gui/ZooInspectorConnectionPropertiesDialog.java,321,0,0.0,0,0,0.0,0,0,0.0,0,0,0.0,0,0,0,0,NO
15,src/contrib/zooinspector/src/java/org/apache/zookeeper/inspector/gui/ZooInspectorNodeViewersDialog.java,631,0,0.0,0,0,0.0,0,0,0.0,0,0,0.0,0,0,0,0,NO
15,src/contrib/zooinspector/src/java/org/apache/zookeeper/inspector/gui/ZooInspectorNodeViewersPanel.java,140,0,0.0,0,0,0.0,0,0,0.0,0,0,0.0,0,0,0,0,NO
15,src/contrib/zooinspector/src/java/org/apache/zookeeper/inspector/gui/ZooInspectorPanel.java,318,0,0.0,0,0,0.0,0,0,0.0,0,0,0.0,0,0,0,0,NO
15,src/contrib/zooinspector/src/java/org/apache/zookeeper/inspector/gui/ZooInspectorTreeViewer.java,356,0,0.0,0,0,0.0,0,0,0.0,0,0,0.0,0,0,0,0,NO
15,src/contrib/zooinspector/src/java/org/apache/zookeeper/inspector/gui/nodeviewer/NodeViewerACL.java,187,0,0.0,0,0,0.0,0,0,0.0,0,0,0.0,0,0,0,0,NO
15,src/contrib/zooinspector/src/java/org/apache/zookeeper/inspector/gui/nodeviewer/NodeViewerData.java,142,0,0.0,0,0,0.0,0,0,0.0,0,0,0.0,0,0,0,0,NO
15,src/contrib/zooinspector/src/java/org/apache/zookeeper/inspector/gui/nodeviewer/NodeViewerMetaData.java,186,0,0.0,0,0,0.0,0,0,0.0,0,0,0.0,0,0,0,0,NO
15,src/contrib/zooinspector/src/java/org/apache/zookeeper/inspector/gui/nodeviewer/ZooInspectorNodeViewer.java,138,0,0.0,0,0,0.0,0,0,0.0,0,0,0.0,0,0,0,0,NO
15,src/contrib/zooinspector/src/java/org/apache/zookeeper/inspector/logger/LoggerFactory.java,36,0,0.0,0,0,0.0,0,0,0.0,0,0,0.0,0,0,0,0,NO
15,src/contrib/zooinspector/src/java/org/apache/zookeeper/inspector/manager/NodeListener.java,37,0,0.0,0,0,0.0,0,0,0.0,0,0,0.0,0,0,0,0,NO
15,src/contrib/zooinspector/src/java/org/apache/zookeeper/inspector/manager/Pair.java,120,0,0.0,0,0,0.0,0,0,0.0,0,0,0.0,0,0,0,0,NO
15,src/contrib/zooinspector/src/java/org/apache/zookeeper/inspector/manager/ZooInspectorManager.java,139,0,0.0,0,0,0.0,0,0,0.0,0,0,0.0,0,0,0,0,NO
15,src/contrib/zooinspector/src/java/org/apache/zookeeper/inspector/manager/ZooInspectorManagerImpl.java,852,0,0.0,0,0,0.0,0,0,0.0,0,0,0.0,0,0,0,0,NO
15,src/contrib/zooinspector/src/java/org/apache/zookeeper/inspector/manager/ZooInspectorNodeManager.java,33,0,0.0,0,0,0.0,0,0,0.0,0,0,0.0,0,0,0,0,NO
15,src/contrib/zooinspector/src/java/org/apache/zookeeper/inspector/manager/ZooInspectorNodeTreeManager.java,43,0,0.0,0,0,0.0,0,0,0.0,0,0,0.0,0,0,0,0,NO
15,src/contrib/zooinspector/src/java/org/apache/zookeeper/inspector/manager/ZooInspectorReadOnlyManager.java,99,0,0.0,0,0,0.0,0,0,0.0,0,0,0.0,0,0,0,0,NO
15,src/contrib/zooinspector/src/java/org/apache/zookeeper/retry/ZooKeeperRetry.java,288,0,0.0,0,0,0.0,0,0,0.0,0,0,0.0,0,0,0,0,NO
15,src/java/main/org/apache/jute/BinaryInputArchive.java,131,0,0.0,0,0,0.0,0,0,0.0,0,0,0.0,0,0,0,0,YES
15,src/java/main/org/apache/jute/BinaryOutputArchive.java,146,0,0.0,0,0,0.0,0,0,0.0,0,0,0.0,0,0,0,0,NO
15,src/java/main/org/apache/jute/CsvInputArchive.java,204,0,0.0,0,0,0.0,0,0,0.0,0,0,0.0,0,0,0,0,NO
15,src/java/main/org/apache/jute/CsvOutputArchive.java,150,0,0.0,0,0,0.0,0,0,0.0,0,0,0.0,0,0,0,0,NO
15,src/java/main/org/apache/jute/Index.java,38,0,0.0,0,0,0.0,0,0,0.0,0,0,0.0,0,0,0,0,NO
15,src/java/main/org/apache/jute/InputArchive.java,43,0,0.0,0,0,0.0,0,0,0.0,0,0,0.0,0,0,0,0,NO
15,src/java/main/org/apache/jute/OutputArchive.java,47,0,0.0,0,0,0.0,0,0,0.0,0,0,0.0,0,0,0,0,NO
15,src/java/main/org/apache/jute/Record.java,32,0,0.0,0,0,0.0,0,0,0.0,0,0,0.0,0,0,0,0,NO
15,src/java/main/org/apache/jute/RecordReader.java,93,0,0.0,0,0,0.0,0,0,0.0,0,0,0.0,0,0,0,0,NO
15,src/java/main/org/apache/jute/RecordWriter.java,93,0,0.0,0,0,0.0,0,0,0.0,0,0,0.0,0,0,0,0,NO
15,src/java/main/org/apache/jute/Utils.java,282,0,0.0,0,0,0.0,0,0,0.0,0,0,0.0,0,0,0,0,NO
15,src/java/main/org/apache/jute/XmlInputArchive.java,251,0,0.0,0,0,0.0,0,0,0.0,0,0,0.0,0,0,0,0,NO
15,src/java/main/org/apache/jute/XmlOutputArchive.java,251,0,0.0,0,0,0.0,0,0,0.0,0,0,0.0,0,0,0,0,NO
15,src/java/main/org/apache/jute/compiler/CGenerator.java,130,0,0.0,0,0,0.0,0,0,0.0,0,0,0.0,0,0,0,0,NO
15,src/java/main/org/apache/jute/compiler/CSharpGenerator.java,53,0,0.0,0,0,0.0,0,0,0.0,0,0,0.0,0,0,0,0,NO
15,src/java/main/org/apache/jute/compiler/CppGenerator.java,125,0,0.0,0,0,0.0,0,0,0.0,0,0,0.0,0,0,0,0,NO
15,src/java/main/org/apache/jute/compiler/JBoolean.java,50,0,0.0,0,0,0.0,0,0,0.0,0,0,0.0,0,0,0,0,NO
15,src/java/main/org/apache/jute/compiler/JBuffer.java,106,0,0.0,0,0,0.0,0,0,0.0,0,0,0.0,0,0,0,0,NO
15,src/java/main/org/apache/jute/compiler/JByte.java,34,0,0.0,0,0,0.0,0,0,0.0,0,0,0.0,0,0,0,0,NO
15,src/java/main/org/apache/jute/compiler/JCompType.java,66,0,0.0,0,0,0.0,0,0,0.0,0,0,0.0,0,0,0,0,NO
15,src/java/main/org/apache/jute/compiler/JDouble.java,40,0,0.0,0,0,0.0,0,0,0.0,0,0,0.0,0,0,0,0,NO
15,src/java/main/org/apache/jute/compiler/JField.java,140,0,0.0,0,0,0.0,0,0,0.0,0,0,0.0,0,0,0,0,NO
15,src/java/main/org/apache/jute/compiler/JFile.java,84,0,0.0,0,0,0.0,0,0,0.0,0,0,0.0,0,0,0,0,NO
15,src/java/main/org/apache/jute/compiler/JFloat.java,39,0,0.0,0,0,0.0,0,0,0.0,0,0,0.0,0,0,0,0,NO
15,src/java/main/org/apache/jute/compiler/JInt.java,34,0,0.0,0,0,0.0,0,0,0.0,0,0,0.0,0,0,0,0,NO
15,src/java/main/org/apache/jute/compiler/JLong.java,38,0,0.0,0,0,0.0,0,0,0.0,0,0,0.0,0,0,0,0,NO
15,src/java/main/org/apache/jute/compiler/JMap.java,149,0,0.0,0,0,0.0,0,0,0.0,0,0,0.0,0,0,0,0,NO
15,src/java/main/org/apache/jute/compiler/JRecord.java,761,0,0.0,0,0,0.0,0,0,0.0,0,0,0.0,0,0,0,0,YES
15,src/java/main/org/apache/jute/compiler/JString.java,46,0,0.0,0,0,0.0,0,0,0.0,0,0,0.0,0,0,0,0,NO
15,src/java/main/org/apache/jute/compiler/JType.java,204,0,0.0,0,0,0.0,0,0,0.0,0,0,0.0,0,0,0,0,NO
15,src/java/main/org/apache/jute/compiler/JVector.java,153,0,0.0,0,0,0.0,0,0,0.0,0,0,0.0,0,0,0,0,NO
15,src/java/main/org/apache/jute/compiler/JavaGenerator.java,57,0,0.0,0,0,0.0,0,0,0.0,0,0,0.0,0,0,0,0,NO
15,src/java/main/org/apache/zookeeper/AsyncCallback.java,57,0,0.0,0,0,0.0,0,0,0.0,0,0,0.0,0,0,0,0,NO
15,src/java/main/org/apache/zookeeper/ClientCnxn.java,1301,10,10.0,10,16,16.0,16,26,26.0,26,6,6.0,6,1,1,1,YES
15,src/java/main/org/apache/zookeeper/ClientCnxnSocket.java,170,0,0.0,0,0,0.0,0,0,0.0,0,0,0.0,0,0,0,0,YES
15,src/java/main/org/apache/zookeeper/ClientCnxnSocketNIO.java,339,0,0.0,0,0,0.0,0,0,0.0,0,0,0.0,0,0,0,0,YES
15,src/java/main/org/apache/zookeeper/ClientWatchManager.java,40,0,0.0,0,0,0.0,0,0,0.0,0,0,0.0,0,0,0,0,NO
15,src/java/main/org/apache/zookeeper/CreateMode.java,90,0,0.0,0,0,0.0,0,0,0.0,0,0,0.0,0,0,0,0,YES
15,src/java/main/org/apache/zookeeper/Environment.java,100,0,0.0,0,0,0.0,0,0,0.0,0,0,0.0,0,0,0,0,NO
15,src/java/main/org/apache/zookeeper/JLineZNodeCompletor.java,84,0,0.0,0,0,0.0,0,0,0.0,0,0,0.0,0,0,0,0,NO
15,src/java/main/org/apache/zookeeper/KeeperException.java,702,3,3.0,3,0,0.0,0,3,3.0,3,3,3.0,3,1,1,1,NO
15,src/java/main/org/apache/zookeeper/Login.java,392,5,5.0,5,2,2.0,2,7,7.0,7,3,3.0,3,1,1,1,NO
15,src/java/main/org/apache/zookeeper/MultiResponse.java,165,0,0.0,0,0,0.0,0,0,0.0,0,0,0.0,0,0,0,0,NO
15,src/java/main/org/apache/zookeeper/MultiTransactionRecord.java,159,0,0.0,0,0,0.0,0,0,0.0,0,0,0.0,0,0,0,0,NO
15,src/java/main/org/apache/zookeeper/Op.java,305,0,0.0,0,0,0.0,0,0,0.0,0,0,0.0,0,0,0,0,YES
15,src/java/main/org/apache/zookeeper/OpResult.java,185,8,8.0,8,8,8.0,8,16,16.0,16,0,0.0,0,1,1,1,NO
15,src/java/main/org/apache/zookeeper/Quotas.java,68,0,0.0,0,0,0.0,0,0,0.0,0,0,0.0,0,0,0,0,NO
15,src/java/main/org/apache/zookeeper/ServerAdminClient.java,277,0,0.0,0,0,0.0,0,0,0.0,0,0,0.0,0,0,0,0,NO
15,src/java/main/org/apache/zookeeper/Shell.java,476,0,0.0,0,0,0.0,0,0,0.0,0,0,0.0,0,0,0,0,NO
15,src/java/main/org/apache/zookeeper/StatsTrack.java,101,0,0.0,0,0,0.0,0,0,0.0,0,0,0.0,0,0,0,0,NO
15,src/java/main/org/apache/zookeeper/Transaction.java,63,3,3.0,3,0,0.0,0,3,3.0,3,3,3.0,3,1,1,1,YES
15,src/java/main/org/apache/zookeeper/Version.java,79,0,0.0,0,0,0.0,0,0,0.0,0,0,0.0,0,0,0,0,NO
15,src/java/main/org/apache/zookeeper/WatchedEvent.java,79,0,0.0,0,0,0.0,0,0,0.0,0,0,0.0,0,0,0,0,NO
15,src/java/main/org/apache/zookeeper/Watcher.java,149,0,0.0,0,0,0.0,0,0,0.0,0,0,0.0,0,0,0,0,NO
15,src/java/main/org/apache/zookeeper/ZKUtil.java,124,0,0.0,0,0,0.0,0,0,0.0,0,0,0.0,0,0,0,0,NO
15,src/java/main/org/apache/zookeeper/ZooDefs.java,119,0,0.0,0,0,0.0,0,0,0.0,0,0,0.0,0,0,0,0,NO
15,src/java/main/org/apache/zookeeper/ZooKeeper.java,1764,33,33.0,33,15,15.0,15,48,48.0,48,18,18.0,18,1,1,1,YES
15,src/java/main/org/apache/zookeeper/ZooKeeperMain.java,875,0,0.0,0,0,0.0,0,0,0.0,0,0,0.0,0,0,0,0,YES
15,src/java/main/org/apache/zookeeper/client/ConnectStringParser.java,87,0,0.0,0,0,0.0,0,0,0.0,0,0,0.0,0,0,0,0,NO
15,src/java/main/org/apache/zookeeper/client/FourLetterWordMain.java,79,0,0.0,0,0,0.0,0,0,0.0,0,0,0.0,0,0,0,0,NO
15,src/java/main/org/apache/zookeeper/client/HostProvider.java,61,0,0.0,0,0,0.0,0,0,0.0,0,0,0.0,0,0,0,0,NO
15,src/java/main/org/apache/zookeeper/client/StaticHostProvider.java,101,0,0.0,0,0,0.0,0,0,0.0,0,0,0.0,0,0,0,0,NO
15,src/java/main/org/apache/zookeeper/client/ZooKeeperSaslClient.java,435,99,99.0,99,19,19.0,19,118,118.0,118,80,80.0,80,1,1,1,YES
15,src/java/main/org/apache/zookeeper/common/PathTrie.java,284,0,0.0,0,0,0.0,0,0,0.0,0,0,0.0,0,0,0,0,NO
15,src/java/main/org/apache/zookeeper/common/PathUtils.java,103,0,0.0,0,0,0.0,0,0,0.0,0,0,0.0,0,0,0,0,NO
15,src/java/main/org/apache/zookeeper/jmx/CommonNames.java,29,0,0.0,0,0,0.0,0,0,0.0,0,0,0.0,0,0,0,0,NO
15,src/java/main/org/apache/zookeeper/jmx/MBeanRegistry.java,215,0,0.0,0,0,0.0,0,0,0.0,0,0,0.0,0,0,0,0,NO
15,src/java/main/org/apache/zookeeper/jmx/ManagedUtil.java,71,0,0.0,0,0,0.0,0,0,0.0,0,0,0.0,0,0,0,0,NO
15,src/java/main/org/apache/zookeeper/jmx/ZKMBeanInfo.java,36,0,0.0,0,0,0.0,0,0,0.0,0,0,0.0,0,0,0,0,NO
15,src/java/main/org/apache/zookeeper/server/ByteBufferInputStream.java,82,0,0.0,0,0,0.0,0,0,0.0,0,0,0.0,0,0,0,0,NO
15,src/java/main/org/apache/zookeeper/server/ByteBufferOutputStream.java,51,0,0.0,0,0,0.0,0,0,0.0,0,0,0.0,0,0,0,0,NO
15,src/java/main/org/apache/zookeeper/server/ConnectionBean.java,173,0,0.0,0,0,0.0,0,0,0.0,0,0,0.0,0,0,0,0,NO
15,src/java/main/org/apache/zookeeper/server/ConnectionMXBean.java,98,0,0.0,0,0,0.0,0,0,0.0,0,0,0.0,0,0,0,0,NO
15,src/java/main/org/apache/zookeeper/server/DataNode.java,174,0,0.0,0,0,0.0,0,0,0.0,0,0,0.0,0,0,0,0,NO
15,src/java/main/org/apache/zookeeper/server/DataTree.java,1311,3,3.0,3,3,3.0,3,6,6.0,6,0,0.0,0,1,1,1,NO
15,src/java/main/org/apache/zookeeper/server/DataTreeBean.java,61,0,0.0,0,0,0.0,0,0,0.0,0,0,0.0,0,0,0,0,NO
15,src/java/main/org/apache/zookeeper/server/DataTreeMXBean.java,47,0,0.0,0,0,0.0,0,0,0.0,0,0,0.0,0,0,0,0,NO
15,src/java/main/org/apache/zookeeper/server/DatadirCleanupManager.java,192,0,0.0,0,0,0.0,0,0,0.0,0,0,0.0,0,0,0,0,NO
15,src/java/main/org/apache/zookeeper/server/FinalRequestProcessor.java,413,5,5.0,5,14,14.0,14,19,19.0,19,9,9.0,9,1,1,1,YES
15,src/java/main/org/apache/zookeeper/server/LogFormatter.java,104,0,0.0,0,0,0.0,0,0,0.0,0,0,0.0,0,0,0,0,NO
15,src/java/main/org/apache/zookeeper/server/NIOServerCnxn.java,1157,2,2.0,2,1,1.0,1,3,3.0,3,1,1.0,1,1,0,1,YES
15,src/java/main/org/apache/zookeeper/server/NIOServerCnxnFactory.java,323,3,3.0,3,6,6.0,6,9,9.0,9,3,3.0,3,1,0,1,NO
15,src/java/main/org/apache/zookeeper/server/NettyServerCnxn.java,852,1,1.0,1,0,0.0,0,1,1.0,1,1,1.0,1,1,0,1,YES
15,src/java/main/org/apache/zookeeper/server/NettyServerCnxnFactory.java,414,0,0.0,0,1,1.0,1,1,1.0,1,1,1.0,1,1,0,1,NO
15,src/java/main/org/apache/zookeeper/server/ObserverBean.java,45,0,0.0,0,0,0.0,0,0,0.0,0,0,0.0,0,0,0,0,NO
15,src/java/main/org/apache/zookeeper/server/PrepRequestProcessor.java,717,4,4.0,4,3,3.0,3,7,7.0,7,1,1.0,1,1,1,1,YES
15,src/java/main/org/apache/zookeeper/server/PurgeTxnLog.java,129,0,0.0,0,0,0.0,0,0,0.0,0,0,0.0,0,0,0,0,NO
15,src/java/main/org/apache/zookeeper/server/Request.java,256,0,0.0,0,0,0.0,0,0,0.0,0,0,0.0,0,0,0,0,NO
15,src/java/main/org/apache/zookeeper/server/RequestProcessor.java,37,0,0.0,0,0,0.0,0,0,0.0,0,0,0.0,0,0,0,0,YES
15,src/java/main/org/apache/zookeeper/server/ServerCnxn.java,452,0,0.0,0,0,0.0,0,0,0.0,0,0,0.0,0,0,0,0,NO
15,src/java/main/org/apache/zookeeper/server/ServerCnxnFactory.java,149,14,14.0,14,4,4.0,4,18,18.0,18,10,10.0,10,1,0,1,NO
15,src/java/main/org/apache/zookeeper/server/ServerConfig.java,112,0,0.0,0,0,0.0,0,0,0.0,0,0,0.0,0,0,0,0,NO
15,src/java/main/org/apache/zookeeper/server/ServerStats.java,140,9,9.0,9,1,1.0,1,10,10.0,10,8,8.0,8,1,0,1,NO
15,src/java/main/org/apache/zookeeper/server/SessionTracker.java,81,0,0.0,0,0,0.0,0,0,0.0,0,0,0.0,0,0,0,0,NO
15,src/java/main/org/apache/zookeeper/server/SessionTrackerImpl.java,274,0,0.0,0,0,0.0,0,0,0.0,0,0,0.0,0,0,0,0,YES
15,src/java/main/org/apache/zookeeper/server/Stats.java,68,0,0.0,0,0,0.0,0,0,0.0,0,0,0.0,0,0,0,0,NO
15,src/java/main/org/apache/zookeeper/server/SyncRequestProcessor.java,190,0,0.0,0,0,0.0,0,0,0.0,0,0,0.0,0,0,0,0,YES
15,src/java/main/org/apache/zookeeper/server/TraceFormatter.java,123,0,0.0,0,0,0.0,0,0,0.0,0,0,0.0,0,0,0,0,NO
15,src/java/main/org/apache/zookeeper/server/WatchManager.java,171,0,0.0,0,0,0.0,0,0,0.0,0,0,0.0,0,0,0,0,NO
15,src/java/main/org/apache/zookeeper/server/ZKDatabase.java,483,0,0.0,0,0,0.0,0,0,0.0,0,0,0.0,0,0,0,0,YES
15,src/java/main/org/apache/zookeeper/server/ZooKeeperSaslServer.java,127,0,0.0,0,0,0.0,0,0,0.0,0,0,0.0,0,0,0,0,NO
15,src/java/main/org/apache/zookeeper/server/ZooKeeperServer.java,958,42,21.0,42,5,2.5,5,47,23.5,47,37,18.5,37,2,1,2,YES
15,src/java/main/org/apache/zookeeper/server/ZooKeeperServerBean.java,147,4,4.0,4,0,0.0,0,4,4.0,4,4,4.0,4,1,0,1,NO
15,src/java/main/org/apache/zookeeper/server/ZooKeeperServerMXBean.java,110,4,4.0,4,0,0.0,0,4,4.0,4,4,4.0,4,1,0,1,NO
15,src/java/main/org/apache/zookeeper/server/ZooKeeperServerMain.java,123,0,0.0,0,0,0.0,0,0,0.0,0,0,0.0,0,0,0,0,NO
15,src/java/main/org/apache/zookeeper/server/ZooTrace.java,93,0,0.0,0,0,0.0,0,0,0.0,0,0,0.0,0,0,0,0,NO
15,src/java/main/org/apache/zookeeper/server/auth/AuthenticationProvider.java,82,0,0.0,0,0,0.0,0,0,0.0,0,0,0.0,0,0,0,0,NO
15,src/java/main/org/apache/zookeeper/server/auth/DigestAuthenticationProvider.java,139,0,0.0,0,0,0.0,0,0,0.0,0,0,0.0,0,0,0,0,NO
15,src/java/main/org/apache/zookeeper/server/auth/DigestLoginModule.java,59,0,0.0,0,0,0.0,0,0,0.0,0,0,0.0,0,0,0,0,NO
15,src/java/main/org/apache/zookeeper/server/auth/IPAuthenticationProvider.java,117,0,0.0,0,0,0.0,0,0,0.0,0,0,0.0,0,0,0,0,NO
15,src/java/main/org/apache/zookeeper/server/auth/KerberosName.java,418,1,1.0,1,1,1.0,1,2,2.0,2,0,0.0,0,1,1,1,NO
15,src/java/main/org/apache/zookeeper/server/auth/ProviderRegistry.java,77,0,0.0,0,0,0.0,0,0,0.0,0,0,0.0,0,0,0,0,NO
15,src/java/main/org/apache/zookeeper/server/auth/SASLAuthenticationProvider.java,70,0,0.0,0,0,0.0,0,0,0.0,0,0,0.0,0,0,0,0,NO
15,src/java/main/org/apache/zookeeper/server/auth/SaslServerCallbackHandler.java,148,0,0.0,0,0,0.0,0,0,0.0,0,0,0.0,0,0,0,0,NO
15,src/java/main/org/apache/zookeeper/server/persistence/FileSnap.java,250,0,0.0,0,0,0.0,0,0,0.0,0,0,0.0,0,0,0,0,NO
15,src/java/main/org/apache/zookeeper/server/persistence/FileTxnLog.java,661,6,6.0,6,5,5.0,5,11,11.0,11,1,1.0,1,1,0,1,NO
15,src/java/main/org/apache/zookeeper/server/persistence/FileTxnSnapLog.java,325,7,7.0,7,7,7.0,7,14,14.0,14,0,0.0,0,1,0,1,YES
15,src/java/main/org/apache/zookeeper/server/persistence/SnapShot.java,66,0,0.0,0,0,0.0,0,0,0.0,0,0,0.0,0,0,0,0,NO
15,src/java/main/org/apache/zookeeper/server/persistence/TxnLog.java,120,0,0.0,0,0,0.0,0,0,0.0,0,0,0.0,0,0,0,0,NO
15,src/java/main/org/apache/zookeeper/server/persistence/Util.java,326,0,0.0,0,0,0.0,0,0,0.0,0,0,0.0,0,0,0,0,NO
15,src/java/main/org/apache/zookeeper/server/quorum/AckRequestProcessor.java,54,0,0.0,0,0,0.0,0,0,0.0,0,0,0.0,0,0,0,0,NO
15,src/java/main/org/apache/zookeeper/server/quorum/AuthFastLeaderElection.java,972,0,0.0,0,0,0.0,0,0,0.0,0,0,0.0,0,0,0,0,NO
15,src/java/main/org/apache/zookeeper/server/quorum/CommitProcessor.java,185,0,0.0,0,0,0.0,0,0,0.0,0,0,0.0,0,0,0,0,NO
15,src/java/main/org/apache/zookeeper/server/quorum/Election.java,27,0,0.0,0,0,0.0,0,0,0.0,0,0,0.0,0,0,0,0,NO
15,src/java/main/org/apache/zookeeper/server/quorum/FastLeaderElection.java,893,33,33.0,33,30,30.0,30,63,63.0,63,3,3.0,3,1,0,1,YES
15,src/java/main/org/apache/zookeeper/server/quorum/Follower.java,167,0,0.0,0,0,0.0,0,0,0.0,0,0,0.0,0,0,0,0,NO
15,src/java/main/org/apache/zookeeper/server/quorum/FollowerBean.java,50,0,0.0,0,0,0.0,0,0,0.0,0,0,0.0,0,0,0,0,NO
15,src/java/main/org/apache/zookeeper/server/quorum/FollowerMXBean.java,41,0,0.0,0,0,0.0,0,0,0.0,0,0,0.0,0,0,0,0,NO
15,src/java/main/org/apache/zookeeper/server/quorum/FollowerRequestProcessor.java,113,0,0.0,0,0,0.0,0,0,0.0,0,0,0.0,0,0,0,0,NO
15,src/java/main/org/apache/zookeeper/server/quorum/FollowerZooKeeperServer.java,160,0,0.0,0,0,0.0,0,0,0.0,0,0,0.0,0,0,0,0,NO
15,src/java/main/org/apache/zookeeper/server/quorum/Leader.java,825,75,15.0,75,77,15.4,77,152,30.4,152,8,1.6,8,5,3,4,YES
15,src/java/main/org/apache/zookeeper/server/quorum/LeaderBean.java,53,0,0.0,0,0,0.0,0,0,0.0,0,0,0.0,0,0,0,0,YES
15,src/java/main/org/apache/zookeeper/server/quorum/LeaderElection.java,293,0,0.0,0,0,0.0,0,0,0.0,0,0,0.0,0,0,0,0,NO
15,src/java/main/org/apache/zookeeper/server/quorum/LeaderElectionBean.java,42,0,0.0,0,0,0.0,0,0,0.0,0,0,0.0,0,0,0,0,NO
15,src/java/main/org/apache/zookeeper/server/quorum/LeaderElectionMXBean.java,31,0,0.0,0,0,0.0,0,0,0.0,0,0,0.0,0,0,0,0,NO
15,src/java/main/org/apache/zookeeper/server/quorum/LeaderMXBean.java,36,0,0.0,0,0,0.0,0,0,0.0,0,0,0.0,0,0,0,0,NO
15,src/java/main/org/apache/zookeeper/server/quorum/LeaderZooKeeperServer.java,177,5,5.0,5,1,1.0,1,6,6.0,6,4,4.0,4,1,1,1,NO
15,src/java/main/org/apache/zookeeper/server/quorum/Learner.java,482,4,4.0,4,3,3.0,3,7,7.0,7,1,1.0,1,1,1,1,YES
15,src/java/main/org/apache/zookeeper/server/quorum/LearnerHandler.java,622,21,21.0,21,10,10.0,10,31,31.0,31,11,11.0,11,1,0,1,YES
15,src/java/main/org/apache/zookeeper/server/quorum/LearnerSessionTracker.java,96,0,0.0,0,0,0.0,0,0,0.0,0,0,0.0,0,0,0,0,NO
15,src/java/main/org/apache/zookeeper/server/quorum/LearnerSyncRequest.java,34,0,0.0,0,0,0.0,0,0,0.0,0,0,0.0,0,0,0,0,NO
15,src/java/main/org/apache/zookeeper/server/quorum/LearnerZooKeeperServer.java,144,4,4.0,4,1,1.0,1,5,5.0,5,3,3.0,3,1,1,1,NO
15,src/java/main/org/apache/zookeeper/server/quorum/LocalPeerBean.java,79,0,0.0,0,0,0.0,0,0,0.0,0,0,0.0,0,0,0,0,NO
15,src/java/main/org/apache/zookeeper/server/quorum/LocalPeerMXBean.java,77,0,0.0,0,0,0.0,0,0,0.0,0,0,0.0,0,0,0,0,NO
15,src/java/main/org/apache/zookeeper/server/quorum/Observer.java,134,0,0.0,0,0,0.0,0,0,0.0,0,0,0.0,0,0,0,0,NO
15,src/java/main/org/apache/zookeeper/server/quorum/ObserverMXBean.java,37,0,0.0,0,0,0.0,0,0,0.0,0,0,0.0,0,0,0,0,NO
15,src/java/main/org/apache/zookeeper/server/quorum/ObserverRequestProcessor.java,127,0,0.0,0,0,0.0,0,0,0.0,0,0,0.0,0,0,0,0,NO
15,src/java/main/org/apache/zookeeper/server/quorum/ObserverZooKeeperServer.java,115,0,0.0,0,0,0.0,0,0,0.0,0,0,0.0,0,0,0,0,NO
15,src/java/main/org/apache/zookeeper/server/quorum/ProposalRequestProcessor.java,88,0,0.0,0,0,0.0,0,0,0.0,0,0,0.0,0,0,0,0,YES
15,src/java/main/org/apache/zookeeper/server/quorum/QuorumBean.java,44,0,0.0,0,0,0.0,0,0,0.0,0,0,0.0,0,0,0,0,NO
15,src/java/main/org/apache/zookeeper/server/quorum/QuorumCnxManager.java,884,0,0.0,0,0,0.0,0,0,0.0,0,0,0.0,0,0,0,0,YES
15,src/java/main/org/apache/zookeeper/server/quorum/QuorumMXBean.java,34,0,0.0,0,0,0.0,0,0,0.0,0,0,0.0,0,0,0,0,NO
15,src/java/main/org/apache/zookeeper/server/quorum/QuorumPeer.java,1127,18,18.0,18,14,14.0,14,32,32.0,32,4,4.0,4,1,0,1,YES
15,src/java/main/org/apache/zookeeper/server/quorum/QuorumPeerConfig.java,411,0,0.0,0,0,0.0,0,0,0.0,0,0,0.0,0,0,0,0,NO
15,src/java/main/org/apache/zookeeper/server/quorum/QuorumPeerMain.java,157,0,0.0,0,0,0.0,0,0,0.0,0,0,0.0,0,0,0,0,NO
15,src/java/main/org/apache/zookeeper/server/quorum/QuorumStats.java,68,0,0.0,0,0,0.0,0,0,0.0,0,0,0.0,0,0,0,0,NO
15,src/java/main/org/apache/zookeeper/server/quorum/QuorumZooKeeperServer.java,59,0,0.0,0,0,0.0,0,0,0.0,0,0,0.0,0,0,0,0,NO
15,src/java/main/org/apache/zookeeper/server/quorum/ReadOnlyBean.java,38,0,0.0,0,0,0.0,0,0,0.0,0,0,0.0,0,0,0,0,NO
15,src/java/main/org/apache/zookeeper/server/quorum/ReadOnlyRequestProcessor.java,120,0,0.0,0,0,0.0,0,0,0.0,0,0,0.0,0,0,0,0,YES
15,src/java/main/org/apache/zookeeper/server/quorum/ReadOnlyZooKeeperServer.java,144,0,0.0,0,0,0.0,0,0,0.0,0,0,0.0,0,0,0,0,NO
15,src/java/main/org/apache/zookeeper/server/quorum/RemotePeerBean.java,45,0,0.0,0,0,0.0,0,0,0.0,0,0,0.0,0,0,0,0,NO
15,src/java/main/org/apache/zookeeper/server/quorum/RemotePeerMXBean.java,33,0,0.0,0,0,0.0,0,0,0.0,0,0,0.0,0,0,0,0,NO
15,src/java/main/org/apache/zookeeper/server/quorum/SendAckRequestProcessor.java,80,0,0.0,0,0,0.0,0,0,0.0,0,0,0.0,0,0,0,0,NO
15,src/java/main/org/apache/zookeeper/server/quorum/ServerBean.java,38,0,0.0,0,0,0.0,0,0,0.0,0,0,0.0,0,0,0,0,NO
15,src/java/main/org/apache/zookeeper/server/quorum/ServerMXBean.java,33,0,0.0,0,0,0.0,0,0,0.0,0,0,0.0,0,0,0,0,NO
15,src/java/main/org/apache/zookeeper/server/quorum/StateSummary.java,57,0,0.0,0,0,0.0,0,0,0.0,0,0,0.0,0,0,0,0,NO
15,src/java/main/org/apache/zookeeper/server/quorum/Vote.java,106,0,0.0,0,0,0.0,0,0,0.0,0,0,0.0,0,0,0,0,NO
15,src/java/main/org/apache/zookeeper/server/quorum/flexible/QuorumHierarchical.java,271,0,0.0,0,0,0.0,0,0,0.0,0,0,0.0,0,0,0,0,NO
15,src/java/main/org/apache/zookeeper/server/quorum/flexible/QuorumMaj.java,57,0,0.0,0,0,0.0,0,0,0.0,0,0,0.0,0,0,0,0,NO
15,src/java/main/org/apache/zookeeper/server/quorum/flexible/QuorumVerifier.java,33,0,0.0,0,0,0.0,0,0,0.0,0,0,0.0,0,0,0,0,NO
15,src/java/main/org/apache/zookeeper/server/util/SerializeUtils.java,141,0,0.0,0,0,0.0,0,0,0.0,0,0,0.0,0,0,0,0,NO
15,src/java/main/org/apache/zookeeper/server/util/VerifyingFileFactory.java,82,0,0.0,0,0,0.0,0,0,0.0,0,0,0.0,0,0,0,0,NO
15,src/java/main/org/apache/zookeeper/server/util/ZxidUtils.java,34,0,0.0,0,0,0.0,0,0,0.0,0,0,0.0,0,0,0,0,NO
15,src/java/main/org/apache/zookeeper/version/util/VerGen.java,177,0,0.0,0,0,0.0,0,0,0.0,0,0,0.0,0,0,0,0,NO
15,src/recipes/election/src/java/org/apache/zookeeper/recipes/leader/LeaderElectionAware.java,37,0,0.0,0,0,0.0,0,0,0.0,0,0,0.0,0,0,0,0,NO
15,src/recipes/election/src/java/org/apache/zookeeper/recipes/leader/LeaderElectionSupport.java,461,0,0.0,0,0,0.0,0,0,0.0,0,0,0.0,0,0,0,0,NO
15,src/recipes/election/src/java/org/apache/zookeeper/recipes/leader/LeaderOffer.java,84,0,0.0,0,0,0.0,0,0,0.0,0,0,0.0,0,0,0,0,NO
15,src/recipes/lock/src/java/org/apache/zookeeper/recipes/lock/LockListener.java,38,0,0.0,0,0,0.0,0,0,0.0,0,0,0.0,0,0,0,0,NO
15,src/recipes/lock/src/java/org/apache/zookeeper/recipes/lock/ProtocolSupport.java,193,0,0.0,0,0,0.0,0,0,0.0,0,0,0.0,0,0,0,0,NO
15,src/recipes/lock/src/java/org/apache/zookeeper/recipes/lock/WriteLock.java,295,0,0.0,0,0,0.0,0,0,0.0,0,0,0.0,0,0,0,0,NO
15,src/recipes/lock/src/java/org/apache/zookeeper/recipes/lock/ZNodeName.java,110,0,0.0,0,0,0.0,0,0,0.0,0,0,0.0,0,0,0,0,NO
15,src/recipes/lock/src/java/org/apache/zookeeper/recipes/lock/ZooKeeperOperation.java,38,0,0.0,0,0,0.0,0,0,0.0,0,0,0.0,0,0,0,0,NO
15,src/recipes/queue/src/java/org/apache/zookeeper/recipes/queue/DistributedQueue.java,313,0,0.0,0,0,0.0,0,0,0.0,0,0,0.0,0,0,0,0,NO
16,src/contrib/fatjar/src/java/org/apache/zookeeper/util/FatJarMain.java,126,0,0.0,0,0,0.0,0,0,0.0,0,0,0.0,0,0,0,0,NO
16,src/contrib/loggraph/src/java/org/apache/zookeeper/graph/FilterException.java,22,0,0.0,0,0,0.0,0,0,0.0,0,0,0.0,0,0,0,0,NO
16,src/contrib/loggraph/src/java/org/apache/zookeeper/graph/FilterOp.java,75,0,0.0,0,0,0.0,0,0,0.0,0,0,0.0,0,0,0,0,NO
16,src/contrib/loggraph/src/java/org/apache/zookeeper/graph/FilterParser.java,131,0,0.0,0,0,0.0,0,0,0.0,0,0,0.0,0,0,0,0,NO
16,src/contrib/loggraph/src/java/org/apache/zookeeper/graph/JsonGenerator.java,223,0,0.0,0,0,0.0,0,0,0.0,0,0,0.0,0,0,0,0,NO
16,src/contrib/loggraph/src/java/org/apache/zookeeper/graph/Log4JEntry.java,40,0,0.0,0,0,0.0,0,0,0.0,0,0,0.0,0,0,0,0,NO
16,src/contrib/loggraph/src/java/org/apache/zookeeper/graph/Log4JSource.java,381,0,0.0,0,0,0.0,0,0,0.0,0,0,0.0,0,0,0,0,NO
16,src/contrib/loggraph/src/java/org/apache/zookeeper/graph/LogEntry.java,46,0,0.0,0,0,0.0,0,0,0.0,0,0,0.0,0,0,0,0,NO
16,src/contrib/loggraph/src/java/org/apache/zookeeper/graph/LogIterator.java,26,0,0.0,0,0,0.0,0,0,0.0,0,0,0.0,0,0,0,0,NO
16,src/contrib/loggraph/src/java/org/apache/zookeeper/graph/LogServer.java,66,0,0.0,0,0,0.0,0,0,0.0,0,0,0.0,0,0,0,0,NO
16,src/contrib/loggraph/src/java/org/apache/zookeeper/graph/LogSkipList.java,95,0,0.0,0,0,0.0,0,0,0.0,0,0,0.0,0,0,0,0,NO
16,src/contrib/loggraph/src/java/org/apache/zookeeper/graph/LogSource.java,33,0,0.0,0,0,0.0,0,0,0.0,0,0,0.0,0,0,0,0,NO
16,src/contrib/loggraph/src/java/org/apache/zookeeper/graph/MeasureThroughput.java,103,0,0.0,0,0,0.0,0,0,0.0,0,0,0.0,0,0,0,0,NO
16,src/contrib/loggraph/src/java/org/apache/zookeeper/graph/MergedLogSource.java,219,0,0.0,0,0,0.0,0,0,0.0,0,0,0.0,0,0,0,0,NO
16,src/contrib/loggraph/src/java/org/apache/zookeeper/graph/RandomAccessFileReader.java,328,0,0.0,0,0,0.0,0,0,0.0,0,0,0.0,0,0,0,0,NO
16,src/contrib/loggraph/src/java/org/apache/zookeeper/graph/TransactionEntry.java,59,0,0.0,0,0,0.0,0,0,0.0,0,0,0.0,0,0,0,0,NO
16,src/contrib/loggraph/src/java/org/apache/zookeeper/graph/TxnLogSource.java,376,0,0.0,0,0,0.0,0,0,0.0,0,0,0.0,0,0,0,0,NO
16,src/contrib/loggraph/src/java/org/apache/zookeeper/graph/filterops/AndOp.java,33,0,0.0,0,0,0.0,0,0,0.0,0,0,0.0,0,0,0,0,NO
16,src/contrib/loggraph/src/java/org/apache/zookeeper/graph/filterops/Arg.java,36,0,0.0,0,0,0.0,0,0,0.0,0,0,0.0,0,0,0,0,NO
16,src/contrib/loggraph/src/java/org/apache/zookeeper/graph/filterops/EqualsOp.java,44,0,0.0,0,0,0.0,0,0,0.0,0,0,0.0,0,0,0,0,NO
16,src/contrib/loggraph/src/java/org/apache/zookeeper/graph/filterops/GreaterThanOp.java,70,0,0.0,0,0,0.0,0,0,0.0,0,0,0.0,0,0,0,0,NO
16,src/contrib/loggraph/src/java/org/apache/zookeeper/graph/filterops/LessThanOp.java,69,0,0.0,0,0,0.0,0,0,0.0,0,0,0.0,0,0,0,0,NO
16,src/contrib/loggraph/src/java/org/apache/zookeeper/graph/filterops/NotOp.java,31,0,0.0,0,0,0.0,0,0,0.0,0,0,0.0,0,0,0,0,NO
16,src/contrib/loggraph/src/java/org/apache/zookeeper/graph/filterops/NumberArg.java,27,0,0.0,0,0,0.0,0,0,0.0,0,0,0.0,0,0,0,0,NO
16,src/contrib/loggraph/src/java/org/apache/zookeeper/graph/filterops/OrOp.java,33,0,0.0,0,0,0.0,0,0,0.0,0,0,0.0,0,0,0,0,NO
16,src/contrib/loggraph/src/java/org/apache/zookeeper/graph/filterops/StringArg.java,27,0,0.0,0,0,0.0,0,0,0.0,0,0,0.0,0,0,0,0,NO
16,src/contrib/loggraph/src/java/org/apache/zookeeper/graph/filterops/SymbolArg.java,27,0,0.0,0,0,0.0,0,0,0.0,0,0,0.0,0,0,0,0,NO
16,src/contrib/loggraph/src/java/org/apache/zookeeper/graph/filterops/XorOp.java,40,0,0.0,0,0,0.0,0,0,0.0,0,0,0.0,0,0,0,0,NO
16,src/contrib/loggraph/src/java/org/apache/zookeeper/graph/servlets/FileLoader.java,60,0,0.0,0,0,0.0,0,0,0.0,0,0,0.0,0,0,0,0,NO
16,src/contrib/loggraph/src/java/org/apache/zookeeper/graph/servlets/Fs.java,69,0,0.0,0,0,0.0,0,0,0.0,0,0,0.0,0,0,0,0,NO
16,src/contrib/loggraph/src/java/org/apache/zookeeper/graph/servlets/GraphData.java,85,0,0.0,0,0,0.0,0,0,0.0,0,0,0.0,0,0,0,0,NO
16,src/contrib/loggraph/src/java/org/apache/zookeeper/graph/servlets/JsonServlet.java,85,0,0.0,0,0,0.0,0,0,0.0,0,0,0.0,0,0,0,0,NO
16,src/contrib/loggraph/src/java/org/apache/zookeeper/graph/servlets/NumEvents.java,86,0,0.0,0,0,0.0,0,0,0.0,0,0,0.0,0,0,0,0,NO
16,src/contrib/loggraph/src/java/org/apache/zookeeper/graph/servlets/StaticContent.java,50,0,0.0,0,0,0.0,0,0,0.0,0,0,0.0,0,0,0,0,NO
16,src/contrib/loggraph/src/java/org/apache/zookeeper/graph/servlets/Throughput.java,125,0,0.0,0,0,0.0,0,0,0.0,0,0,0.0,0,0,0,0,NO
16,src/contrib/rest/src/java/org/apache/zookeeper/server/jersey/RestMain.java,151,0,0.0,0,0,0.0,0,0,0.0,0,0,0.0,0,0,0,0,NO
16,src/contrib/rest/src/java/org/apache/zookeeper/server/jersey/ZooKeeperService.java,242,0,0.0,0,0,0.0,0,0,0.0,0,0,0.0,0,0,0,0,NO
16,src/contrib/rest/src/java/org/apache/zookeeper/server/jersey/cfg/Credentials.java,47,0,0.0,0,0,0.0,0,0,0.0,0,0,0.0,0,0,0,0,NO
16,src/contrib/rest/src/java/org/apache/zookeeper/server/jersey/cfg/Endpoint.java,72,0,0.0,0,0,0.0,0,0,0.0,0,0,0.0,0,0,0,0,NO
16,src/contrib/rest/src/java/org/apache/zookeeper/server/jersey/cfg/HostPort.java,51,0,0.0,0,0,0.0,0,0,0.0,0,0,0.0,0,0,0,0,NO
16,src/contrib/rest/src/java/org/apache/zookeeper/server/jersey/cfg/HostPortSet.java,51,0,0.0,0,0,0.0,0,0,0.0,0,0,0.0,0,0,0,0,NO
16,src/contrib/rest/src/java/org/apache/zookeeper/server/jersey/cfg/RestCfg.java,106,0,0.0,0,0,0.0,0,0,0.0,0,0,0.0,0,0,0,0,NO
16,src/contrib/rest/src/java/org/apache/zookeeper/server/jersey/filters/HTTPBasicAuth.java,87,0,0.0,0,0,0.0,0,0,0.0,0,0,0.0,0,0,0,0,NO
16,src/contrib/rest/src/java/org/apache/zookeeper/server/jersey/jaxb/ZChildren.java,80,0,0.0,0,0,0.0,0,0,0.0,0,0,0.0,0,0,0,0,NO
16,src/contrib/rest/src/java/org/apache/zookeeper/server/jersey/jaxb/ZChildrenJSON.java,76,0,0.0,0,0,0.0,0,0,0.0,0,0,0.0,0,0,0,0,NO
16,src/contrib/rest/src/java/org/apache/zookeeper/server/jersey/jaxb/ZError.java,41,0,0.0,0,0,0.0,0,0,0.0,0,0,0.0,0,0,0,0,NO
16,src/contrib/rest/src/java/org/apache/zookeeper/server/jersey/jaxb/ZPath.java,63,0,0.0,0,0,0.0,0,0,0.0,0,0,0.0,0,0,0,0,NO
16,src/contrib/rest/src/java/org/apache/zookeeper/server/jersey/jaxb/ZSession.java,55,0,0.0,0,0,0.0,0,0,0.0,0,0,0.0,0,0,0,0,NO
16,src/contrib/rest/src/java/org/apache/zookeeper/server/jersey/jaxb/ZStat.java,106,0,0.0,0,0,0.0,0,0,0.0,0,0,0.0,0,0,0,0,NO
16,src/contrib/rest/src/java/org/apache/zookeeper/server/jersey/resources/JAXBContextResolver.java,72,0,0.0,0,0,0.0,0,0,0.0,0,0,0.0,0,0,0,0,NO
16,src/contrib/rest/src/java/org/apache/zookeeper/server/jersey/resources/KeeperExceptionMapper.java,86,0,0.0,0,0,0.0,0,0,0.0,0,0,0.0,0,0,0,0,NO
16,src/contrib/rest/src/java/org/apache/zookeeper/server/jersey/resources/RuntimeExceptionMapper.java,55,0,0.0,0,0,0.0,0,0,0.0,0,0,0.0,0,0,0,0,NO
16,src/contrib/rest/src/java/org/apache/zookeeper/server/jersey/resources/SessionsResource.java,135,0,0.0,0,0,0.0,0,0,0.0,0,0,0.0,0,0,0,0,NO
16,src/contrib/rest/src/java/org/apache/zookeeper/server/jersey/resources/ZErrorWriter.java,63,0,0.0,0,0,0.0,0,0,0.0,0,0,0.0,0,0,0,0,NO
16,src/contrib/rest/src/java/org/apache/zookeeper/server/jersey/resources/ZNodeResource.java,412,0,0.0,0,0,0.0,0,0,0.0,0,0,0.0,0,0,0,0,NO
16,src/contrib/zooinspector/src/java/com/nitido/utils/toaster/Toaster.java,533,0,0.0,0,0,0.0,0,0,0.0,0,0,0.0,0,0,0,0,NO
16,src/contrib/zooinspector/src/java/org/apache/zookeeper/inspector/ZooInspector.java,67,0,0.0,0,0,0.0,0,0,0.0,0,0,0.0,0,0,0,0,NO
16,src/contrib/zooinspector/src/java/org/apache/zookeeper/inspector/encryption/BasicDataEncryptionManager.java,50,0,0.0,0,0,0.0,0,0,0.0,0,0,0.0,0,0,0,0,NO
16,src/contrib/zooinspector/src/java/org/apache/zookeeper/inspector/encryption/DataEncryptionManager.java,39,0,0.0,0,0,0.0,0,0,0.0,0,0,0.0,0,0,0,0,NO
16,src/contrib/zooinspector/src/java/org/apache/zookeeper/inspector/gui/IconResource.java,88,0,0.0,0,0,0.0,0,0,0.0,0,0,0.0,0,0,0,0,NO
16,src/contrib/zooinspector/src/java/org/apache/zookeeper/inspector/gui/NodeViewersChangeListener.java,37,0,0.0,0,0,0.0,0,0,0.0,0,0,0.0,0,0,0,0,NO
16,src/contrib/zooinspector/src/java/org/apache/zookeeper/inspector/gui/Toolbar.java,74,0,0.0,0,0,0.0,0,0,0.0,0,0,0.0,0,0,0,0,NO
16,src/contrib/zooinspector/src/java/org/apache/zookeeper/inspector/gui/ZooInspectorAboutDialog.java,79,0,0.0,0,0,0.0,0,0,0.0,0,0,0.0,0,0,0,0,NO
16,src/contrib/zooinspector/src/java/org/apache/zookeeper/inspector/gui/ZooInspectorConnectionPropertiesDialog.java,321,0,0.0,0,0,0.0,0,0,0.0,0,0,0.0,0,0,0,0,NO
16,src/contrib/zooinspector/src/java/org/apache/zookeeper/inspector/gui/ZooInspectorNodeViewersDialog.java,631,0,0.0,0,0,0.0,0,0,0.0,0,0,0.0,0,0,0,0,NO
16,src/contrib/zooinspector/src/java/org/apache/zookeeper/inspector/gui/ZooInspectorNodeViewersPanel.java,140,0,0.0,0,0,0.0,0,0,0.0,0,0,0.0,0,0,0,0,NO
16,src/contrib/zooinspector/src/java/org/apache/zookeeper/inspector/gui/ZooInspectorPanel.java,318,0,0.0,0,0,0.0,0,0,0.0,0,0,0.0,0,0,0,0,NO
16,src/contrib/zooinspector/src/java/org/apache/zookeeper/inspector/gui/ZooInspectorTreeViewer.java,356,0,0.0,0,0,0.0,0,0,0.0,0,0,0.0,0,0,0,0,NO
16,src/contrib/zooinspector/src/java/org/apache/zookeeper/inspector/gui/nodeviewer/NodeViewerACL.java,187,0,0.0,0,0,0.0,0,0,0.0,0,0,0.0,0,0,0,0,NO
16,src/contrib/zooinspector/src/java/org/apache/zookeeper/inspector/gui/nodeviewer/NodeViewerData.java,142,0,0.0,0,0,0.0,0,0,0.0,0,0,0.0,0,0,0,0,NO
16,src/contrib/zooinspector/src/java/org/apache/zookeeper/inspector/gui/nodeviewer/NodeViewerMetaData.java,186,0,0.0,0,0,0.0,0,0,0.0,0,0,0.0,0,0,0,0,NO
16,src/contrib/zooinspector/src/java/org/apache/zookeeper/inspector/gui/nodeviewer/ZooInspectorNodeViewer.java,138,0,0.0,0,0,0.0,0,0,0.0,0,0,0.0,0,0,0,0,NO
16,src/contrib/zooinspector/src/java/org/apache/zookeeper/inspector/logger/LoggerFactory.java,36,0,0.0,0,0,0.0,0,0,0.0,0,0,0.0,0,0,0,0,NO
16,src/contrib/zooinspector/src/java/org/apache/zookeeper/inspector/manager/NodeListener.java,37,0,0.0,0,0,0.0,0,0,0.0,0,0,0.0,0,0,0,0,NO
16,src/contrib/zooinspector/src/java/org/apache/zookeeper/inspector/manager/Pair.java,120,0,0.0,0,0,0.0,0,0,0.0,0,0,0.0,0,0,0,0,NO
16,src/contrib/zooinspector/src/java/org/apache/zookeeper/inspector/manager/ZooInspectorManager.java,139,0,0.0,0,0,0.0,0,0,0.0,0,0,0.0,0,0,0,0,NO
16,src/contrib/zooinspector/src/java/org/apache/zookeeper/inspector/manager/ZooInspectorManagerImpl.java,852,0,0.0,0,0,0.0,0,0,0.0,0,0,0.0,0,0,0,0,NO
16,src/contrib/zooinspector/src/java/org/apache/zookeeper/inspector/manager/ZooInspectorNodeManager.java,33,0,0.0,0,0,0.0,0,0,0.0,0,0,0.0,0,0,0,0,NO
16,src/contrib/zooinspector/src/java/org/apache/zookeeper/inspector/manager/ZooInspectorNodeTreeManager.java,43,0,0.0,0,0,0.0,0,0,0.0,0,0,0.0,0,0,0,0,NO
16,src/contrib/zooinspector/src/java/org/apache/zookeeper/inspector/manager/ZooInspectorReadOnlyManager.java,99,0,0.0,0,0,0.0,0,0,0.0,0,0,0.0,0,0,0,0,NO
16,src/contrib/zooinspector/src/java/org/apache/zookeeper/retry/ZooKeeperRetry.java,288,0,0.0,0,0,0.0,0,0,0.0,0,0,0.0,0,0,0,0,NO
16,src/java/main/org/apache/jute/BinaryInputArchive.java,131,0,0.0,0,0,0.0,0,0,0.0,0,0,0.0,0,0,0,0,YES
16,src/java/main/org/apache/jute/BinaryOutputArchive.java,146,0,0.0,0,0,0.0,0,0,0.0,0,0,0.0,0,0,0,0,NO
16,src/java/main/org/apache/jute/CsvInputArchive.java,204,0,0.0,0,0,0.0,0,0,0.0,0,0,0.0,0,0,0,0,NO
16,src/java/main/org/apache/jute/CsvOutputArchive.java,150,0,0.0,0,0,0.0,0,0,0.0,0,0,0.0,0,0,0,0,NO
16,src/java/main/org/apache/jute/Index.java,38,0,0.0,0,0,0.0,0,0,0.0,0,0,0.0,0,0,0,0,NO
16,src/java/main/org/apache/jute/InputArchive.java,43,0,0.0,0,0,0.0,0,0,0.0,0,0,0.0,0,0,0,0,NO
16,src/java/main/org/apache/jute/OutputArchive.java,47,0,0.0,0,0,0.0,0,0,0.0,0,0,0.0,0,0,0,0,NO
16,src/java/main/org/apache/jute/Record.java,32,0,0.0,0,0,0.0,0,0,0.0,0,0,0.0,0,0,0,0,NO
16,src/java/main/org/apache/jute/RecordReader.java,93,0,0.0,0,0,0.0,0,0,0.0,0,0,0.0,0,0,0,0,NO
16,src/java/main/org/apache/jute/RecordWriter.java,93,0,0.0,0,0,0.0,0,0,0.0,0,0,0.0,0,0,0,0,NO
16,src/java/main/org/apache/jute/Utils.java,282,0,0.0,0,0,0.0,0,0,0.0,0,0,0.0,0,0,0,0,NO
16,src/java/main/org/apache/jute/XmlInputArchive.java,251,0,0.0,0,0,0.0,0,0,0.0,0,0,0.0,0,0,0,0,NO
16,src/java/main/org/apache/jute/XmlOutputArchive.java,251,0,0.0,0,0,0.0,0,0,0.0,0,0,0.0,0,0,0,0,NO
16,src/java/main/org/apache/jute/compiler/CGenerator.java,130,0,0.0,0,0,0.0,0,0,0.0,0,0,0.0,0,0,0,0,NO
16,src/java/main/org/apache/jute/compiler/CSharpGenerator.java,53,0,0.0,0,0,0.0,0,0,0.0,0,0,0.0,0,0,0,0,NO
16,src/java/main/org/apache/jute/compiler/CppGenerator.java,125,0,0.0,0,0,0.0,0,0,0.0,0,0,0.0,0,0,0,0,NO
16,src/java/main/org/apache/jute/compiler/JBoolean.java,50,0,0.0,0,0,0.0,0,0,0.0,0,0,0.0,0,0,0,0,NO
16,src/java/main/org/apache/jute/compiler/JBuffer.java,106,0,0.0,0,0,0.0,0,0,0.0,0,0,0.0,0,0,0,0,NO
16,src/java/main/org/apache/jute/compiler/JByte.java,34,0,0.0,0,0,0.0,0,0,0.0,0,0,0.0,0,0,0,0,NO
16,src/java/main/org/apache/jute/compiler/JCompType.java,66,0,0.0,0,0,0.0,0,0,0.0,0,0,0.0,0,0,0,0,NO
16,src/java/main/org/apache/jute/compiler/JDouble.java,40,0,0.0,0,0,0.0,0,0,0.0,0,0,0.0,0,0,0,0,NO
16,src/java/main/org/apache/jute/compiler/JField.java,140,0,0.0,0,0,0.0,0,0,0.0,0,0,0.0,0,0,0,0,NO
16,src/java/main/org/apache/jute/compiler/JFile.java,84,0,0.0,0,0,0.0,0,0,0.0,0,0,0.0,0,0,0,0,NO
16,src/java/main/org/apache/jute/compiler/JFloat.java,39,0,0.0,0,0,0.0,0,0,0.0,0,0,0.0,0,0,0,0,NO
16,src/java/main/org/apache/jute/compiler/JInt.java,34,0,0.0,0,0,0.0,0,0,0.0,0,0,0.0,0,0,0,0,NO
16,src/java/main/org/apache/jute/compiler/JLong.java,38,0,0.0,0,0,0.0,0,0,0.0,0,0,0.0,0,0,0,0,NO
16,src/java/main/org/apache/jute/compiler/JMap.java,149,0,0.0,0,0,0.0,0,0,0.0,0,0,0.0,0,0,0,0,NO
16,src/java/main/org/apache/jute/compiler/JRecord.java,761,0,0.0,0,0,0.0,0,0,0.0,0,0,0.0,0,0,0,0,YES
16,src/java/main/org/apache/jute/compiler/JString.java,46,0,0.0,0,0,0.0,0,0,0.0,0,0,0.0,0,0,0,0,NO
16,src/java/main/org/apache/jute/compiler/JType.java,204,0,0.0,0,0,0.0,0,0,0.0,0,0,0.0,0,0,0,0,NO
16,src/java/main/org/apache/jute/compiler/JVector.java,153,0,0.0,0,0,0.0,0,0,0.0,0,0,0.0,0,0,0,0,NO
16,src/java/main/org/apache/jute/compiler/JavaGenerator.java,57,0,0.0,0,0,0.0,0,0,0.0,0,0,0.0,0,0,0,0,NO
16,src/java/main/org/apache/zookeeper/AsyncCallback.java,57,0,0.0,0,0,0.0,0,0,0.0,0,0,0.0,0,0,0,0,NO
16,src/java/main/org/apache/zookeeper/ClientCnxn.java,1305,4,4.0,4,0,0.0,0,4,4.0,4,4,4.0,4,1,1,1,YES
16,src/java/main/org/apache/zookeeper/ClientCnxnSocket.java,170,0,0.0,0,0,0.0,0,0,0.0,0,0,0.0,0,0,0,0,YES
16,src/java/main/org/apache/zookeeper/ClientCnxnSocketNIO.java,339,0,0.0,0,0,0.0,0,0,0.0,0,0,0.0,0,0,0,0,YES
16,src/java/main/org/apache/zookeeper/ClientWatchManager.java,40,0,0.0,0,0,0.0,0,0,0.0,0,0,0.0,0,0,0,0,NO
16,src/java/main/org/apache/zookeeper/CreateMode.java,90,0,0.0,0,0,0.0,0,0,0.0,0,0,0.0,0,0,0,0,YES
16,src/java/main/org/apache/zookeeper/Environment.java,100,0,0.0,0,0,0.0,0,0,0.0,0,0,0.0,0,0,0,0,NO
16,src/java/main/org/apache/zookeeper/JLineZNodeCompletor.java,84,0,0.0,0,0,0.0,0,0,0.0,0,0,0.0,0,0,0,0,NO
16,src/java/main/org/apache/zookeeper/KeeperException.java,702,0,0.0,0,0,0.0,0,0,0.0,0,0,0.0,0,0,0,0,NO
16,src/java/main/org/apache/zookeeper/Login.java,392,0,0.0,0,0,0.0,0,0,0.0,0,0,0.0,0,0,0,0,NO
16,src/java/main/org/apache/zookeeper/MultiResponse.java,165,0,0.0,0,0,0.0,0,0,0.0,0,0,0.0,0,0,0,0,NO
16,src/java/main/org/apache/zookeeper/MultiTransactionRecord.java,159,0,0.0,0,0,0.0,0,0,0.0,0,0,0.0,0,0,0,0,NO
16,src/java/main/org/apache/zookeeper/Op.java,332,27,27.0,27,0,0.0,0,27,27.0,27,27,27.0,27,1,1,1,YES
16,src/java/main/org/apache/zookeeper/OpResult.java,185,0,0.0,0,0,0.0,0,0,0.0,0,0,0.0,0,0,0,0,NO
16,src/java/main/org/apache/zookeeper/Quotas.java,68,0,0.0,0,0,0.0,0,0,0.0,0,0,0.0,0,0,0,0,NO
16,src/java/main/org/apache/zookeeper/ServerAdminClient.java,277,0,0.0,0,0,0.0,0,0,0.0,0,0,0.0,0,0,0,0,NO
16,src/java/main/org/apache/zookeeper/Shell.java,476,0,0.0,0,0,0.0,0,0,0.0,0,0,0.0,0,0,0,0,NO
16,src/java/main/org/apache/zookeeper/StatsTrack.java,101,0,0.0,0,0,0.0,0,0,0.0,0,0,0.0,0,0,0,0,NO
16,src/java/main/org/apache/zookeeper/Transaction.java,63,7,7.0,7,7,7.0,7,14,14.0,14,0,0.0,0,1,1,1,NO
16,src/java/main/org/apache/zookeeper/Version.java,79,0,0.0,0,0,0.0,0,0,0.0,0,0,0.0,0,0,0,0,NO
16,src/java/main/org/apache/zookeeper/WatchedEvent.java,79,0,0.0,0,0,0.0,0,0,0.0,0,0,0.0,0,0,0,0,NO
16,src/java/main/org/apache/zookeeper/Watcher.java,149,0,0.0,0,0,0.0,0,0,0.0,0,0,0.0,0,0,0,0,NO
16,src/java/main/org/apache/zookeeper/ZKUtil.java,124,0,0.0,0,0,0.0,0,0,0.0,0,0,0.0,0,0,0,0,NO
16,src/java/main/org/apache/zookeeper/ZooDefs.java,119,0,0.0,0,0,0.0,0,0,0.0,0,0,0.0,0,0,0,0,NO
16,src/java/main/org/apache/zookeeper/ZooKeeper.java,1779,17,8.5,17,2,1.0,2,19,9.5,19,15,7.5,15,2,2,1,YES
16,src/java/main/org/apache/zookeeper/ZooKeeperMain.java,670,71,35.5,71,276,138.0,276,347,173.5,347,221,110.5,221,2,1,1,YES
16,src/java/main/org/apache/zookeeper/cli/AclParser.java,81,81,81.0,81,0,0.0,0,81,81.0,81,81,81.0,81,1,0,1,NO
16,src/java/main/org/apache/zookeeper/cli/AddAuthCommand.java,64,64,64.0,64,0,0.0,0,64,64.0,64,64,64.0,64,1,0,1,NO
16,src/java/main/org/apache/zookeeper/cli/CliCommand.java,119,119,119.0,119,0,0.0,0,119,119.0,119,119,119.0,119,1,0,1,NO
16,src/java/main/org/apache/zookeeper/cli/CloseCommand.java,46,46,46.0,46,0,0.0,0,46,46.0,46,46,46.0,46,1,0,1,NO
16,src/java/main/org/apache/zookeeper/cli/CreateCommand.java,81,81,81.0,81,0,0.0,0,81,81.0,81,81,81.0,81,1,0,1,NO
16,src/java/main/org/apache/zookeeper/cli/DelQuotaCommand.java,152,152,152.0,152,0,0.0,0,152,152.0,152,152,152.0,152,1,0,1,NO
16,src/java/main/org/apache/zookeeper/cli/DeleteAllCommand.java,72,72,72.0,72,0,0.0,0,72,72.0,72,72,72.0,72,1,0,1,NO
16,src/java/main/org/apache/zookeeper/cli/DeleteCommand.java,88,88,88.0,88,0,0.0,0,88,88.0,88,88,88.0,88,1,0,1,NO
16,src/java/main/org/apache/zookeeper/cli/GetAclCommand.java,94,94,94.0,94,0,0.0,0,94,94.0,94,94,94.0,94,1,0,1,NO
16,src/java/main/org/apache/zookeeper/cli/GetCommand.java,83,83,83.0,83,0,0.0,0,83,83.0,83,83,83.0,83,1,0,1,NO
16,src/java/main/org/apache/zookeeper/cli/ListQuotaCommand.java,74,74,74.0,74,0,0.0,0,74,74.0,74,74,74.0,74,1,0,1,NO
16,src/java/main/org/apache/zookeeper/cli/Ls2Command.java,62,62,62.0,62,0,0.0,0,62,62.0,62,62,62.0,62,1,0,1,NO
16,src/java/main/org/apache/zookeeper/cli/LsCommand.java,85,85,85.0,85,0,0.0,0,85,85.0,85,85,85.0,85,1,0,1,NO
16,src/java/main/org/apache/zookeeper/cli/SetAclCommand.java,82,82,82.0,82,0,0.0,0,82,82.0,82,82,82.0,82,1,0,1,NO
16,src/java/main/org/apache/zookeeper/cli/SetCommand.java,75,75,75.0,75,0,0.0,0,75,75.0,75,75,75.0,75,1,0,1,NO
16,src/java/main/org/apache/zookeeper/cli/SetQuotaCommand.java,200,200,200.0,200,0,0.0,0,200,200.0,200,200,200.0,200,1,0,1,NO
16,src/java/main/org/apache/zookeeper/cli/StatCommand.java,81,81,81.0,81,0,0.0,0,81,81.0,81,81,81.0,81,1,0,1,NO
16,src/java/main/org/apache/zookeeper/cli/StatPrinter.java,49,49,49.0,49,0,0.0,0,49,49.0,49,49,49.0,49,1,0,1,NO
16,src/java/main/org/apache/zookeeper/cli/SyncCommand.java,64,64,64.0,64,0,0.0,0,64,64.0,64,64,64.0,64,1,0,1,NO
16,src/java/main/org/apache/zookeeper/client/ConnectStringParser.java,87,0,0.0,0,0,0.0,0,0,0.0,0,0,0.0,0,0,0,0,NO
16,src/java/main/org/apache/zookeeper/client/FourLetterWordMain.java,79,0,0.0,0,0,0.0,0,0,0.0,0,0,0.0,0,0,0,0,NO
16,src/java/main/org/apache/zookeeper/client/HostProvider.java,61,0,0.0,0,0,0.0,0,0,0.0,0,0,0.0,0,0,0,0,NO
16,src/java/main/org/apache/zookeeper/client/StaticHostProvider.java,101,0,0.0,0,0,0.0,0,0,0.0,0,0,0.0,0,0,0,0,NO
16,src/java/main/org/apache/zookeeper/client/ZooKeeperSaslClient.java,435,0,0.0,0,0,0.0,0,0,0.0,0,0,0.0,0,0,0,0,YES
16,src/java/main/org/apache/zookeeper/common/PathTrie.java,284,0,0.0,0,0,0.0,0,0,0.0,0,0,0.0,0,0,0,0,YES
16,src/java/main/org/apache/zookeeper/common/PathUtils.java,103,0,0.0,0,0,0.0,0,0,0.0,0,0,0.0,0,0,0,0,NO
16,src/java/main/org/apache/zookeeper/jmx/CommonNames.java,29,0,0.0,0,0,0.0,0,0,0.0,0,0,0.0,0,0,0,0,NO
16,src/java/main/org/apache/zookeeper/jmx/MBeanRegistry.java,215,0,0.0,0,0,0.0,0,0,0.0,0,0,0.0,0,0,0,0,NO
16,src/java/main/org/apache/zookeeper/jmx/ManagedUtil.java,71,0,0.0,0,0,0.0,0,0,0.0,0,0,0.0,0,0,0,0,NO
16,src/java/main/org/apache/zookeeper/jmx/ZKMBeanInfo.java,36,0,0.0,0,0,0.0,0,0,0.0,0,0,0.0,0,0,0,0,NO
16,src/java/main/org/apache/zookeeper/server/ByteBufferInputStream.java,82,0,0.0,0,0,0.0,0,0,0.0,0,0,0.0,0,0,0,0,NO
16,src/java/main/org/apache/zookeeper/server/ByteBufferOutputStream.java,51,0,0.0,0,0,0.0,0,0,0.0,0,0,0.0,0,0,0,0,NO
16,src/java/main/org/apache/zookeeper/server/ConnectionBean.java,173,0,0.0,0,0,0.0,0,0,0.0,0,0,0.0,0,0,0,0,NO
16,src/java/main/org/apache/zookeeper/server/ConnectionMXBean.java,98,0,0.0,0,0,0.0,0,0,0.0,0,0,0.0,0,0,0,0,NO
16,src/java/main/org/apache/zookeeper/server/DataNode.java,174,0,0.0,0,0,0.0,0,0,0.0,0,0,0.0,0,0,0,0,NO
16,src/java/main/org/apache/zookeeper/server/DataTree.java,1302,6,6.0,6,15,15.0,15,21,21.0,21,9,9.0,9,1,0,1,YES
16,src/java/main/org/apache/zookeeper/server/DataTreeBean.java,61,0,0.0,0,0,0.0,0,0,0.0,0,0,0.0,0,0,0,0,NO
16,src/java/main/org/apache/zookeeper/server/DataTreeMXBean.java,47,0,0.0,0,0,0.0,0,0,0.0,0,0,0.0,0,0,0,0,NO
16,src/java/main/org/apache/zookeeper/server/DatadirCleanupManager.java,192,0,0.0,0,0,0.0,0,0,0.0,0,0,0.0,0,0,0,0,NO
16,src/java/main/org/apache/zookeeper/server/FinalRequestProcessor.java,414,3,3.0,3,2,2.0,2,5,5.0,5,1,1.0,1,1,1,1,NO
16,src/java/main/org/apache/zookeeper/server/LogFormatter.java,104,0,0.0,0,0,0.0,0,0,0.0,0,0,0.0,0,0,0,0,NO
16,src/java/main/org/apache/zookeeper/server/NIOServerCnxn.java,1157,3,3.0,3,3,3.0,3,6,6.0,6,0,0.0,0,1,1,1,YES
16,src/java/main/org/apache/zookeeper/server/NIOServerCnxnFactory.java,323,0,0.0,0,0,0.0,0,0,0.0,0,0,0.0,0,0,0,0,NO
16,src/java/main/org/apache/zookeeper/server/NettyServerCnxn.java,852,3,3.0,3,3,3.0,3,6,6.0,6,0,0.0,0,1,1,1,YES
16,src/java/main/org/apache/zookeeper/server/NettyServerCnxnFactory.java,414,0,0.0,0,0,0.0,0,0,0.0,0,0,0.0,0,0,0,0,NO
16,src/java/main/org/apache/zookeeper/server/ObserverBean.java,45,0,0.0,0,0,0.0,0,0,0.0,0,0,0.0,0,0,0,0,NO
16,src/java/main/org/apache/zookeeper/server/PrepRequestProcessor.java,725,10,10.0,10,2,2.0,2,12,12.0,12,8,8.0,8,1,1,1,NO
16,src/java/main/org/apache/zookeeper/server/PurgeTxnLog.java,129,0,0.0,0,0,0.0,0,0,0.0,0,0,0.0,0,0,0,0,NO
16,src/java/main/org/apache/zookeeper/server/Request.java,256,0,0.0,0,0,0.0,0,0,0.0,0,0,0.0,0,0,0,0,NO
16,src/java/main/org/apache/zookeeper/server/RequestProcessor.java,44,8,8.0,8,1,1.0,1,9,9.0,9,7,7.0,7,1,1,1,NO
16,src/java/main/org/apache/zookeeper/server/ServerCnxn.java,452,0,0.0,0,0,0.0,0,0,0.0,0,0,0.0,0,0,0,0,NO
16,src/java/main/org/apache/zookeeper/server/ServerCnxnFactory.java,149,0,0.0,0,0,0.0,0,0,0.0,0,0,0.0,0,0,0,0,NO
16,src/java/main/org/apache/zookeeper/server/ServerConfig.java,112,0,0.0,0,0,0.0,0,0,0.0,0,0,0.0,0,0,0,0,NO
16,src/java/main/org/apache/zookeeper/server/ServerStats.java,140,0,0.0,0,0,0.0,0,0,0.0,0,0,0.0,0,0,0,0,NO
16,src/java/main/org/apache/zookeeper/server/SessionTracker.java,81,0,0.0,0,0,0.0,0,0,0.0,0,0,0.0,0,0,0,0,NO
16,src/java/main/org/apache/zookeeper/server/SessionTrackerImpl.java,274,0,0.0,0,0,0.0,0,0,0.0,0,0,0.0,0,0,0,0,YES
16,src/java/main/org/apache/zookeeper/server/SnapshotFormatter.java,124,124,124.0,124,0,0.0,0,124,124.0,124,124,124.0,124,1,0,1,NO
16,src/java/main/org/apache/zookeeper/server/Stats.java,68,0,0.0,0,0,0.0,0,0,0.0,0,0,0.0,0,0,0,0,NO
16,src/java/main/org/apache/zookeeper/server/SyncRequestProcessor.java,192,3,3.0,3,1,1.0,1,4,4.0,4,2,2.0,2,1,1,1,NO
16,src/java/main/org/apache/zookeeper/server/TraceFormatter.java,123,0,0.0,0,0,0.0,0,0,0.0,0,0,0.0,0,0,0,0,NO
16,src/java/main/org/apache/zookeeper/server/WatchManager.java,171,0,0.0,0,0,0.0,0,0,0.0,0,0,0.0,0,0,0,0,NO
16,src/java/main/org/apache/zookeeper/server/ZKDatabase.java,483,0,0.0,0,0,0.0,0,0,0.0,0,0,0.0,0,0,0,0,YES
16,src/java/main/org/apache/zookeeper/server/ZooKeeperSaslServer.java,127,0,0.0,0,0,0.0,0,0,0.0,0,0,0.0,0,0,0,0,NO
16,src/java/main/org/apache/zookeeper/server/ZooKeeperServer.java,961,7,7.0,7,4,4.0,4,11,11.0,11,3,3.0,3,1,1,1,YES
16,src/java/main/org/apache/zookeeper/server/ZooKeeperServerBean.java,147,0,0.0,0,0,0.0,0,0,0.0,0,0,0.0,0,0,0,0,NO
16,src/java/main/org/apache/zookeeper/server/ZooKeeperServerMXBean.java,110,0,0.0,0,0,0.0,0,0,0.0,0,0,0.0,0,0,0,0,NO
16,src/java/main/org/apache/zookeeper/server/ZooKeeperServerMain.java,128,7,7.0,7,2,2.0,2,9,9.0,9,5,5.0,5,1,0,1,NO
16,src/java/main/org/apache/zookeeper/server/ZooTrace.java,93,0,0.0,0,0,0.0,0,0,0.0,0,0,0.0,0,0,0,0,NO
16,src/java/main/org/apache/zookeeper/server/auth/AuthenticationProvider.java,82,0,0.0,0,0,0.0,0,0,0.0,0,0,0.0,0,0,0,0,NO
16,src/java/main/org/apache/zookeeper/server/auth/DigestAuthenticationProvider.java,139,0,0.0,0,0,0.0,0,0,0.0,0,0,0.0,0,0,0,0,NO
16,src/java/main/org/apache/zookeeper/server/auth/DigestLoginModule.java,59,0,0.0,0,0,0.0,0,0,0.0,0,0,0.0,0,0,0,0,NO
16,src/java/main/org/apache/zookeeper/server/auth/IPAuthenticationProvider.java,117,0,0.0,0,0,0.0,0,0,0.0,0,0,0.0,0,0,0,0,NO
16,src/java/main/org/apache/zookeeper/server/auth/KerberosName.java,418,0,0.0,0,0,0.0,0,0,0.0,0,0,0.0,0,0,0,0,NO
16,src/java/main/org/apache/zookeeper/server/auth/ProviderRegistry.java,77,0,0.0,0,0,0.0,0,0,0.0,0,0,0.0,0,0,0,0,NO
16,src/java/main/org/apache/zookeeper/server/auth/SASLAuthenticationProvider.java,70,0,0.0,0,0,0.0,0,0,0.0,0,0,0.0,0,0,0,0,NO
16,src/java/main/org/apache/zookeeper/server/auth/SaslServerCallbackHandler.java,148,0,0.0,0,0,0.0,0,0,0.0,0,0,0.0,0,0,0,0,NO
16,src/java/main/org/apache/zookeeper/server/persistence/FileSnap.java,250,0,0.0,0,0,0.0,0,0,0.0,0,0,0.0,0,0,0,0,NO
16,src/java/main/org/apache/zookeeper/server/persistence/FileTxnLog.java,661,0,0.0,0,0,0.0,0,0,0.0,0,0,0.0,0,0,0,0,NO
16,src/java/main/org/apache/zookeeper/server/persistence/FileTxnSnapLog.java,365,45,45.0,45,5,5.0,5,50,50.0,50,40,40.0,40,1,0,1,YES
16,src/java/main/org/apache/zookeeper/server/persistence/SnapShot.java,66,0,0.0,0,0,0.0,0,0,0.0,0,0,0.0,0,0,0,0,NO
16,src/java/main/org/apache/zookeeper/server/persistence/TxnLog.java,120,0,0.0,0,0,0.0,0,0,0.0,0,0,0.0,0,0,0,0,NO
16,src/java/main/org/apache/zookeeper/server/persistence/Util.java,326,0,0.0,0,0,0.0,0,0,0.0,0,0,0.0,0,0,0,0,NO
16,src/java/main/org/apache/zookeeper/server/quorum/AckRequestProcessor.java,54,0,0.0,0,0,0.0,0,0,0.0,0,0,0.0,0,0,0,0,NO
16,src/java/main/org/apache/zookeeper/server/quorum/AuthFastLeaderElection.java,972,0,0.0,0,0,0.0,0,0,0.0,0,0,0.0,0,0,0,0,NO
16,src/java/main/org/apache/zookeeper/server/quorum/CommitProcessor.java,185,0,0.0,0,0,0.0,0,0,0.0,0,0,0.0,0,0,0,0,NO
16,src/java/main/org/apache/zookeeper/server/quorum/Election.java,27,0,0.0,0,0,0.0,0,0,0.0,0,0,0.0,0,0,0,0,NO
16,src/java/main/org/apache/zookeeper/server/quorum/FastLeaderElection.java,893,0,0.0,0,0,0.0,0,0,0.0,0,0,0.0,0,0,0,0,YES
16,src/java/main/org/apache/zookeeper/server/quorum/Follower.java,167,0,0.0,0,0,0.0,0,0,0.0,0,0,0.0,0,0,0,0,NO
16,src/java/main/org/apache/zookeeper/server/quorum/FollowerBean.java,50,0,0.0,0,0,0.0,0,0,0.0,0,0,0.0,0,0,0,0,NO
16,src/java/main/org/apache/zookeeper/server/quorum/FollowerMXBean.java,41,0,0.0,0,0,0.0,0,0,0.0,0,0,0.0,0,0,0,0,NO
16,src/java/main/org/apache/zookeeper/server/quorum/FollowerRequestProcessor.java,113,0,0.0,0,0,0.0,0,0,0.0,0,0,0.0,0,0,0,0,NO
16,src/java/main/org/apache/zookeeper/server/quorum/FollowerZooKeeperServer.java,160,0,0.0,0,0,0.0,0,0,0.0,0,0,0.0,0,0,0,0,NO
16,src/java/main/org/apache/zookeeper/server/quorum/Leader.java,904,106,53.0,106,27,13.5,27,133,66.5,133,79,39.5,79,2,2,2,YES
16,src/java/main/org/apache/zookeeper/server/quorum/LeaderBean.java,53,1,1.0,1,1,1.0,1,2,2.0,2,0,0.0,0,1,1,1,NO
16,src/java/main/org/apache/zookeeper/server/quorum/LeaderElection.java,293,0,0.0,0,0,0.0,0,0,0.0,0,0,0.0,0,0,0,0,NO
16,src/java/main/org/apache/zookeeper/server/quorum/LeaderElectionBean.java,42,0,0.0,0,0,0.0,0,0,0.0,0,0,0.0,0,0,0,0,NO
16,src/java/main/org/apache/zookeeper/server/quorum/LeaderElectionMXBean.java,31,0,0.0,0,0,0.0,0,0,0.0,0,0,0.0,0,0,0,0,NO
16,src/java/main/org/apache/zookeeper/server/quorum/LeaderMXBean.java,36,0,0.0,0,0,0.0,0,0,0.0,0,0,0.0,0,0,0,0,NO
16,src/java/main/org/apache/zookeeper/server/quorum/LeaderZooKeeperServer.java,177,0,0.0,0,0,0.0,0,0,0.0,0,0,0.0,0,0,0,0,NO
16,src/java/main/org/apache/zookeeper/server/quorum/Learner.java,482,0,0.0,0,0,0.0,0,0,0.0,0,0,0.0,0,0,0,0,YES
16,src/java/main/org/apache/zookeeper/server/quorum/LearnerHandler.java,622,0,0.0,0,0,0.0,0,0,0.0,0,0,0.0,0,0,0,0,YES
16,src/java/main/org/apache/zookeeper/server/quorum/LearnerSessionTracker.java,96,0,0.0,0,0,0.0,0,0,0.0,0,0,0.0,0,0,0,0,NO
16,src/java/main/org/apache/zookeeper/server/quorum/LearnerSyncRequest.java,34,0,0.0,0,0,0.0,0,0,0.0,0,0,0.0,0,0,0,0,NO
16,src/java/main/org/apache/zookeeper/server/quorum/LearnerZooKeeperServer.java,144,0,0.0,0,0,0.0,0,0,0.0,0,0,0.0,0,0,0,0,NO
16,src/java/main/org/apache/zookeeper/server/quorum/LocalPeerBean.java,79,0,0.0,0,0,0.0,0,0,0.0,0,0,0.0,0,0,0,0,NO
16,src/java/main/org/apache/zookeeper/server/quorum/LocalPeerMXBean.java,77,0,0.0,0,0,0.0,0,0,0.0,0,0,0.0,0,0,0,0,NO
16,src/java/main/org/apache/zookeeper/server/quorum/Observer.java,134,0,0.0,0,0,0.0,0,0,0.0,0,0,0.0,0,0,0,0,NO
16,src/java/main/org/apache/zookeeper/server/quorum/ObserverMXBean.java,37,0,0.0,0,0,0.0,0,0,0.0,0,0,0.0,0,0,0,0,NO
16,src/java/main/org/apache/zookeeper/server/quorum/ObserverRequestProcessor.java,127,0,0.0,0,0,0.0,0,0,0.0,0,0,0.0,0,0,0,0,NO
16,src/java/main/org/apache/zookeeper/server/quorum/ObserverZooKeeperServer.java,115,0,0.0,0,0,0.0,0,0,0.0,0,0,0.0,0,0,0,0,NO
16,src/java/main/org/apache/zookeeper/server/quorum/ProposalRequestProcessor.java,93,9,9.0,9,4,4.0,4,13,13.0,13,5,5.0,5,1,1,1,NO
16,src/java/main/org/apache/zookeeper/server/quorum/QuorumBean.java,44,0,0.0,0,0,0.0,0,0,0.0,0,0,0.0,0,0,0,0,NO
16,src/java/main/org/apache/zookeeper/server/quorum/QuorumCnxManager.java,884,0,0.0,0,0,0.0,0,0,0.0,0,0,0.0,0,0,0,0,YES
16,src/java/main/org/apache/zookeeper/server/quorum/QuorumMXBean.java,34,0,0.0,0,0,0.0,0,0,0.0,0,0,0.0,0,0,0,0,NO
16,src/java/main/org/apache/zookeeper/server/quorum/QuorumPeer.java,1123,2,2.0,2,6,6.0,6,8,8.0,8,4,4.0,4,1,1,1,YES
16,src/java/main/org/apache/zookeeper/server/quorum/QuorumPeerConfig.java,411,0,0.0,0,0,0.0,0,0,0.0,0,0,0.0,0,0,0,0,NO
16,src/java/main/org/apache/zookeeper/server/quorum/QuorumPeerMain.java,162,5,5.0,5,0,0.0,0,5,5.0,5,5,5.0,5,1,0,1,NO
16,src/java/main/org/apache/zookeeper/server/quorum/QuorumStats.java,68,0,0.0,0,0,0.0,0,0,0.0,0,0,0.0,0,0,0,0,NO
16,src/java/main/org/apache/zookeeper/server/quorum/QuorumZooKeeperServer.java,59,0,0.0,0,0,0.0,0,0,0.0,0,0,0.0,0,0,0,0,NO
16,src/java/main/org/apache/zookeeper/server/quorum/ReadOnlyBean.java,38,0,0.0,0,0,0.0,0,0,0.0,0,0,0.0,0,0,0,0,NO
16,src/java/main/org/apache/zookeeper/server/quorum/ReadOnlyRequestProcessor.java,129,9,9.0,9,0,0.0,0,9,9.0,9,9,9.0,9,1,1,1,NO
16,src/java/main/org/apache/zookeeper/server/quorum/ReadOnlyZooKeeperServer.java,144,0,0.0,0,0,0.0,0,0,0.0,0,0,0.0,0,0,0,0,NO
16,src/java/main/org/apache/zookeeper/server/quorum/RemotePeerBean.java,45,0,0.0,0,0,0.0,0,0,0.0,0,0,0.0,0,0,0,0,NO
16,src/java/main/org/apache/zookeeper/server/quorum/RemotePeerMXBean.java,33,0,0.0,0,0,0.0,0,0,0.0,0,0,0.0,0,0,0,0,NO
16,src/java/main/org/apache/zookeeper/server/quorum/SendAckRequestProcessor.java,80,0,0.0,0,0,0.0,0,0,0.0,0,0,0.0,0,0,0,0,NO
16,src/java/main/org/apache/zookeeper/server/quorum/ServerBean.java,38,0,0.0,0,0,0.0,0,0,0.0,0,0,0.0,0,0,0,0,NO
16,src/java/main/org/apache/zookeeper/server/quorum/ServerMXBean.java,33,0,0.0,0,0,0.0,0,0,0.0,0,0,0.0,0,0,0,0,NO
16,src/java/main/org/apache/zookeeper/server/quorum/StateSummary.java,57,0,0.0,0,0,0.0,0,0,0.0,0,0,0.0,0,0,0,0,NO
16,src/java/main/org/apache/zookeeper/server/quorum/Vote.java,106,0,0.0,0,0,0.0,0,0,0.0,0,0,0.0,0,0,0,0,NO
16,src/java/main/org/apache/zookeeper/server/quorum/flexible/QuorumHierarchical.java,271,0,0.0,0,0,0.0,0,0,0.0,0,0,0.0,0,0,0,0,NO
16,src/java/main/org/apache/zookeeper/server/quorum/flexible/QuorumMaj.java,57,0,0.0,0,0,0.0,0,0,0.0,0,0,0.0,0,0,0,0,NO
16,src/java/main/org/apache/zookeeper/server/quorum/flexible/QuorumVerifier.java,33,0,0.0,0,0,0.0,0,0,0.0,0,0,0.0,0,0,0,0,NO
16,src/java/main/org/apache/zookeeper/server/util/SerializeUtils.java,141,0,0.0,0,0,0.0,0,0,0.0,0,0,0.0,0,0,0,0,NO
16,src/java/main/org/apache/zookeeper/server/util/VerifyingFileFactory.java,82,0,0.0,0,0,0.0,0,0,0.0,0,0,0.0,0,0,0,0,NO
16,src/java/main/org/apache/zookeeper/server/util/ZxidUtils.java,34,0,0.0,0,0,0.0,0,0,0.0,0,0,0.0,0,0,0,0,NO
16,src/java/main/org/apache/zookeeper/version/util/VerGen.java,177,0,0.0,0,0,0.0,0,0,0.0,0,0,0.0,0,0,0,0,NO
16,src/recipes/election/src/java/org/apache/zookeeper/recipes/leader/LeaderElectionAware.java,37,0,0.0,0,0,0.0,0,0,0.0,0,0,0.0,0,0,0,0,NO
16,src/recipes/election/src/java/org/apache/zookeeper/recipes/leader/LeaderElectionSupport.java,461,0,0.0,0,0,0.0,0,0,0.0,0,0,0.0,0,0,0,0,NO
16,src/recipes/election/src/java/org/apache/zookeeper/recipes/leader/LeaderOffer.java,84,0,0.0,0,0,0.0,0,0,0.0,0,0,0.0,0,0,0,0,NO
16,src/recipes/lock/src/java/org/apache/zookeeper/recipes/lock/LockListener.java,38,0,0.0,0,0,0.0,0,0,0.0,0,0,0.0,0,0,0,0,NO
16,src/recipes/lock/src/java/org/apache/zookeeper/recipes/lock/ProtocolSupport.java,193,0,0.0,0,0,0.0,0,0,0.0,0,0,0.0,0,0,0,0,NO
16,src/recipes/lock/src/java/org/apache/zookeeper/recipes/lock/WriteLock.java,295,0,0.0,0,0,0.0,0,0,0.0,0,0,0.0,0,0,0,0,NO
16,src/recipes/lock/src/java/org/apache/zookeeper/recipes/lock/ZNodeName.java,110,0,0.0,0,0,0.0,0,0,0.0,0,0,0.0,0,0,0,0,NO
16,src/recipes/lock/src/java/org/apache/zookeeper/recipes/lock/ZooKeeperOperation.java,38,0,0.0,0,0,0.0,0,0,0.0,0,0,0.0,0,0,0,0,NO
16,src/recipes/queue/src/java/org/apache/zookeeper/recipes/queue/DistributedQueue.java,313,0,0.0,0,0,0.0,0,0,0.0,0,0,0.0,0,0,0,0,NO
17,src/contrib/fatjar/src/java/org/apache/zookeeper/util/FatJarMain.java,126,0,0.0,0,0,0.0,0,0,0.0,0,0,0.0,0,0,0,0,NO
17,src/contrib/loggraph/src/java/org/apache/zookeeper/graph/FilterException.java,22,0,0.0,0,0,0.0,0,0,0.0,0,0,0.0,0,0,0,0,NO
17,src/contrib/loggraph/src/java/org/apache/zookeeper/graph/FilterOp.java,75,0,0.0,0,0,0.0,0,0,0.0,0,0,0.0,0,0,0,0,NO
17,src/contrib/loggraph/src/java/org/apache/zookeeper/graph/FilterParser.java,131,0,0.0,0,0,0.0,0,0,0.0,0,0,0.0,0,0,0,0,NO
17,src/contrib/loggraph/src/java/org/apache/zookeeper/graph/JsonGenerator.java,223,0,0.0,0,0,0.0,0,0,0.0,0,0,0.0,0,0,0,0,NO
17,src/contrib/loggraph/src/java/org/apache/zookeeper/graph/Log4JEntry.java,40,0,0.0,0,0,0.0,0,0,0.0,0,0,0.0,0,0,0,0,NO
17,src/contrib/loggraph/src/java/org/apache/zookeeper/graph/Log4JSource.java,381,0,0.0,0,0,0.0,0,0,0.0,0,0,0.0,0,0,0,0,NO
17,src/contrib/loggraph/src/java/org/apache/zookeeper/graph/LogEntry.java,46,0,0.0,0,0,0.0,0,0,0.0,0,0,0.0,0,0,0,0,NO
17,src/contrib/loggraph/src/java/org/apache/zookeeper/graph/LogIterator.java,26,0,0.0,0,0,0.0,0,0,0.0,0,0,0.0,0,0,0,0,NO
17,src/contrib/loggraph/src/java/org/apache/zookeeper/graph/LogServer.java,66,0,0.0,0,0,0.0,0,0,0.0,0,0,0.0,0,0,0,0,NO
17,src/contrib/loggraph/src/java/org/apache/zookeeper/graph/LogSkipList.java,95,0,0.0,0,0,0.0,0,0,0.0,0,0,0.0,0,0,0,0,NO
17,src/contrib/loggraph/src/java/org/apache/zookeeper/graph/LogSource.java,33,0,0.0,0,0,0.0,0,0,0.0,0,0,0.0,0,0,0,0,NO
17,src/contrib/loggraph/src/java/org/apache/zookeeper/graph/MeasureThroughput.java,103,0,0.0,0,0,0.0,0,0,0.0,0,0,0.0,0,0,0,0,NO
17,src/contrib/loggraph/src/java/org/apache/zookeeper/graph/MergedLogSource.java,219,0,0.0,0,0,0.0,0,0,0.0,0,0,0.0,0,0,0,0,NO
17,src/contrib/loggraph/src/java/org/apache/zookeeper/graph/RandomAccessFileReader.java,328,0,0.0,0,0,0.0,0,0,0.0,0,0,0.0,0,0,0,0,NO
17,src/contrib/loggraph/src/java/org/apache/zookeeper/graph/TransactionEntry.java,59,0,0.0,0,0,0.0,0,0,0.0,0,0,0.0,0,0,0,0,NO
17,src/contrib/loggraph/src/java/org/apache/zookeeper/graph/TxnLogSource.java,376,0,0.0,0,0,0.0,0,0,0.0,0,0,0.0,0,0,0,0,NO
17,src/contrib/loggraph/src/java/org/apache/zookeeper/graph/filterops/AndOp.java,33,0,0.0,0,0,0.0,0,0,0.0,0,0,0.0,0,0,0,0,NO
17,src/contrib/loggraph/src/java/org/apache/zookeeper/graph/filterops/Arg.java,36,0,0.0,0,0,0.0,0,0,0.0,0,0,0.0,0,0,0,0,NO
17,src/contrib/loggraph/src/java/org/apache/zookeeper/graph/filterops/EqualsOp.java,44,0,0.0,0,0,0.0,0,0,0.0,0,0,0.0,0,0,0,0,NO
17,src/contrib/loggraph/src/java/org/apache/zookeeper/graph/filterops/GreaterThanOp.java,70,0,0.0,0,0,0.0,0,0,0.0,0,0,0.0,0,0,0,0,NO
17,src/contrib/loggraph/src/java/org/apache/zookeeper/graph/filterops/LessThanOp.java,69,0,0.0,0,0,0.0,0,0,0.0,0,0,0.0,0,0,0,0,NO
17,src/contrib/loggraph/src/java/org/apache/zookeeper/graph/filterops/NotOp.java,31,0,0.0,0,0,0.0,0,0,0.0,0,0,0.0,0,0,0,0,NO
17,src/contrib/loggraph/src/java/org/apache/zookeeper/graph/filterops/NumberArg.java,27,0,0.0,0,0,0.0,0,0,0.0,0,0,0.0,0,0,0,0,NO
17,src/contrib/loggraph/src/java/org/apache/zookeeper/graph/filterops/OrOp.java,33,0,0.0,0,0,0.0,0,0,0.0,0,0,0.0,0,0,0,0,NO
17,src/contrib/loggraph/src/java/org/apache/zookeeper/graph/filterops/StringArg.java,27,0,0.0,0,0,0.0,0,0,0.0,0,0,0.0,0,0,0,0,NO
17,src/contrib/loggraph/src/java/org/apache/zookeeper/graph/filterops/SymbolArg.java,27,0,0.0,0,0,0.0,0,0,0.0,0,0,0.0,0,0,0,0,NO
17,src/contrib/loggraph/src/java/org/apache/zookeeper/graph/filterops/XorOp.java,40,0,0.0,0,0,0.0,0,0,0.0,0,0,0.0,0,0,0,0,NO
17,src/contrib/loggraph/src/java/org/apache/zookeeper/graph/servlets/FileLoader.java,60,0,0.0,0,0,0.0,0,0,0.0,0,0,0.0,0,0,0,0,NO
17,src/contrib/loggraph/src/java/org/apache/zookeeper/graph/servlets/Fs.java,69,0,0.0,0,0,0.0,0,0,0.0,0,0,0.0,0,0,0,0,NO
17,src/contrib/loggraph/src/java/org/apache/zookeeper/graph/servlets/GraphData.java,85,0,0.0,0,0,0.0,0,0,0.0,0,0,0.0,0,0,0,0,NO
17,src/contrib/loggraph/src/java/org/apache/zookeeper/graph/servlets/JsonServlet.java,85,0,0.0,0,0,0.0,0,0,0.0,0,0,0.0,0,0,0,0,NO
17,src/contrib/loggraph/src/java/org/apache/zookeeper/graph/servlets/NumEvents.java,86,0,0.0,0,0,0.0,0,0,0.0,0,0,0.0,0,0,0,0,NO
17,src/contrib/loggraph/src/java/org/apache/zookeeper/graph/servlets/StaticContent.java,50,0,0.0,0,0,0.0,0,0,0.0,0,0,0.0,0,0,0,0,NO
17,src/contrib/loggraph/src/java/org/apache/zookeeper/graph/servlets/Throughput.java,125,0,0.0,0,0,0.0,0,0,0.0,0,0,0.0,0,0,0,0,NO
17,src/contrib/rest/src/java/org/apache/zookeeper/server/jersey/RestMain.java,151,0,0.0,0,0,0.0,0,0,0.0,0,0,0.0,0,0,0,0,NO
17,src/contrib/rest/src/java/org/apache/zookeeper/server/jersey/ZooKeeperService.java,242,0,0.0,0,0,0.0,0,0,0.0,0,0,0.0,0,0,0,0,NO
17,src/contrib/rest/src/java/org/apache/zookeeper/server/jersey/cfg/Credentials.java,47,0,0.0,0,0,0.0,0,0,0.0,0,0,0.0,0,0,0,0,NO
17,src/contrib/rest/src/java/org/apache/zookeeper/server/jersey/cfg/Endpoint.java,72,0,0.0,0,0,0.0,0,0,0.0,0,0,0.0,0,0,0,0,NO
17,src/contrib/rest/src/java/org/apache/zookeeper/server/jersey/cfg/HostPort.java,51,0,0.0,0,0,0.0,0,0,0.0,0,0,0.0,0,0,0,0,NO
17,src/contrib/rest/src/java/org/apache/zookeeper/server/jersey/cfg/HostPortSet.java,51,0,0.0,0,0,0.0,0,0,0.0,0,0,0.0,0,0,0,0,NO
17,src/contrib/rest/src/java/org/apache/zookeeper/server/jersey/cfg/RestCfg.java,106,0,0.0,0,0,0.0,0,0,0.0,0,0,0.0,0,0,0,0,NO
17,src/contrib/rest/src/java/org/apache/zookeeper/server/jersey/filters/HTTPBasicAuth.java,87,0,0.0,0,0,0.0,0,0,0.0,0,0,0.0,0,0,0,0,NO
17,src/contrib/rest/src/java/org/apache/zookeeper/server/jersey/jaxb/ZChildren.java,80,0,0.0,0,0,0.0,0,0,0.0,0,0,0.0,0,0,0,0,NO
17,src/contrib/rest/src/java/org/apache/zookeeper/server/jersey/jaxb/ZChildrenJSON.java,76,0,0.0,0,0,0.0,0,0,0.0,0,0,0.0,0,0,0,0,NO
17,src/contrib/rest/src/java/org/apache/zookeeper/server/jersey/jaxb/ZError.java,41,0,0.0,0,0,0.0,0,0,0.0,0,0,0.0,0,0,0,0,NO
17,src/contrib/rest/src/java/org/apache/zookeeper/server/jersey/jaxb/ZPath.java,63,0,0.0,0,0,0.0,0,0,0.0,0,0,0.0,0,0,0,0,NO
17,src/contrib/rest/src/java/org/apache/zookeeper/server/jersey/jaxb/ZSession.java,55,0,0.0,0,0,0.0,0,0,0.0,0,0,0.0,0,0,0,0,NO
17,src/contrib/rest/src/java/org/apache/zookeeper/server/jersey/jaxb/ZStat.java,106,0,0.0,0,0,0.0,0,0,0.0,0,0,0.0,0,0,0,0,NO
17,src/contrib/rest/src/java/org/apache/zookeeper/server/jersey/resources/JAXBContextResolver.java,72,0,0.0,0,0,0.0,0,0,0.0,0,0,0.0,0,0,0,0,NO
17,src/contrib/rest/src/java/org/apache/zookeeper/server/jersey/resources/KeeperExceptionMapper.java,86,0,0.0,0,0,0.0,0,0,0.0,0,0,0.0,0,0,0,0,NO
17,src/contrib/rest/src/java/org/apache/zookeeper/server/jersey/resources/RuntimeExceptionMapper.java,55,0,0.0,0,0,0.0,0,0,0.0,0,0,0.0,0,0,0,0,NO
17,src/contrib/rest/src/java/org/apache/zookeeper/server/jersey/resources/SessionsResource.java,135,0,0.0,0,0,0.0,0,0,0.0,0,0,0.0,0,0,0,0,NO
17,src/contrib/rest/src/java/org/apache/zookeeper/server/jersey/resources/ZErrorWriter.java,63,0,0.0,0,0,0.0,0,0,0.0,0,0,0.0,0,0,0,0,NO
17,src/contrib/rest/src/java/org/apache/zookeeper/server/jersey/resources/ZNodeResource.java,412,0,0.0,0,0,0.0,0,0,0.0,0,0,0.0,0,0,0,0,NO
17,src/contrib/zooinspector/src/java/com/nitido/utils/toaster/Toaster.java,533,0,0.0,0,0,0.0,0,0,0.0,0,0,0.0,0,0,0,0,NO
17,src/contrib/zooinspector/src/java/org/apache/zookeeper/inspector/ZooInspector.java,67,0,0.0,0,0,0.0,0,0,0.0,0,0,0.0,0,0,0,0,NO
17,src/contrib/zooinspector/src/java/org/apache/zookeeper/inspector/encryption/BasicDataEncryptionManager.java,50,0,0.0,0,0,0.0,0,0,0.0,0,0,0.0,0,0,0,0,NO
17,src/contrib/zooinspector/src/java/org/apache/zookeeper/inspector/encryption/DataEncryptionManager.java,39,0,0.0,0,0,0.0,0,0,0.0,0,0,0.0,0,0,0,0,NO
17,src/contrib/zooinspector/src/java/org/apache/zookeeper/inspector/gui/IconResource.java,88,0,0.0,0,0,0.0,0,0,0.0,0,0,0.0,0,0,0,0,NO
17,src/contrib/zooinspector/src/java/org/apache/zookeeper/inspector/gui/NodeViewersChangeListener.java,37,0,0.0,0,0,0.0,0,0,0.0,0,0,0.0,0,0,0,0,NO
17,src/contrib/zooinspector/src/java/org/apache/zookeeper/inspector/gui/Toolbar.java,74,0,0.0,0,0,0.0,0,0,0.0,0,0,0.0,0,0,0,0,NO
17,src/contrib/zooinspector/src/java/org/apache/zookeeper/inspector/gui/ZooInspectorAboutDialog.java,79,0,0.0,0,0,0.0,0,0,0.0,0,0,0.0,0,0,0,0,NO
17,src/contrib/zooinspector/src/java/org/apache/zookeeper/inspector/gui/ZooInspectorConnectionPropertiesDialog.java,321,0,0.0,0,0,0.0,0,0,0.0,0,0,0.0,0,0,0,0,NO
17,src/contrib/zooinspector/src/java/org/apache/zookeeper/inspector/gui/ZooInspectorNodeViewersDialog.java,631,0,0.0,0,0,0.0,0,0,0.0,0,0,0.0,0,0,0,0,NO
17,src/contrib/zooinspector/src/java/org/apache/zookeeper/inspector/gui/ZooInspectorNodeViewersPanel.java,140,0,0.0,0,0,0.0,0,0,0.0,0,0,0.0,0,0,0,0,NO
17,src/contrib/zooinspector/src/java/org/apache/zookeeper/inspector/gui/ZooInspectorPanel.java,318,0,0.0,0,0,0.0,0,0,0.0,0,0,0.0,0,0,0,0,NO
17,src/contrib/zooinspector/src/java/org/apache/zookeeper/inspector/gui/ZooInspectorTreeViewer.java,356,0,0.0,0,0,0.0,0,0,0.0,0,0,0.0,0,0,0,0,NO
17,src/contrib/zooinspector/src/java/org/apache/zookeeper/inspector/gui/nodeviewer/NodeViewerACL.java,187,0,0.0,0,0,0.0,0,0,0.0,0,0,0.0,0,0,0,0,NO
17,src/contrib/zooinspector/src/java/org/apache/zookeeper/inspector/gui/nodeviewer/NodeViewerData.java,142,0,0.0,0,0,0.0,0,0,0.0,0,0,0.0,0,0,0,0,NO
17,src/contrib/zooinspector/src/java/org/apache/zookeeper/inspector/gui/nodeviewer/NodeViewerMetaData.java,186,0,0.0,0,0,0.0,0,0,0.0,0,0,0.0,0,0,0,0,NO
17,src/contrib/zooinspector/src/java/org/apache/zookeeper/inspector/gui/nodeviewer/ZooInspectorNodeViewer.java,138,0,0.0,0,0,0.0,0,0,0.0,0,0,0.0,0,0,0,0,NO
17,src/contrib/zooinspector/src/java/org/apache/zookeeper/inspector/logger/LoggerFactory.java,36,0,0.0,0,0,0.0,0,0,0.0,0,0,0.0,0,0,0,0,NO
17,src/contrib/zooinspector/src/java/org/apache/zookeeper/inspector/manager/NodeListener.java,37,0,0.0,0,0,0.0,0,0,0.0,0,0,0.0,0,0,0,0,NO
17,src/contrib/zooinspector/src/java/org/apache/zookeeper/inspector/manager/Pair.java,120,0,0.0,0,0,0.0,0,0,0.0,0,0,0.0,0,0,0,0,NO
17,src/contrib/zooinspector/src/java/org/apache/zookeeper/inspector/manager/ZooInspectorManager.java,139,0,0.0,0,0,0.0,0,0,0.0,0,0,0.0,0,0,0,0,NO
17,src/contrib/zooinspector/src/java/org/apache/zookeeper/inspector/manager/ZooInspectorManagerImpl.java,852,0,0.0,0,0,0.0,0,0,0.0,0,0,0.0,0,0,0,0,NO
17,src/contrib/zooinspector/src/java/org/apache/zookeeper/inspector/manager/ZooInspectorNodeManager.java,33,0,0.0,0,0,0.0,0,0,0.0,0,0,0.0,0,0,0,0,NO
17,src/contrib/zooinspector/src/java/org/apache/zookeeper/inspector/manager/ZooInspectorNodeTreeManager.java,43,0,0.0,0,0,0.0,0,0,0.0,0,0,0.0,0,0,0,0,NO
17,src/contrib/zooinspector/src/java/org/apache/zookeeper/inspector/manager/ZooInspectorReadOnlyManager.java,99,0,0.0,0,0,0.0,0,0,0.0,0,0,0.0,0,0,0,0,NO
17,src/contrib/zooinspector/src/java/org/apache/zookeeper/retry/ZooKeeperRetry.java,288,0,0.0,0,0,0.0,0,0,0.0,0,0,0.0,0,0,0,0,NO
17,src/java/main/org/apache/jute/BinaryInputArchive.java,131,0,0.0,0,0,0.0,0,0,0.0,0,0,0.0,0,0,0,0,YES
17,src/java/main/org/apache/jute/BinaryOutputArchive.java,146,0,0.0,0,0,0.0,0,0,0.0,0,0,0.0,0,0,0,0,NO
17,src/java/main/org/apache/jute/CsvInputArchive.java,204,0,0.0,0,0,0.0,0,0,0.0,0,0,0.0,0,0,0,0,NO
17,src/java/main/org/apache/jute/CsvOutputArchive.java,150,0,0.0,0,0,0.0,0,0,0.0,0,0,0.0,0,0,0,0,NO
17,src/java/main/org/apache/jute/Index.java,38,0,0.0,0,0,0.0,0,0,0.0,0,0,0.0,0,0,0,0,NO
17,src/java/main/org/apache/jute/InputArchive.java,43,0,0.0,0,0,0.0,0,0,0.0,0,0,0.0,0,0,0,0,NO
17,src/java/main/org/apache/jute/OutputArchive.java,47,0,0.0,0,0,0.0,0,0,0.0,0,0,0.0,0,0,0,0,NO
17,src/java/main/org/apache/jute/Record.java,32,0,0.0,0,0,0.0,0,0,0.0,0,0,0.0,0,0,0,0,NO
17,src/java/main/org/apache/jute/RecordReader.java,93,0,0.0,0,0,0.0,0,0,0.0,0,0,0.0,0,0,0,0,NO
17,src/java/main/org/apache/jute/RecordWriter.java,93,0,0.0,0,0,0.0,0,0,0.0,0,0,0.0,0,0,0,0,NO
17,src/java/main/org/apache/jute/Utils.java,282,0,0.0,0,0,0.0,0,0,0.0,0,0,0.0,0,0,0,0,NO
17,src/java/main/org/apache/jute/XmlInputArchive.java,251,0,0.0,0,0,0.0,0,0,0.0,0,0,0.0,0,0,0,0,NO
17,src/java/main/org/apache/jute/XmlOutputArchive.java,251,0,0.0,0,0,0.0,0,0,0.0,0,0,0.0,0,0,0,0,NO
17,src/java/main/org/apache/jute/compiler/CGenerator.java,130,0,0.0,0,0,0.0,0,0,0.0,0,0,0.0,0,0,0,0,NO
17,src/java/main/org/apache/jute/compiler/CSharpGenerator.java,53,0,0.0,0,0,0.0,0,0,0.0,0,0,0.0,0,0,0,0,NO
17,src/java/main/org/apache/jute/compiler/CppGenerator.java,125,0,0.0,0,0,0.0,0,0,0.0,0,0,0.0,0,0,0,0,NO
17,src/java/main/org/apache/jute/compiler/JBoolean.java,50,0,0.0,0,0,0.0,0,0,0.0,0,0,0.0,0,0,0,0,NO
17,src/java/main/org/apache/jute/compiler/JBuffer.java,106,0,0.0,0,0,0.0,0,0,0.0,0,0,0.0,0,0,0,0,NO
17,src/java/main/org/apache/jute/compiler/JByte.java,34,0,0.0,0,0,0.0,0,0,0.0,0,0,0.0,0,0,0,0,NO
17,src/java/main/org/apache/jute/compiler/JCompType.java,66,0,0.0,0,0,0.0,0,0,0.0,0,0,0.0,0,0,0,0,NO
17,src/java/main/org/apache/jute/compiler/JDouble.java,40,0,0.0,0,0,0.0,0,0,0.0,0,0,0.0,0,0,0,0,NO
17,src/java/main/org/apache/jute/compiler/JField.java,140,0,0.0,0,0,0.0,0,0,0.0,0,0,0.0,0,0,0,0,NO
17,src/java/main/org/apache/jute/compiler/JFile.java,84,0,0.0,0,0,0.0,0,0,0.0,0,0,0.0,0,0,0,0,NO
17,src/java/main/org/apache/jute/compiler/JFloat.java,39,0,0.0,0,0,0.0,0,0,0.0,0,0,0.0,0,0,0,0,NO
17,src/java/main/org/apache/jute/compiler/JInt.java,34,0,0.0,0,0,0.0,0,0,0.0,0,0,0.0,0,0,0,0,NO
17,src/java/main/org/apache/jute/compiler/JLong.java,38,0,0.0,0,0,0.0,0,0,0.0,0,0,0.0,0,0,0,0,NO
17,src/java/main/org/apache/jute/compiler/JMap.java,149,0,0.0,0,0,0.0,0,0,0.0,0,0,0.0,0,0,0,0,NO
17,src/java/main/org/apache/jute/compiler/JRecord.java,761,8,8.0,8,8,8.0,8,16,16.0,16,0,0.0,0,1,1,1,NO
17,src/java/main/org/apache/jute/compiler/JString.java,46,0,0.0,0,0,0.0,0,0,0.0,0,0,0.0,0,0,0,0,NO
17,src/java/main/org/apache/jute/compiler/JType.java,204,0,0.0,0,0,0.0,0,0,0.0,0,0,0.0,0,0,0,0,NO
17,src/java/main/org/apache/jute/compiler/JVector.java,153,0,0.0,0,0,0.0,0,0,0.0,0,0,0.0,0,0,0,0,NO
17,src/java/main/org/apache/jute/compiler/JavaGenerator.java,57,0,0.0,0,0,0.0,0,0,0.0,0,0,0.0,0,0,0,0,NO
17,src/java/main/org/apache/zookeeper/AsyncCallback.java,57,0,0.0,0,0,0.0,0,0,0.0,0,0,0.0,0,0,0,0,NO
17,src/java/main/org/apache/zookeeper/ClientCnxn.java,1309,7,7.0,7,3,3.0,3,10,10.0,10,4,4.0,4,1,0,1,YES
17,src/java/main/org/apache/zookeeper/ClientCnxnSocket.java,170,0,0.0,0,0,0.0,0,0,0.0,0,0,0.0,0,0,0,0,YES
17,src/java/main/org/apache/zookeeper/ClientCnxnSocketNIO.java,339,0,0.0,0,0,0.0,0,0,0.0,0,0,0.0,0,0,0,0,YES
17,src/java/main/org/apache/zookeeper/ClientWatchManager.java,40,0,0.0,0,0,0.0,0,0,0.0,0,0,0.0,0,0,0,0,NO
17,src/java/main/org/apache/zookeeper/CreateMode.java,90,0,0.0,0,0,0.0,0,0,0.0,0,0,0.0,0,0,0,0,YES
17,src/java/main/org/apache/zookeeper/Environment.java,100,0,0.0,0,0,0.0,0,0,0.0,0,0,0.0,0,0,0,0,NO
17,src/java/main/org/apache/zookeeper/JLineZNodeCompletor.java,84,0,0.0,0,0,0.0,0,0,0.0,0,0,0.0,0,0,0,0,NO
17,src/java/main/org/apache/zookeeper/KeeperException.java,702,0,0.0,0,0,0.0,0,0,0.0,0,0,0.0,0,0,0,0,NO
17,src/java/main/org/apache/zookeeper/Login.java,392,0,0.0,0,0,0.0,0,0,0.0,0,0,0.0,0,0,0,0,NO
17,src/java/main/org/apache/zookeeper/MultiResponse.java,165,0,0.0,0,0,0.0,0,0,0.0,0,0,0.0,0,0,0,0,NO
17,src/java/main/org/apache/zookeeper/MultiTransactionRecord.java,159,0,0.0,0,0,0.0,0,0,0.0,0,0,0.0,0,0,0,0,NO
17,src/java/main/org/apache/zookeeper/Op.java,332,0,0.0,0,0,0.0,0,0,0.0,0,0,0.0,0,0,0,0,YES
17,src/java/main/org/apache/zookeeper/OpResult.java,185,0,0.0,0,0,0.0,0,0,0.0,0,0,0.0,0,0,0,0,NO
17,src/java/main/org/apache/zookeeper/Quotas.java,68,0,0.0,0,0,0.0,0,0,0.0,0,0,0.0,0,0,0,0,NO
17,src/java/main/org/apache/zookeeper/ServerAdminClient.java,277,0,0.0,0,0,0.0,0,0,0.0,0,0,0.0,0,0,0,0,NO
17,src/java/main/org/apache/zookeeper/Shell.java,476,0,0.0,0,0,0.0,0,0,0.0,0,0,0.0,0,0,0,0,NO
17,src/java/main/org/apache/zookeeper/StatsTrack.java,101,0,0.0,0,0,0.0,0,0,0.0,0,0,0.0,0,0,0,0,NO
17,src/java/main/org/apache/zookeeper/Transaction.java,63,0,0.0,0,0,0.0,0,0,0.0,0,0,0.0,0,0,0,0,NO
17,src/java/main/org/apache/zookeeper/Version.java,79,0,0.0,0,0,0.0,0,0,0.0,0,0,0.0,0,0,0,0,NO
17,src/java/main/org/apache/zookeeper/WatchedEvent.java,79,0,0.0,0,0,0.0,0,0,0.0,0,0,0.0,0,0,0,0,NO
17,src/java/main/org/apache/zookeeper/Watcher.java,149,0,0.0,0,0,0.0,0,0,0.0,0,0,0.0,0,0,0,0,NO
17,src/java/main/org/apache/zookeeper/ZKUtil.java,124,0,0.0,0,0,0.0,0,0,0.0,0,0,0.0,0,0,0,0,NO
17,src/java/main/org/apache/zookeeper/ZooDefs.java,119,0,0.0,0,0,0.0,0,0,0.0,0,0,0.0,0,0,0,0,NO
17,src/java/main/org/apache/zookeeper/ZooKeeper.java,1779,0,0.0,0,0,0.0,0,0,0.0,0,0,0.0,0,0,0,0,YES
17,src/java/main/org/apache/zookeeper/ZooKeeperMain.java,670,0,0.0,0,0,0.0,0,0,0.0,0,0,0.0,0,0,0,0,YES
17,src/java/main/org/apache/zookeeper/cli/AclParser.java,81,0,0.0,0,0,0.0,0,0,0.0,0,0,0.0,0,0,0,0,NO
17,src/java/main/org/apache/zookeeper/cli/AddAuthCommand.java,64,0,0.0,0,0,0.0,0,0,0.0,0,0,0.0,0,0,0,0,NO
17,src/java/main/org/apache/zookeeper/cli/CliCommand.java,119,0,0.0,0,0,0.0,0,0,0.0,0,0,0.0,0,0,0,0,NO
17,src/java/main/org/apache/zookeeper/cli/CloseCommand.java,46,0,0.0,0,0,0.0,0,0,0.0,0,0,0.0,0,0,0,0,NO
17,src/java/main/org/apache/zookeeper/cli/CreateCommand.java,81,0,0.0,0,0,0.0,0,0,0.0,0,0,0.0,0,0,0,0,NO
17,src/java/main/org/apache/zookeeper/cli/DelQuotaCommand.java,152,0,0.0,0,0,0.0,0,0,0.0,0,0,0.0,0,0,0,0,NO
17,src/java/main/org/apache/zookeeper/cli/DeleteAllCommand.java,72,0,0.0,0,0,0.0,0,0,0.0,0,0,0.0,0,0,0,0,NO
17,src/java/main/org/apache/zookeeper/cli/DeleteCommand.java,88,0,0.0,0,0,0.0,0,0,0.0,0,0,0.0,0,0,0,0,NO
17,src/java/main/org/apache/zookeeper/cli/GetAclCommand.java,94,0,0.0,0,0,0.0,0,0,0.0,0,0,0.0,0,0,0,0,NO
17,src/java/main/org/apache/zookeeper/cli/GetCommand.java,83,0,0.0,0,0,0.0,0,0,0.0,0,0,0.0,0,0,0,0,NO
17,src/java/main/org/apache/zookeeper/cli/ListQuotaCommand.java,74,0,0.0,0,0,0.0,0,0,0.0,0,0,0.0,0,0,0,0,NO
17,src/java/main/org/apache/zookeeper/cli/Ls2Command.java,62,0,0.0,0,0,0.0,0,0,0.0,0,0,0.0,0,0,0,0,NO
17,src/java/main/org/apache/zookeeper/cli/LsCommand.java,85,0,0.0,0,0,0.0,0,0,0.0,0,0,0.0,0,0,0,0,NO
17,src/java/main/org/apache/zookeeper/cli/SetAclCommand.java,82,0,0.0,0,0,0.0,0,0,0.0,0,0,0.0,0,0,0,0,NO
17,src/java/main/org/apache/zookeeper/cli/SetCommand.java,75,0,0.0,0,0,0.0,0,0,0.0,0,0,0.0,0,0,0,0,NO
17,src/java/main/org/apache/zookeeper/cli/SetQuotaCommand.java,200,0,0.0,0,0,0.0,0,0,0.0,0,0,0.0,0,0,0,0,NO
17,src/java/main/org/apache/zookeeper/cli/StatCommand.java,81,0,0.0,0,0,0.0,0,0,0.0,0,0,0.0,0,0,0,0,NO
17,src/java/main/org/apache/zookeeper/cli/StatPrinter.java,49,0,0.0,0,0,0.0,0,0,0.0,0,0,0.0,0,0,0,0,NO
17,src/java/main/org/apache/zookeeper/cli/SyncCommand.java,64,0,0.0,0,0,0.0,0,0,0.0,0,0,0.0,0,0,0,0,NO
17,src/java/main/org/apache/zookeeper/client/ConnectStringParser.java,87,0,0.0,0,0,0.0,0,0,0.0,0,0,0.0,0,0,0,0,NO
17,src/java/main/org/apache/zookeeper/client/FourLetterWordMain.java,79,0,0.0,0,0,0.0,0,0,0.0,0,0,0.0,0,0,0,0,NO
17,src/java/main/org/apache/zookeeper/client/HostProvider.java,61,0,0.0,0,0,0.0,0,0,0.0,0,0,0.0,0,0,0,0,NO
17,src/java/main/org/apache/zookeeper/client/StaticHostProvider.java,101,0,0.0,0,0,0.0,0,0,0.0,0,0,0.0,0,0,0,0,NO
17,src/java/main/org/apache/zookeeper/client/ZooKeeperSaslClient.java,442,12,12.0,12,5,5.0,5,17,17.0,17,7,7.0,7,1,0,1,YES
17,src/java/main/org/apache/zookeeper/common/AtomicFileOutputStream.java,115,115,115.0,115,0,0.0,0,115,115.0,115,115,115.0,115,1,1,1,NO
17,src/java/main/org/apache/zookeeper/common/IOUtils.java,123,123,123.0,123,0,0.0,0,123,123.0,123,123,123.0,123,1,1,1,NO
17,src/java/main/org/apache/zookeeper/common/PathTrie.java,284,0,0.0,0,0,0.0,0,0,0.0,0,0,0.0,0,0,0,0,YES
17,src/java/main/org/apache/zookeeper/common/PathUtils.java,103,0,0.0,0,0,0.0,0,0,0.0,0,0,0.0,0,0,0,0,NO
17,src/java/main/org/apache/zookeeper/jmx/CommonNames.java,29,0,0.0,0,0,0.0,0,0,0.0,0,0,0.0,0,0,0,0,NO
17,src/java/main/org/apache/zookeeper/jmx/MBeanRegistry.java,215,0,0.0,0,0,0.0,0,0,0.0,0,0,0.0,0,0,0,0,NO
17,src/java/main/org/apache/zookeeper/jmx/ManagedUtil.java,71,0,0.0,0,0,0.0,0,0,0.0,0,0,0.0,0,0,0,0,NO
17,src/java/main/org/apache/zookeeper/jmx/ZKMBeanInfo.java,36,0,0.0,0,0,0.0,0,0,0.0,0,0,0.0,0,0,0,0,NO
17,src/java/main/org/apache/zookeeper/server/ByteBufferInputStream.java,82,0,0.0,0,0,0.0,0,0,0.0,0,0,0.0,0,0,0,0,NO
17,src/java/main/org/apache/zookeeper/server/ByteBufferOutputStream.java,51,0,0.0,0,0,0.0,0,0,0.0,0,0,0.0,0,0,0,0,NO
17,src/java/main/org/apache/zookeeper/server/ConnectionBean.java,173,0,0.0,0,0,0.0,0,0,0.0,0,0,0.0,0,0,0,0,NO
17,src/java/main/org/apache/zookeeper/server/ConnectionMXBean.java,98,0,0.0,0,0,0.0,0,0,0.0,0,0,0.0,0,0,0,0,NO
17,src/java/main/org/apache/zookeeper/server/DataNode.java,174,0,0.0,0,0,0.0,0,0,0.0,0,0,0.0,0,0,0,0,NO
17,src/java/main/org/apache/zookeeper/server/DataTree.java,1302,0,0.0,0,0,0.0,0,0,0.0,0,0,0.0,0,0,0,0,YES
17,src/java/main/org/apache/zookeeper/server/DataTreeBean.java,61,0,0.0,0,0,0.0,0,0,0.0,0,0,0.0,0,0,0,0,NO
17,src/java/main/org/apache/zookeeper/server/DataTreeMXBean.java,47,0,0.0,0,0,0.0,0,0,0.0,0,0,0.0,0,0,0,0,NO
17,src/java/main/org/apache/zookeeper/server/DatadirCleanupManager.java,192,0,0.0,0,0,0.0,0,0,0.0,0,0,0.0,0,0,0,0,NO
17,src/java/main/org/apache/zookeeper/server/FinalRequestProcessor.java,414,0,0.0,0,0,0.0,0,0,0.0,0,0,0.0,0,0,0,0,NO
17,src/java/main/org/apache/zookeeper/server/LogFormatter.java,104,0,0.0,0,0,0.0,0,0,0.0,0,0,0.0,0,0,0,0,NO
17,src/java/main/org/apache/zookeeper/server/NIOServerCnxn.java,1157,0,0.0,0,0,0.0,0,0,0.0,0,0,0.0,0,0,0,0,YES
17,src/java/main/org/apache/zookeeper/server/NIOServerCnxnFactory.java,323,0,0.0,0,0,0.0,0,0,0.0,0,0,0.0,0,0,0,0,NO
17,src/java/main/org/apache/zookeeper/server/NettyServerCnxn.java,852,0,0.0,0,0,0.0,0,0,0.0,0,0,0.0,0,0,0,0,YES
17,src/java/main/org/apache/zookeeper/server/NettyServerCnxnFactory.java,414,0,0.0,0,0,0.0,0,0,0.0,0,0,0.0,0,0,0,0,NO
17,src/java/main/org/apache/zookeeper/server/ObserverBean.java,45,0,0.0,0,0,0.0,0,0,0.0,0,0,0.0,0,0,0,0,NO
17,src/java/main/org/apache/zookeeper/server/PrepRequestProcessor.java,738,13,13.0,13,0,0.0,0,13,13.0,13,13,13.0,13,1,0,1,NO
17,src/java/main/org/apache/zookeeper/server/PurgeTxnLog.java,129,0,0.0,0,0,0.0,0,0,0.0,0,0,0.0,0,0,0,0,NO
17,src/java/main/org/apache/zookeeper/server/Request.java,256,0,0.0,0,0,0.0,0,0,0.0,0,0,0.0,0,0,0,0,NO
17,src/java/main/org/apache/zookeeper/server/RequestProcessor.java,44,0,0.0,0,0,0.0,0,0,0.0,0,0,0.0,0,0,0,0,NO
17,src/java/main/org/apache/zookeeper/server/ServerCnxn.java,452,0,0.0,0,0,0.0,0,0,0.0,0,0,0.0,0,0,0,0,NO
17,src/java/main/org/apache/zookeeper/server/ServerCnxnFactory.java,149,0,0.0,0,0,0.0,0,0,0.0,0,0,0.0,0,0,0,0,NO
17,src/java/main/org/apache/zookeeper/server/ServerConfig.java,112,0,0.0,0,0,0.0,0,0,0.0,0,0,0.0,0,0,0,0,NO
17,src/java/main/org/apache/zookeeper/server/ServerStats.java,140,0,0.0,0,0,0.0,0,0,0.0,0,0,0.0,0,0,0,0,NO
17,src/java/main/org/apache/zookeeper/server/SessionTracker.java,81,0,0.0,0,0,0.0,0,0,0.0,0,0,0.0,0,0,0,0,NO
17,src/java/main/org/apache/zookeeper/server/SessionTrackerImpl.java,274,0,0.0,0,0,0.0,0,0,0.0,0,0,0.0,0,0,0,0,YES
17,src/java/main/org/apache/zookeeper/server/SnapshotFormatter.java,124,0,0.0,0,0,0.0,0,0,0.0,0,0,0.0,0,0,0,0,NO
17,src/java/main/org/apache/zookeeper/server/Stats.java,68,0,0.0,0,0,0.0,0,0,0.0,0,0,0.0,0,0,0,0,NO
17,src/java/main/org/apache/zookeeper/server/SyncRequestProcessor.java,192,0,0.0,0,0,0.0,0,0,0.0,0,0,0.0,0,0,0,0,NO
17,src/java/main/org/apache/zookeeper/server/TraceFormatter.java,123,0,0.0,0,0,0.0,0,0,0.0,0,0,0.0,0,0,0,0,NO
17,src/java/main/org/apache/zookeeper/server/WatchManager.java,171,0,0.0,0,0,0.0,0,0,0.0,0,0,0.0,0,0,0,0,NO
17,src/java/main/org/apache/zookeeper/server/ZKDatabase.java,490,11,11.0,11,4,4.0,4,15,15.0,15,7,7.0,7,1,1,1,NO
17,src/java/main/org/apache/zookeeper/server/ZooKeeperSaslServer.java,127,0,0.0,0,0,0.0,0,0,0.0,0,0,0.0,0,0,0,0,NO
17,src/java/main/org/apache/zookeeper/server/ZooKeeperServer.java,961,0,0.0,0,0,0.0,0,0,0.0,0,0,0.0,0,0,0,0,YES
17,src/java/main/org/apache/zookeeper/server/ZooKeeperServerBean.java,147,0,0.0,0,0,0.0,0,0,0.0,0,0,0.0,0,0,0,0,NO
17,src/java/main/org/apache/zookeeper/server/ZooKeeperServerMXBean.java,110,0,0.0,0,0,0.0,0,0,0.0,0,0,0.0,0,0,0,0,NO
17,src/java/main/org/apache/zookeeper/server/ZooKeeperServerMain.java,128,0,0.0,0,0,0.0,0,0,0.0,0,0,0.0,0,0,0,0,NO
17,src/java/main/org/apache/zookeeper/server/ZooTrace.java,93,0,0.0,0,0,0.0,0,0,0.0,0,0,0.0,0,0,0,0,NO
17,src/java/main/org/apache/zookeeper/server/auth/AuthenticationProvider.java,82,0,0.0,0,0,0.0,0,0,0.0,0,0,0.0,0,0,0,0,NO
17,src/java/main/org/apache/zookeeper/server/auth/DigestAuthenticationProvider.java,139,0,0.0,0,0,0.0,0,0,0.0,0,0,0.0,0,0,0,0,NO
17,src/java/main/org/apache/zookeeper/server/auth/DigestLoginModule.java,59,0,0.0,0,0,0.0,0,0,0.0,0,0,0.0,0,0,0,0,NO
17,src/java/main/org/apache/zookeeper/server/auth/IPAuthenticationProvider.java,117,0,0.0,0,0,0.0,0,0,0.0,0,0,0.0,0,0,0,0,NO
17,src/java/main/org/apache/zookeeper/server/auth/KerberosName.java,418,6,6.0,6,6,6.0,6,12,12.0,12,0,0.0,0,1,0,1,NO
17,src/java/main/org/apache/zookeeper/server/auth/ProviderRegistry.java,77,0,0.0,0,0,0.0,0,0,0.0,0,0,0.0,0,0,0,0,NO
17,src/java/main/org/apache/zookeeper/server/auth/SASLAuthenticationProvider.java,70,0,0.0,0,0,0.0,0,0,0.0,0,0,0.0,0,0,0,0,NO
17,src/java/main/org/apache/zookeeper/server/auth/SaslServerCallbackHandler.java,148,0,0.0,0,0,0.0,0,0,0.0,0,0,0.0,0,0,0,0,NO
17,src/java/main/org/apache/zookeeper/server/persistence/FileSnap.java,250,0,0.0,0,0,0.0,0,0,0.0,0,0,0.0,0,0,0,0,NO
17,src/java/main/org/apache/zookeeper/server/persistence/FileTxnLog.java,661,0,0.0,0,0,0.0,0,0,0.0,0,0,0.0,0,0,0,0,NO
17,src/java/main/org/apache/zookeeper/server/persistence/FileTxnSnapLog.java,381,22,22.0,22,6,6.0,6,28,28.0,28,16,16.0,16,1,1,1,YES
17,src/java/main/org/apache/zookeeper/server/persistence/SnapShot.java,66,0,0.0,0,0,0.0,0,0,0.0,0,0,0.0,0,0,0,0,NO
17,src/java/main/org/apache/zookeeper/server/persistence/TxnLog.java,120,0,0.0,0,0,0.0,0,0,0.0,0,0,0.0,0,0,0,0,NO
17,src/java/main/org/apache/zookeeper/server/persistence/Util.java,326,0,0.0,0,0,0.0,0,0,0.0,0,0,0.0,0,0,0,0,NO
17,src/java/main/org/apache/zookeeper/server/quorum/AckRequestProcessor.java,54,0,0.0,0,0,0.0,0,0,0.0,0,0,0.0,0,0,0,0,NO
17,src/java/main/org/apache/zookeeper/server/quorum/AuthFastLeaderElection.java,972,0,0.0,0,0,0.0,0,0,0.0,0,0,0.0,0,0,0,0,NO
17,src/java/main/org/apache/zookeeper/server/quorum/CommitProcessor.java,185,0,0.0,0,0,0.0,0,0,0.0,0,0,0.0,0,0,0,0,NO
17,src/java/main/org/apache/zookeeper/server/quorum/Election.java,27,0,0.0,0,0,0.0,0,0,0.0,0,0,0.0,0,0,0,0,NO
17,src/java/main/org/apache/zookeeper/server/quorum/FastLeaderElection.java,901,14,7.0,14,6,3.0,6,20,10.0,20,8,4.0,8,2,1,2,NO
17,src/java/main/org/apache/zookeeper/server/quorum/Follower.java,167,0,0.0,0,0,0.0,0,0,0.0,0,0,0.0,0,0,0,0,NO
17,src/java/main/org/apache/zookeeper/server/quorum/FollowerBean.java,50,0,0.0,0,0,0.0,0,0,0.0,0,0,0.0,0,0,0,0,NO
17,src/java/main/org/apache/zookeeper/server/quorum/FollowerMXBean.java,41,0,0.0,0,0,0.0,0,0,0.0,0,0,0.0,0,0,0,0,NO
17,src/java/main/org/apache/zookeeper/server/quorum/FollowerRequestProcessor.java,113,0,0.0,0,0,0.0,0,0,0.0,0,0,0.0,0,0,0,0,NO
17,src/java/main/org/apache/zookeeper/server/quorum/FollowerZooKeeperServer.java,160,0,0.0,0,0,0.0,0,0,0.0,0,0,0.0,0,0,0,0,NO
17,src/java/main/org/apache/zookeeper/server/quorum/Leader.java,958,58,19.333334,58,4,1.3333334,4,62,20.666666,62,54,18.0,54,3,2,3,YES
17,src/java/main/org/apache/zookeeper/server/quorum/LeaderBean.java,53,0,0.0,0,0,0.0,0,0,0.0,0,0,0.0,0,0,0,0,NO
17,src/java/main/org/apache/zookeeper/server/quorum/LeaderElection.java,293,0,0.0,0,0,0.0,0,0,0.0,0,0,0.0,0,0,0,0,NO
17,src/java/main/org/apache/zookeeper/server/quorum/LeaderElectionBean.java,42,0,0.0,0,0,0.0,0,0,0.0,0,0,0.0,0,0,0,0,NO
17,src/java/main/org/apache/zookeeper/server/quorum/LeaderElectionMXBean.java,31,0,0.0,0,0,0.0,0,0,0.0,0,0,0.0,0,0,0,0,NO
17,src/java/main/org/apache/zookeeper/server/quorum/LeaderMXBean.java,36,0,0.0,0,0,0.0,0,0,0.0,0,0,0.0,0,0,0,0,NO
17,src/java/main/org/apache/zookeeper/server/quorum/LeaderZooKeeperServer.java,177,0,0.0,0,0,0.0,0,0,0.0,0,0,0.0,0,0,0,0,NO
17,src/java/main/org/apache/zookeeper/server/quorum/Learner.java,482,0,0.0,0,0,0.0,0,0,0.0,0,0,0.0,0,0,0,0,YES
17,src/java/main/org/apache/zookeeper/server/quorum/LearnerHandler.java,629,26,8.666667,26,19,6.3333335,19,45,15.0,45,7,2.3333333,7,3,2,3,YES
17,src/java/main/org/apache/zookeeper/server/quorum/LearnerSessionTracker.java,96,0,0.0,0,0,0.0,0,0,0.0,0,0,0.0,0,0,0,0,NO
17,src/java/main/org/apache/zookeeper/server/quorum/LearnerSyncRequest.java,34,0,0.0,0,0,0.0,0,0,0.0,0,0,0.0,0,0,0,0,NO
17,src/java/main/org/apache/zookeeper/server/quorum/LearnerZooKeeperServer.java,144,0,0.0,0,0,0.0,0,0,0.0,0,0,0.0,0,0,0,0,NO
17,src/java/main/org/apache/zookeeper/server/quorum/LocalPeerBean.java,79,0,0.0,0,0,0.0,0,0,0.0,0,0,0.0,0,0,0,0,NO
17,src/java/main/org/apache/zookeeper/server/quorum/LocalPeerMXBean.java,77,0,0.0,0,0,0.0,0,0,0.0,0,0,0.0,0,0,0,0,NO
17,src/java/main/org/apache/zookeeper/server/quorum/Observer.java,134,0,0.0,0,0,0.0,0,0,0.0,0,0,0.0,0,0,0,0,NO
17,src/java/main/org/apache/zookeeper/server/quorum/ObserverMXBean.java,37,0,0.0,0,0,0.0,0,0,0.0,0,0,0.0,0,0,0,0,NO
17,src/java/main/org/apache/zookeeper/server/quorum/ObserverRequestProcessor.java,127,0,0.0,0,0,0.0,0,0,0.0,0,0,0.0,0,0,0,0,NO
17,src/java/main/org/apache/zookeeper/server/quorum/ObserverZooKeeperServer.java,115,0,0.0,0,0,0.0,0,0,0.0,0,0,0.0,0,0,0,0,NO
17,src/java/main/org/apache/zookeeper/server/quorum/ProposalRequestProcessor.java,93,0,0.0,0,0,0.0,0,0,0.0,0,0,0.0,0,0,0,0,NO
17,src/java/main/org/apache/zookeeper/server/quorum/QuorumBean.java,44,0,0.0,0,0,0.0,0,0,0.0,0,0,0.0,0,0,0,0,NO
17,src/java/main/org/apache/zookeeper/server/quorum/QuorumCnxManager.java,884,20,6.6666665,20,20,6.6666665,20,40,13.333333,40,4,1.3333334,4,3,2,3,NO
17,src/java/main/org/apache/zookeeper/server/quorum/QuorumMXBean.java,34,0,0.0,0,0,0.0,0,0,0.0,0,0,0.0,0,0,0,0,NO
17,src/java/main/org/apache/zookeeper/server/quorum/QuorumPeer.java,1343,265,132.5,265,45,22.5,45,310,155.0,310,220,110.0,220,2,1,2,YES
17,src/java/main/org/apache/zookeeper/server/quorum/QuorumPeerConfig.java,511,237,237.0,237,137,137.0,137,374,374.0,374,100,100.0,100,1,0,1,NO
17,src/java/main/org/apache/zookeeper/server/quorum/QuorumPeerMain.java,164,10,10.0,10,8,8.0,8,18,18.0,18,2,2.0,2,1,0,1,NO
17,src/java/main/org/apache/zookeeper/server/quorum/QuorumStats.java,68,0,0.0,0,0,0.0,0,0,0.0,0,0,0.0,0,0,0,0,NO
17,src/java/main/org/apache/zookeeper/server/quorum/QuorumZooKeeperServer.java,58,2,2.0,2,3,3.0,3,5,5.0,5,1,1.0,1,1,0,1,NO
17,src/java/main/org/apache/zookeeper/server/quorum/ReadOnlyBean.java,38,0,0.0,0,0,0.0,0,0,0.0,0,0,0.0,0,0,0,0,NO
17,src/java/main/org/apache/zookeeper/server/quorum/ReadOnlyRequestProcessor.java,129,0,0.0,0,0,0.0,0,0,0.0,0,0,0.0,0,0,0,0,NO
17,src/java/main/org/apache/zookeeper/server/quorum/ReadOnlyZooKeeperServer.java,144,0,0.0,0,0,0.0,0,0,0.0,0,0,0.0,0,0,0,0,NO
17,src/java/main/org/apache/zookeeper/server/quorum/RemotePeerBean.java,45,0,0.0,0,0,0.0,0,0,0.0,0,0,0.0,0,0,0,0,NO
17,src/java/main/org/apache/zookeeper/server/quorum/RemotePeerMXBean.java,33,0,0.0,0,0,0.0,0,0,0.0,0,0,0.0,0,0,0,0,NO
17,src/java/main/org/apache/zookeeper/server/quorum/SendAckRequestProcessor.java,80,0,0.0,0,0,0.0,0,0,0.0,0,0,0.0,0,0,0,0,NO
17,src/java/main/org/apache/zookeeper/server/quorum/ServerBean.java,38,0,0.0,0,0,0.0,0,0,0.0,0,0,0.0,0,0,0,0,NO
17,src/java/main/org/apache/zookeeper/server/quorum/ServerMXBean.java,33,0,0.0,0,0,0.0,0,0,0.0,0,0,0.0,0,0,0,0,NO
17,src/java/main/org/apache/zookeeper/server/quorum/StateSummary.java,57,0,0.0,0,0,0.0,0,0,0.0,0,0,0.0,0,0,0,0,NO
17,src/java/main/org/apache/zookeeper/server/quorum/Vote.java,106,0,0.0,0,0,0.0,0,0,0.0,0,0,0.0,0,0,0,0,NO
17,src/java/main/org/apache/zookeeper/server/quorum/flexible/QuorumHierarchical.java,374,151,151.0,151,48,48.0,48,199,199.0,199,103,103.0,103,1,0,1,NO
17,src/java/main/org/apache/zookeeper/server/quorum/flexible/QuorumMaj.java,153,115,115.0,115,19,19.0,19,134,134.0,134,96,96.0,96,1,0,1,NO
17,src/java/main/org/apache/zookeeper/server/quorum/flexible/QuorumVerifier.java,42,11,11.0,11,2,2.0,2,13,13.0,13,9,9.0,9,1,0,1,NO
17,src/java/main/org/apache/zookeeper/server/util/KerberosUtil.java,45,45,45.0,45,0,0.0,0,45,45.0,45,45,45.0,45,1,0,1,NO
17,src/java/main/org/apache/zookeeper/server/util/SerializeUtils.java,141,0,0.0,0,0,0.0,0,0,0.0,0,0,0.0,0,0,0,0,NO
17,src/java/main/org/apache/zookeeper/server/util/VerifyingFileFactory.java,82,0,0.0,0,0,0.0,0,0,0.0,0,0,0.0,0,0,0,0,NO
17,src/java/main/org/apache/zookeeper/server/util/ZxidUtils.java,34,0,0.0,0,0,0.0,0,0,0.0,0,0,0.0,0,0,0,0,NO
17,src/java/main/org/apache/zookeeper/version/util/VerGen.java,177,0,0.0,0,0,0.0,0,0,0.0,0,0,0.0,0,0,0,0,NO
17,src/recipes/election/src/java/org/apache/zookeeper/recipes/leader/LeaderElectionAware.java,37,0,0.0,0,0,0.0,0,0,0.0,0,0,0.0,0,0,0,0,NO
17,src/recipes/election/src/java/org/apache/zookeeper/recipes/leader/LeaderElectionSupport.java,461,0,0.0,0,0,0.0,0,0,0.0,0,0,0.0,0,0,0,0,NO
17,src/recipes/election/src/java/org/apache/zookeeper/recipes/leader/LeaderOffer.java,84,0,0.0,0,0,0.0,0,0,0.0,0,0,0.0,0,0,0,0,NO
17,src/recipes/lock/src/java/org/apache/zookeeper/recipes/lock/LockListener.java,38,0,0.0,0,0,0.0,0,0,0.0,0,0,0.0,0,0,0,0,NO
17,src/recipes/lock/src/java/org/apache/zookeeper/recipes/lock/ProtocolSupport.java,193,0,0.0,0,0,0.0,0,0,0.0,0,0,0.0,0,0,0,0,NO
17,src/recipes/lock/src/java/org/apache/zookeeper/recipes/lock/WriteLock.java,295,0,0.0,0,0,0.0,0,0,0.0,0,0,0.0,0,0,0,0,NO
17,src/recipes/lock/src/java/org/apache/zookeeper/recipes/lock/ZNodeName.java,110,0,0.0,0,0,0.0,0,0,0.0,0,0,0.0,0,0,0,0,NO
17,src/recipes/lock/src/java/org/apache/zookeeper/recipes/lock/ZooKeeperOperation.java,38,0,0.0,0,0,0.0,0,0,0.0,0,0,0.0,0,0,0,0,NO
17,src/recipes/queue/src/java/org/apache/zookeeper/recipes/queue/DistributedQueue.java,313,0,0.0,0,0,0.0,0,0,0.0,0,0,0.0,0,0,0,0,NO
18,src/contrib/fatjar/src/java/org/apache/zookeeper/util/FatJarMain.java,126,0,0.0,0,0,0.0,0,0,0.0,0,0,0.0,0,0,0,0,NO
18,src/contrib/loggraph/src/java/org/apache/zookeeper/graph/FilterException.java,22,0,0.0,0,0,0.0,0,0,0.0,0,0,0.0,0,0,0,0,NO
18,src/contrib/loggraph/src/java/org/apache/zookeeper/graph/FilterOp.java,75,0,0.0,0,0,0.0,0,0,0.0,0,0,0.0,0,0,0,0,NO
18,src/contrib/loggraph/src/java/org/apache/zookeeper/graph/FilterParser.java,131,0,0.0,0,0,0.0,0,0,0.0,0,0,0.0,0,0,0,0,NO
18,src/contrib/loggraph/src/java/org/apache/zookeeper/graph/JsonGenerator.java,223,0,0.0,0,0,0.0,0,0,0.0,0,0,0.0,0,0,0,0,NO
18,src/contrib/loggraph/src/java/org/apache/zookeeper/graph/Log4JEntry.java,40,0,0.0,0,0,0.0,0,0,0.0,0,0,0.0,0,0,0,0,NO
18,src/contrib/loggraph/src/java/org/apache/zookeeper/graph/Log4JSource.java,381,0,0.0,0,0,0.0,0,0,0.0,0,0,0.0,0,0,0,0,NO
18,src/contrib/loggraph/src/java/org/apache/zookeeper/graph/LogEntry.java,46,0,0.0,0,0,0.0,0,0,0.0,0,0,0.0,0,0,0,0,NO
18,src/contrib/loggraph/src/java/org/apache/zookeeper/graph/LogIterator.java,26,0,0.0,0,0,0.0,0,0,0.0,0,0,0.0,0,0,0,0,NO
18,src/contrib/loggraph/src/java/org/apache/zookeeper/graph/LogServer.java,66,0,0.0,0,0,0.0,0,0,0.0,0,0,0.0,0,0,0,0,NO
18,src/contrib/loggraph/src/java/org/apache/zookeeper/graph/LogSkipList.java,95,0,0.0,0,0,0.0,0,0,0.0,0,0,0.0,0,0,0,0,NO
18,src/contrib/loggraph/src/java/org/apache/zookeeper/graph/LogSource.java,33,0,0.0,0,0,0.0,0,0,0.0,0,0,0.0,0,0,0,0,NO
18,src/contrib/loggraph/src/java/org/apache/zookeeper/graph/MeasureThroughput.java,103,0,0.0,0,0,0.0,0,0,0.0,0,0,0.0,0,0,0,0,NO
18,src/contrib/loggraph/src/java/org/apache/zookeeper/graph/MergedLogSource.java,219,0,0.0,0,0,0.0,0,0,0.0,0,0,0.0,0,0,0,0,NO
18,src/contrib/loggraph/src/java/org/apache/zookeeper/graph/RandomAccessFileReader.java,328,0,0.0,0,0,0.0,0,0,0.0,0,0,0.0,0,0,0,0,NO
18,src/contrib/loggraph/src/java/org/apache/zookeeper/graph/TransactionEntry.java,59,0,0.0,0,0,0.0,0,0,0.0,0,0,0.0,0,0,0,0,NO
18,src/contrib/loggraph/src/java/org/apache/zookeeper/graph/TxnLogSource.java,376,0,0.0,0,0,0.0,0,0,0.0,0,0,0.0,0,0,0,0,NO
18,src/contrib/loggraph/src/java/org/apache/zookeeper/graph/filterops/AndOp.java,33,0,0.0,0,0,0.0,0,0,0.0,0,0,0.0,0,0,0,0,NO
18,src/contrib/loggraph/src/java/org/apache/zookeeper/graph/filterops/Arg.java,36,0,0.0,0,0,0.0,0,0,0.0,0,0,0.0,0,0,0,0,NO
18,src/contrib/loggraph/src/java/org/apache/zookeeper/graph/filterops/EqualsOp.java,44,0,0.0,0,0,0.0,0,0,0.0,0,0,0.0,0,0,0,0,NO
18,src/contrib/loggraph/src/java/org/apache/zookeeper/graph/filterops/GreaterThanOp.java,70,0,0.0,0,0,0.0,0,0,0.0,0,0,0.0,0,0,0,0,NO
18,src/contrib/loggraph/src/java/org/apache/zookeeper/graph/filterops/LessThanOp.java,69,0,0.0,0,0,0.0,0,0,0.0,0,0,0.0,0,0,0,0,NO
18,src/contrib/loggraph/src/java/org/apache/zookeeper/graph/filterops/NotOp.java,31,0,0.0,0,0,0.0,0,0,0.0,0,0,0.0,0,0,0,0,NO
18,src/contrib/loggraph/src/java/org/apache/zookeeper/graph/filterops/NumberArg.java,27,0,0.0,0,0,0.0,0,0,0.0,0,0,0.0,0,0,0,0,NO
18,src/contrib/loggraph/src/java/org/apache/zookeeper/graph/filterops/OrOp.java,33,0,0.0,0,0,0.0,0,0,0.0,0,0,0.0,0,0,0,0,NO
18,src/contrib/loggraph/src/java/org/apache/zookeeper/graph/filterops/StringArg.java,27,0,0.0,0,0,0.0,0,0,0.0,0,0,0.0,0,0,0,0,NO
18,src/contrib/loggraph/src/java/org/apache/zookeeper/graph/filterops/SymbolArg.java,27,0,0.0,0,0,0.0,0,0,0.0,0,0,0.0,0,0,0,0,NO
18,src/contrib/loggraph/src/java/org/apache/zookeeper/graph/filterops/XorOp.java,40,0,0.0,0,0,0.0,0,0,0.0,0,0,0.0,0,0,0,0,NO
18,src/contrib/loggraph/src/java/org/apache/zookeeper/graph/servlets/FileLoader.java,60,0,0.0,0,0,0.0,0,0,0.0,0,0,0.0,0,0,0,0,NO
18,src/contrib/loggraph/src/java/org/apache/zookeeper/graph/servlets/Fs.java,69,0,0.0,0,0,0.0,0,0,0.0,0,0,0.0,0,0,0,0,NO
18,src/contrib/loggraph/src/java/org/apache/zookeeper/graph/servlets/GraphData.java,85,0,0.0,0,0,0.0,0,0,0.0,0,0,0.0,0,0,0,0,NO
18,src/contrib/loggraph/src/java/org/apache/zookeeper/graph/servlets/JsonServlet.java,85,0,0.0,0,0,0.0,0,0,0.0,0,0,0.0,0,0,0,0,NO
18,src/contrib/loggraph/src/java/org/apache/zookeeper/graph/servlets/NumEvents.java,86,0,0.0,0,0,0.0,0,0,0.0,0,0,0.0,0,0,0,0,NO
18,src/contrib/loggraph/src/java/org/apache/zookeeper/graph/servlets/StaticContent.java,50,0,0.0,0,0,0.0,0,0,0.0,0,0,0.0,0,0,0,0,NO
18,src/contrib/loggraph/src/java/org/apache/zookeeper/graph/servlets/Throughput.java,125,0,0.0,0,0,0.0,0,0,0.0,0,0,0.0,0,0,0,0,NO
18,src/contrib/rest/src/java/org/apache/zookeeper/server/jersey/RestMain.java,151,0,0.0,0,0,0.0,0,0,0.0,0,0,0.0,0,0,0,0,NO
18,src/contrib/rest/src/java/org/apache/zookeeper/server/jersey/ZooKeeperService.java,242,0,0.0,0,0,0.0,0,0,0.0,0,0,0.0,0,0,0,0,NO
18,src/contrib/rest/src/java/org/apache/zookeeper/server/jersey/cfg/Credentials.java,47,0,0.0,0,0,0.0,0,0,0.0,0,0,0.0,0,0,0,0,NO
18,src/contrib/rest/src/java/org/apache/zookeeper/server/jersey/cfg/Endpoint.java,72,0,0.0,0,0,0.0,0,0,0.0,0,0,0.0,0,0,0,0,NO
18,src/contrib/rest/src/java/org/apache/zookeeper/server/jersey/cfg/HostPort.java,51,0,0.0,0,0,0.0,0,0,0.0,0,0,0.0,0,0,0,0,NO
18,src/contrib/rest/src/java/org/apache/zookeeper/server/jersey/cfg/HostPortSet.java,51,0,0.0,0,0,0.0,0,0,0.0,0,0,0.0,0,0,0,0,NO
18,src/contrib/rest/src/java/org/apache/zookeeper/server/jersey/cfg/RestCfg.java,106,0,0.0,0,0,0.0,0,0,0.0,0,0,0.0,0,0,0,0,NO
18,src/contrib/rest/src/java/org/apache/zookeeper/server/jersey/filters/HTTPBasicAuth.java,87,0,0.0,0,0,0.0,0,0,0.0,0,0,0.0,0,0,0,0,NO
18,src/contrib/rest/src/java/org/apache/zookeeper/server/jersey/jaxb/ZChildren.java,80,0,0.0,0,0,0.0,0,0,0.0,0,0,0.0,0,0,0,0,NO
18,src/contrib/rest/src/java/org/apache/zookeeper/server/jersey/jaxb/ZChildrenJSON.java,76,0,0.0,0,0,0.0,0,0,0.0,0,0,0.0,0,0,0,0,NO
18,src/contrib/rest/src/java/org/apache/zookeeper/server/jersey/jaxb/ZError.java,41,0,0.0,0,0,0.0,0,0,0.0,0,0,0.0,0,0,0,0,NO
18,src/contrib/rest/src/java/org/apache/zookeeper/server/jersey/jaxb/ZPath.java,63,0,0.0,0,0,0.0,0,0,0.0,0,0,0.0,0,0,0,0,NO
18,src/contrib/rest/src/java/org/apache/zookeeper/server/jersey/jaxb/ZSession.java,55,0,0.0,0,0,0.0,0,0,0.0,0,0,0.0,0,0,0,0,NO
18,src/contrib/rest/src/java/org/apache/zookeeper/server/jersey/jaxb/ZStat.java,106,0,0.0,0,0,0.0,0,0,0.0,0,0,0.0,0,0,0,0,NO
18,src/contrib/rest/src/java/org/apache/zookeeper/server/jersey/resources/JAXBContextResolver.java,72,0,0.0,0,0,0.0,0,0,0.0,0,0,0.0,0,0,0,0,NO
18,src/contrib/rest/src/java/org/apache/zookeeper/server/jersey/resources/KeeperExceptionMapper.java,86,0,0.0,0,0,0.0,0,0,0.0,0,0,0.0,0,0,0,0,NO
18,src/contrib/rest/src/java/org/apache/zookeeper/server/jersey/resources/RuntimeExceptionMapper.java,55,0,0.0,0,0,0.0,0,0,0.0,0,0,0.0,0,0,0,0,NO
18,src/contrib/rest/src/java/org/apache/zookeeper/server/jersey/resources/SessionsResource.java,135,0,0.0,0,0,0.0,0,0,0.0,0,0,0.0,0,0,0,0,NO
18,src/contrib/rest/src/java/org/apache/zookeeper/server/jersey/resources/ZErrorWriter.java,63,0,0.0,0,0,0.0,0,0,0.0,0,0,0.0,0,0,0,0,NO
18,src/contrib/rest/src/java/org/apache/zookeeper/server/jersey/resources/ZNodeResource.java,412,0,0.0,0,0,0.0,0,0,0.0,0,0,0.0,0,0,0,0,NO
18,src/contrib/zooinspector/src/java/com/nitido/utils/toaster/Toaster.java,533,0,0.0,0,0,0.0,0,0,0.0,0,0,0.0,0,0,0,0,NO
18,src/contrib/zooinspector/src/java/org/apache/zookeeper/inspector/ZooInspector.java,67,0,0.0,0,0,0.0,0,0,0.0,0,0,0.0,0,0,0,0,NO
18,src/contrib/zooinspector/src/java/org/apache/zookeeper/inspector/encryption/BasicDataEncryptionManager.java,50,0,0.0,0,0,0.0,0,0,0.0,0,0,0.0,0,0,0,0,NO
18,src/contrib/zooinspector/src/java/org/apache/zookeeper/inspector/encryption/DataEncryptionManager.java,39,0,0.0,0,0,0.0,0,0,0.0,0,0,0.0,0,0,0,0,NO
18,src/contrib/zooinspector/src/java/org/apache/zookeeper/inspector/gui/IconResource.java,88,0,0.0,0,0,0.0,0,0,0.0,0,0,0.0,0,0,0,0,NO
18,src/contrib/zooinspector/src/java/org/apache/zookeeper/inspector/gui/NodeViewersChangeListener.java,37,0,0.0,0,0,0.0,0,0,0.0,0,0,0.0,0,0,0,0,NO
18,src/contrib/zooinspector/src/java/org/apache/zookeeper/inspector/gui/Toolbar.java,74,0,0.0,0,0,0.0,0,0,0.0,0,0,0.0,0,0,0,0,NO
18,src/contrib/zooinspector/src/java/org/apache/zookeeper/inspector/gui/ZooInspectorAboutDialog.java,79,0,0.0,0,0,0.0,0,0,0.0,0,0,0.0,0,0,0,0,NO
18,src/contrib/zooinspector/src/java/org/apache/zookeeper/inspector/gui/ZooInspectorConnectionPropertiesDialog.java,321,0,0.0,0,0,0.0,0,0,0.0,0,0,0.0,0,0,0,0,NO
18,src/contrib/zooinspector/src/java/org/apache/zookeeper/inspector/gui/ZooInspectorNodeViewersDialog.java,631,0,0.0,0,0,0.0,0,0,0.0,0,0,0.0,0,0,0,0,NO
18,src/contrib/zooinspector/src/java/org/apache/zookeeper/inspector/gui/ZooInspectorNodeViewersPanel.java,140,0,0.0,0,0,0.0,0,0,0.0,0,0,0.0,0,0,0,0,NO
18,src/contrib/zooinspector/src/java/org/apache/zookeeper/inspector/gui/ZooInspectorPanel.java,318,0,0.0,0,0,0.0,0,0,0.0,0,0,0.0,0,0,0,0,NO
18,src/contrib/zooinspector/src/java/org/apache/zookeeper/inspector/gui/ZooInspectorTreeViewer.java,356,0,0.0,0,0,0.0,0,0,0.0,0,0,0.0,0,0,0,0,NO
18,src/contrib/zooinspector/src/java/org/apache/zookeeper/inspector/gui/nodeviewer/NodeViewerACL.java,187,0,0.0,0,0,0.0,0,0,0.0,0,0,0.0,0,0,0,0,NO
18,src/contrib/zooinspector/src/java/org/apache/zookeeper/inspector/gui/nodeviewer/NodeViewerData.java,142,0,0.0,0,0,0.0,0,0,0.0,0,0,0.0,0,0,0,0,NO
18,src/contrib/zooinspector/src/java/org/apache/zookeeper/inspector/gui/nodeviewer/NodeViewerMetaData.java,186,0,0.0,0,0,0.0,0,0,0.0,0,0,0.0,0,0,0,0,NO
18,src/contrib/zooinspector/src/java/org/apache/zookeeper/inspector/gui/nodeviewer/ZooInspectorNodeViewer.java,138,0,0.0,0,0,0.0,0,0,0.0,0,0,0.0,0,0,0,0,NO
18,src/contrib/zooinspector/src/java/org/apache/zookeeper/inspector/logger/LoggerFactory.java,36,0,0.0,0,0,0.0,0,0,0.0,0,0,0.0,0,0,0,0,NO
18,src/contrib/zooinspector/src/java/org/apache/zookeeper/inspector/manager/NodeListener.java,37,0,0.0,0,0,0.0,0,0,0.0,0,0,0.0,0,0,0,0,NO
18,src/contrib/zooinspector/src/java/org/apache/zookeeper/inspector/manager/Pair.java,120,0,0.0,0,0,0.0,0,0,0.0,0,0,0.0,0,0,0,0,NO
18,src/contrib/zooinspector/src/java/org/apache/zookeeper/inspector/manager/ZooInspectorManager.java,139,0,0.0,0,0,0.0,0,0,0.0,0,0,0.0,0,0,0,0,NO
18,src/contrib/zooinspector/src/java/org/apache/zookeeper/inspector/manager/ZooInspectorManagerImpl.java,852,0,0.0,0,0,0.0,0,0,0.0,0,0,0.0,0,0,0,0,NO
18,src/contrib/zooinspector/src/java/org/apache/zookeeper/inspector/manager/ZooInspectorNodeManager.java,33,0,0.0,0,0,0.0,0,0,0.0,0,0,0.0,0,0,0,0,NO
18,src/contrib/zooinspector/src/java/org/apache/zookeeper/inspector/manager/ZooInspectorNodeTreeManager.java,43,0,0.0,0,0,0.0,0,0,0.0,0,0,0.0,0,0,0,0,NO
18,src/contrib/zooinspector/src/java/org/apache/zookeeper/inspector/manager/ZooInspectorReadOnlyManager.java,99,0,0.0,0,0,0.0,0,0,0.0,0,0,0.0,0,0,0,0,NO
18,src/contrib/zooinspector/src/java/org/apache/zookeeper/retry/ZooKeeperRetry.java,288,0,0.0,0,0,0.0,0,0,0.0,0,0,0.0,0,0,0,0,NO
18,src/java/main/org/apache/jute/BinaryInputArchive.java,131,0,0.0,0,0,0.0,0,0,0.0,0,0,0.0,0,0,0,0,YES
18,src/java/main/org/apache/jute/BinaryOutputArchive.java,146,0,0.0,0,0,0.0,0,0,0.0,0,0,0.0,0,0,0,0,NO
18,src/java/main/org/apache/jute/CsvInputArchive.java,204,0,0.0,0,0,0.0,0,0,0.0,0,0,0.0,0,0,0,0,NO
18,src/java/main/org/apache/jute/CsvOutputArchive.java,150,0,0.0,0,0,0.0,0,0,0.0,0,0,0.0,0,0,0,0,NO
18,src/java/main/org/apache/jute/Index.java,38,0,0.0,0,0,0.0,0,0,0.0,0,0,0.0,0,0,0,0,NO
18,src/java/main/org/apache/jute/InputArchive.java,43,0,0.0,0,0,0.0,0,0,0.0,0,0,0.0,0,0,0,0,NO
18,src/java/main/org/apache/jute/OutputArchive.java,47,0,0.0,0,0,0.0,0,0,0.0,0,0,0.0,0,0,0,0,NO
18,src/java/main/org/apache/jute/Record.java,32,0,0.0,0,0,0.0,0,0,0.0,0,0,0.0,0,0,0,0,NO
18,src/java/main/org/apache/jute/RecordReader.java,93,0,0.0,0,0,0.0,0,0,0.0,0,0,0.0,0,0,0,0,NO
18,src/java/main/org/apache/jute/RecordWriter.java,93,0,0.0,0,0,0.0,0,0,0.0,0,0,0.0,0,0,0,0,NO
18,src/java/main/org/apache/jute/Utils.java,282,0,0.0,0,0,0.0,0,0,0.0,0,0,0.0,0,0,0,0,NO
18,src/java/main/org/apache/jute/XmlInputArchive.java,251,0,0.0,0,0,0.0,0,0,0.0,0,0,0.0,0,0,0,0,NO
18,src/java/main/org/apache/jute/XmlOutputArchive.java,251,0,0.0,0,0,0.0,0,0,0.0,0,0,0.0,0,0,0,0,NO
18,src/java/main/org/apache/jute/compiler/CGenerator.java,130,0,0.0,0,0,0.0,0,0,0.0,0,0,0.0,0,0,0,0,NO
18,src/java/main/org/apache/jute/compiler/CSharpGenerator.java,53,0,0.0,0,0,0.0,0,0,0.0,0,0,0.0,0,0,0,0,NO
18,src/java/main/org/apache/jute/compiler/CppGenerator.java,125,0,0.0,0,0,0.0,0,0,0.0,0,0,0.0,0,0,0,0,NO
18,src/java/main/org/apache/jute/compiler/JBoolean.java,50,0,0.0,0,0,0.0,0,0,0.0,0,0,0.0,0,0,0,0,NO
18,src/java/main/org/apache/jute/compiler/JBuffer.java,106,0,0.0,0,0,0.0,0,0,0.0,0,0,0.0,0,0,0,0,NO
18,src/java/main/org/apache/jute/compiler/JByte.java,34,0,0.0,0,0,0.0,0,0,0.0,0,0,0.0,0,0,0,0,NO
18,src/java/main/org/apache/jute/compiler/JCompType.java,66,0,0.0,0,0,0.0,0,0,0.0,0,0,0.0,0,0,0,0,NO
18,src/java/main/org/apache/jute/compiler/JDouble.java,40,0,0.0,0,0,0.0,0,0,0.0,0,0,0.0,0,0,0,0,NO
18,src/java/main/org/apache/jute/compiler/JField.java,140,0,0.0,0,0,0.0,0,0,0.0,0,0,0.0,0,0,0,0,NO
18,src/java/main/org/apache/jute/compiler/JFile.java,84,0,0.0,0,0,0.0,0,0,0.0,0,0,0.0,0,0,0,0,NO
18,src/java/main/org/apache/jute/compiler/JFloat.java,39,0,0.0,0,0,0.0,0,0,0.0,0,0,0.0,0,0,0,0,NO
18,src/java/main/org/apache/jute/compiler/JInt.java,34,0,0.0,0,0,0.0,0,0,0.0,0,0,0.0,0,0,0,0,NO
18,src/java/main/org/apache/jute/compiler/JLong.java,38,0,0.0,0,0,0.0,0,0,0.0,0,0,0.0,0,0,0,0,NO
18,src/java/main/org/apache/jute/compiler/JMap.java,149,0,0.0,0,0,0.0,0,0,0.0,0,0,0.0,0,0,0,0,NO
18,src/java/main/org/apache/jute/compiler/JRecord.java,761,0,0.0,0,0,0.0,0,0,0.0,0,0,0.0,0,0,0,0,NO
18,src/java/main/org/apache/jute/compiler/JString.java,46,0,0.0,0,0,0.0,0,0,0.0,0,0,0.0,0,0,0,0,NO
18,src/java/main/org/apache/jute/compiler/JType.java,204,0,0.0,0,0,0.0,0,0,0.0,0,0,0.0,0,0,0,0,NO
18,src/java/main/org/apache/jute/compiler/JVector.java,153,0,0.0,0,0,0.0,0,0,0.0,0,0,0.0,0,0,0,0,NO
18,src/java/main/org/apache/jute/compiler/JavaGenerator.java,57,0,0.0,0,0,0.0,0,0,0.0,0,0,0.0,0,0,0,0,NO
18,src/java/main/org/apache/zookeeper/AsyncCallback.java,57,0,0.0,0,0,0.0,0,0,0.0,0,0,0.0,0,0,0,0,NO
18,src/java/main/org/apache/zookeeper/ClientCnxn.java,1379,117,58.5,117,47,23.5,47,164,82.0,164,70,35.0,70,2,1,2,YES
18,src/java/main/org/apache/zookeeper/ClientCnxnSocket.java,174,6,6.0,6,2,2.0,2,8,8.0,8,4,4.0,4,1,1,1,NO
18,src/java/main/org/apache/zookeeper/ClientCnxnSocketNIO.java,414,88,88.0,88,13,13.0,13,101,101.0,101,75,75.0,75,1,1,1,YES
18,src/java/main/org/apache/zookeeper/ClientWatchManager.java,40,0,0.0,0,0,0.0,0,0,0.0,0,0,0.0,0,0,0,0,NO
18,src/java/main/org/apache/zookeeper/CreateMode.java,90,0,0.0,0,0,0.0,0,0,0.0,0,0,0.0,0,0,0,0,YES
18,src/java/main/org/apache/zookeeper/Environment.java,102,3,1.5,3,1,0.5,1,4,2.0,4,2,1.0,2,2,0,2,NO
18,src/java/main/org/apache/zookeeper/JLineZNodeCompletor.java,84,0,0.0,0,0,0.0,0,0,0.0,0,0,0.0,0,0,0,0,NO
18,src/java/main/org/apache/zookeeper/KeeperException.java,702,0,0.0,0,0,0.0,0,0,0.0,0,0,0.0,0,0,0,0,NO
18,src/java/main/org/apache/zookeeper/Login.java,392,0,0.0,0,0,0.0,0,0,0.0,0,0,0.0,0,0,0,0,YES
18,src/java/main/org/apache/zookeeper/MultiResponse.java,165,0,0.0,0,0,0.0,0,0,0.0,0,0,0.0,0,0,0,0,NO
18,src/java/main/org/apache/zookeeper/MultiTransactionRecord.java,159,0,0.0,0,0,0.0,0,0,0.0,0,0,0.0,0,0,0,0,NO
18,src/java/main/org/apache/zookeeper/Op.java,332,0,0.0,0,0,0.0,0,0,0.0,0,0,0.0,0,0,0,0,YES
18,src/java/main/org/apache/zookeeper/OpResult.java,185,0,0.0,0,0,0.0,0,0,0.0,0,0,0.0,0,0,0,0,NO
18,src/java/main/org/apache/zookeeper/Quotas.java,68,0,0.0,0,0,0.0,0,0,0.0,0,0,0.0,0,0,0,0,NO
18,src/java/main/org/apache/zookeeper/ServerAdminClient.java,277,0,0.0,0,0,0.0,0,0,0.0,0,0,0.0,0,0,0,0,NO
18,src/java/main/org/apache/zookeeper/Shell.java,476,0,0.0,0,0,0.0,0,0,0.0,0,0,0.0,0,0,0,0,NO
18,src/java/main/org/apache/zookeeper/StatsTrack.java,101,0,0.0,0,0,0.0,0,0,0.0,0,0,0.0,0,0,0,0,NO
18,src/java/main/org/apache/zookeeper/Transaction.java,63,0,0.0,0,0,0.0,0,0,0.0,0,0,0.0,0,0,0,0,NO
18,src/java/main/org/apache/zookeeper/Version.java,79,0,0.0,0,0,0.0,0,0,0.0,0,0,0.0,0,0,0,0,NO
18,src/java/main/org/apache/zookeeper/WatchedEvent.java,79,0,0.0,0,0,0.0,0,0,0.0,0,0,0.0,0,0,0,0,NO
18,src/java/main/org/apache/zookeeper/Watcher.java,149,0,0.0,0,0,0.0,0,0,0.0,0,0,0.0,0,0,0,0,NO
18,src/java/main/org/apache/zookeeper/ZKUtil.java,124,0,0.0,0,0,0.0,0,0,0.0,0,0,0.0,0,0,0,0,NO
18,src/java/main/org/apache/zookeeper/ZooDefs.java,119,0,0.0,0,0,0.0,0,0,0.0,0,0,0.0,0,0,0,0,NO
18,src/java/main/org/apache/zookeeper/ZooKeeper.java,1779,0,0.0,0,0,0.0,0,0,0.0,0,0,0.0,0,0,0,0,YES
18,src/java/main/org/apache/zookeeper/ZooKeeperMain.java,670,0,0.0,0,0,0.0,0,0,0.0,0,0,0.0,0,0,0,0,YES
18,src/java/main/org/apache/zookeeper/cli/AclParser.java,81,0,0.0,0,0,0.0,0,0,0.0,0,0,0.0,0,0,0,0,NO
18,src/java/main/org/apache/zookeeper/cli/AddAuthCommand.java,64,0,0.0,0,0,0.0,0,0,0.0,0,0,0.0,0,0,0,0,NO
18,src/java/main/org/apache/zookeeper/cli/CliCommand.java,119,0,0.0,0,0,0.0,0,0,0.0,0,0,0.0,0,0,0,0,NO
18,src/java/main/org/apache/zookeeper/cli/CloseCommand.java,46,0,0.0,0,0,0.0,0,0,0.0,0,0,0.0,0,0,0,0,NO
18,src/java/main/org/apache/zookeeper/cli/CreateCommand.java,81,0,0.0,0,0,0.0,0,0,0.0,0,0,0.0,0,0,0,0,NO
18,src/java/main/org/apache/zookeeper/cli/DelQuotaCommand.java,152,0,0.0,0,0,0.0,0,0,0.0,0,0,0.0,0,0,0,0,NO
18,src/java/main/org/apache/zookeeper/cli/DeleteAllCommand.java,72,0,0.0,0,0,0.0,0,0,0.0,0,0,0.0,0,0,0,0,NO
18,src/java/main/org/apache/zookeeper/cli/DeleteCommand.java,88,0,0.0,0,0,0.0,0,0,0.0,0,0,0.0,0,0,0,0,NO
18,src/java/main/org/apache/zookeeper/cli/GetAclCommand.java,94,0,0.0,0,0,0.0,0,0,0.0,0,0,0.0,0,0,0,0,NO
18,src/java/main/org/apache/zookeeper/cli/GetCommand.java,83,0,0.0,0,0,0.0,0,0,0.0,0,0,0.0,0,0,0,0,NO
18,src/java/main/org/apache/zookeeper/cli/ListQuotaCommand.java,74,0,0.0,0,0,0.0,0,0,0.0,0,0,0.0,0,0,0,0,NO
18,src/java/main/org/apache/zookeeper/cli/Ls2Command.java,62,0,0.0,0,0,0.0,0,0,0.0,0,0,0.0,0,0,0,0,NO
18,src/java/main/org/apache/zookeeper/cli/LsCommand.java,85,0,0.0,0,0,0.0,0,0,0.0,0,0,0.0,0,0,0,0,NO
18,src/java/main/org/apache/zookeeper/cli/SetAclCommand.java,82,0,0.0,0,0,0.0,0,0,0.0,0,0,0.0,0,0,0,0,NO
18,src/java/main/org/apache/zookeeper/cli/SetCommand.java,75,0,0.0,0,0,0.0,0,0,0.0,0,0,0.0,0,0,0,0,NO
18,src/java/main/org/apache/zookeeper/cli/SetQuotaCommand.java,200,0,0.0,0,0,0.0,0,0,0.0,0,0,0.0,0,0,0,0,NO
18,src/java/main/org/apache/zookeeper/cli/StatCommand.java,81,0,0.0,0,0,0.0,0,0,0.0,0,0,0.0,0,0,0,0,NO
18,src/java/main/org/apache/zookeeper/cli/StatPrinter.java,49,0,0.0,0,0,0.0,0,0,0.0,0,0,0.0,0,0,0,0,NO
18,src/java/main/org/apache/zookeeper/cli/SyncCommand.java,64,0,0.0,0,0,0.0,0,0,0.0,0,0,0.0,0,0,0,0,NO
18,src/java/main/org/apache/zookeeper/client/ConnectStringParser.java,87,0,0.0,0,0,0.0,0,0,0.0,0,0,0.0,0,0,0,0,NO
18,src/java/main/org/apache/zookeeper/client/FourLetterWordMain.java,79,0,0.0,0,0,0.0,0,0,0.0,0,0,0.0,0,0,0,0,NO
18,src/java/main/org/apache/zookeeper/client/HostProvider.java,61,0,0.0,0,0,0.0,0,0,0.0,0,0,0.0,0,0,0,0,NO
18,src/java/main/org/apache/zookeeper/client/StaticHostProvider.java,101,0,0.0,0,0,0.0,0,0,0.0,0,0,0.0,0,0,0,0,NO
18,src/java/main/org/apache/zookeeper/client/ZooKeeperSaslClient.java,522,123,41.0,123,43,14.333333,43,166,55.333332,166,82,27.333334,82,3,1,2,YES
18,src/java/main/org/apache/zookeeper/common/AtomicFileOutputStream.java,115,0,0.0,0,0,0.0,0,0,0.0,0,0,0.0,0,0,0,0,NO
18,src/java/main/org/apache/zookeeper/common/IOUtils.java,123,0,0.0,0,0,0.0,0,0,0.0,0,0,0.0,0,0,0,0,NO
18,src/java/main/org/apache/zookeeper/common/PathTrie.java,284,0,0.0,0,0,0.0,0,0,0.0,0,0,0.0,0,0,0,0,YES
18,src/java/main/org/apache/zookeeper/common/PathUtils.java,103,0,0.0,0,0,0.0,0,0,0.0,0,0,0.0,0,0,0,0,YES
18,src/java/main/org/apache/zookeeper/jmx/CommonNames.java,29,0,0.0,0,0,0.0,0,0,0.0,0,0,0.0,0,0,0,0,NO
18,src/java/main/org/apache/zookeeper/jmx/MBeanRegistry.java,215,0,0.0,0,0,0.0,0,0,0.0,0,0,0.0,0,0,0,0,NO
18,src/java/main/org/apache/zookeeper/jmx/ManagedUtil.java,71,0,0.0,0,0,0.0,0,0,0.0,0,0,0.0,0,0,0,0,NO
18,src/java/main/org/apache/zookeeper/jmx/ZKMBeanInfo.java,36,0,0.0,0,0,0.0,0,0,0.0,0,0,0.0,0,0,0,0,NO
18,src/java/main/org/apache/zookeeper/server/ByteBufferInputStream.java,82,0,0.0,0,0,0.0,0,0,0.0,0,0,0.0,0,0,0,0,NO
18,src/java/main/org/apache/zookeeper/server/ByteBufferOutputStream.java,51,0,0.0,0,0,0.0,0,0,0.0,0,0,0.0,0,0,0,0,NO
18,src/java/main/org/apache/zookeeper/server/ConnectionBean.java,173,0,0.0,0,0,0.0,0,0,0.0,0,0,0.0,0,0,0,0,NO
18,src/java/main/org/apache/zookeeper/server/ConnectionMXBean.java,98,0,0.0,0,0,0.0,0,0,0.0,0,0,0.0,0,0,0,0,NO
18,src/java/main/org/apache/zookeeper/server/DataNode.java,174,0,0.0,0,0,0.0,0,0,0.0,0,0,0.0,0,0,0,0,NO
18,src/java/main/org/apache/zookeeper/server/DataTree.java,1302,0,0.0,0,0,0.0,0,0,0.0,0,0,0.0,0,0,0,0,YES
18,src/java/main/org/apache/zookeeper/server/DataTreeBean.java,61,0,0.0,0,0,0.0,0,0,0.0,0,0,0.0,0,0,0,0,NO
18,src/java/main/org/apache/zookeeper/server/DataTreeMXBean.java,47,0,0.0,0,0,0.0,0,0,0.0,0,0,0.0,0,0,0,0,NO
18,src/java/main/org/apache/zookeeper/server/DatadirCleanupManager.java,192,0,0.0,0,0,0.0,0,0,0.0,0,0,0.0,0,0,0,0,NO
18,src/java/main/org/apache/zookeeper/server/FinalRequestProcessor.java,414,0,0.0,0,0,0.0,0,0,0.0,0,0,0.0,0,0,0,0,NO
18,src/java/main/org/apache/zookeeper/server/LogFormatter.java,104,0,0.0,0,0,0.0,0,0,0.0,0,0,0.0,0,0,0,0,NO
18,src/java/main/org/apache/zookeeper/server/NIOServerCnxn.java,1157,0,0.0,0,0,0.0,0,0,0.0,0,0,0.0,0,0,0,0,YES
18,src/java/main/org/apache/zookeeper/server/NIOServerCnxnFactory.java,309,2,2.0,2,16,16.0,16,18,18.0,18,14,14.0,14,1,0,1,NO
18,src/java/main/org/apache/zookeeper/server/NettyServerCnxn.java,852,0,0.0,0,0,0.0,0,0,0.0,0,0,0.0,0,0,0,0,YES
18,src/java/main/org/apache/zookeeper/server/NettyServerCnxnFactory.java,399,1,1.0,1,16,16.0,16,17,17.0,17,15,15.0,15,1,0,1,NO
18,src/java/main/org/apache/zookeeper/server/ObserverBean.java,45,0,0.0,0,0,0.0,0,0,0.0,0,0,0.0,0,0,0,0,NO
18,src/java/main/org/apache/zookeeper/server/PrepRequestProcessor.java,738,0,0.0,0,0,0.0,0,0,0.0,0,0,0.0,0,0,0,0,YES
18,src/java/main/org/apache/zookeeper/server/PurgeTxnLog.java,129,0,0.0,0,0,0.0,0,0,0.0,0,0,0.0,0,0,0,0,NO
18,src/java/main/org/apache/zookeeper/server/Request.java,256,0,0.0,0,0,0.0,0,0,0.0,0,0,0.0,0,0,0,0,NO
18,src/java/main/org/apache/zookeeper/server/RequestProcessor.java,44,0,0.0,0,0,0.0,0,0,0.0,0,0,0.0,0,0,0,0,NO
18,src/java/main/org/apache/zookeeper/server/ServerCnxn.java,452,0,0.0,0,0,0.0,0,0,0.0,0,0,0.0,0,0,0,0,NO
18,src/java/main/org/apache/zookeeper/server/ServerCnxnFactory.java,209,60,60.0,60,0,0.0,0,60,60.0,60,60,60.0,60,1,0,1,NO
18,src/java/main/org/apache/zookeeper/server/ServerConfig.java,112,0,0.0,0,0,0.0,0,0,0.0,0,0,0.0,0,0,0,0,NO
18,src/java/main/org/apache/zookeeper/server/ServerStats.java,140,0,0.0,0,0,0.0,0,0,0.0,0,0,0.0,0,0,0,0,NO
18,src/java/main/org/apache/zookeeper/server/SessionTracker.java,81,0,0.0,0,0,0.0,0,0,0.0,0,0,0.0,0,0,0,0,NO
18,src/java/main/org/apache/zookeeper/server/SessionTrackerImpl.java,279,9,9.0,9,4,4.0,4,13,13.0,13,5,5.0,5,1,1,1,YES
18,src/java/main/org/apache/zookeeper/server/SnapshotFormatter.java,124,0,0.0,0,0,0.0,0,0,0.0,0,0,0.0,0,0,0,0,NO
18,src/java/main/org/apache/zookeeper/server/Stats.java,68,0,0.0,0,0,0.0,0,0,0.0,0,0,0.0,0,0,0,0,NO
18,src/java/main/org/apache/zookeeper/server/SyncRequestProcessor.java,192,0,0.0,0,0,0.0,0,0,0.0,0,0,0.0,0,0,0,0,YES
18,src/java/main/org/apache/zookeeper/server/TraceFormatter.java,123,0,0.0,0,0,0.0,0,0,0.0,0,0,0.0,0,0,0,0,NO
18,src/java/main/org/apache/zookeeper/server/WatchManager.java,171,0,0.0,0,0,0.0,0,0,0.0,0,0,0.0,0,0,0,0,NO
18,src/java/main/org/apache/zookeeper/server/ZKDatabase.java,490,0,0.0,0,0,0.0,0,0,0.0,0,0,0.0,0,0,0,0,NO
18,src/java/main/org/apache/zookeeper/server/ZooKeeperSaslServer.java,130,3,3.0,3,0,0.0,0,3,3.0,3,3,3.0,3,1,0,1,NO
18,src/java/main/org/apache/zookeeper/server/ZooKeeperServer.java,961,0,0.0,0,0,0.0,0,0,0.0,0,0,0.0,0,0,0,0,YES
18,src/java/main/org/apache/zookeeper/server/ZooKeeperServerBean.java,147,0,0.0,0,0,0.0,0,0,0.0,0,0,0.0,0,0,0,0,NO
18,src/java/main/org/apache/zookeeper/server/ZooKeeperServerMXBean.java,110,0,0.0,0,0,0.0,0,0,0.0,0,0,0.0,0,0,0,0,NO
18,src/java/main/org/apache/zookeeper/server/ZooKeeperServerMain.java,128,0,0.0,0,0,0.0,0,0,0.0,0,0,0.0,0,0,0,0,NO
18,src/java/main/org/apache/zookeeper/server/ZooTrace.java,93,0,0.0,0,0,0.0,0,0,0.0,0,0,0.0,0,0,0,0,NO
18,src/java/main/org/apache/zookeeper/server/auth/AuthenticationProvider.java,82,0,0.0,0,0,0.0,0,0,0.0,0,0,0.0,0,0,0,0,NO
18,src/java/main/org/apache/zookeeper/server/auth/DigestAuthenticationProvider.java,139,0,0.0,0,0,0.0,0,0,0.0,0,0,0.0,0,0,0,0,NO
18,src/java/main/org/apache/zookeeper/server/auth/DigestLoginModule.java,59,0,0.0,0,0,0.0,0,0,0.0,0,0,0.0,0,0,0,0,NO
18,src/java/main/org/apache/zookeeper/server/auth/IPAuthenticationProvider.java,117,0,0.0,0,0,0.0,0,0,0.0,0,0,0.0,0,0,0,0,NO
18,src/java/main/org/apache/zookeeper/server/auth/KerberosName.java,418,0,0.0,0,0,0.0,0,0,0.0,0,0,0.0,0,0,0,0,NO
18,src/java/main/org/apache/zookeeper/server/auth/ProviderRegistry.java,77,0,0.0,0,0,0.0,0,0,0.0,0,0,0.0,0,0,0,0,NO
18,src/java/main/org/apache/zookeeper/server/auth/SASLAuthenticationProvider.java,70,0,0.0,0,0,0.0,0,0,0.0,0,0,0.0,0,0,0,0,NO
18,src/java/main/org/apache/zookeeper/server/auth/SaslServerCallbackHandler.java,152,5,5.0,5,1,1.0,1,6,6.0,6,4,4.0,4,1,0,1,NO
18,src/java/main/org/apache/zookeeper/server/persistence/FileSnap.java,250,0,0.0,0,0,0.0,0,0,0.0,0,0,0.0,0,0,0,0,NO
18,src/java/main/org/apache/zookeeper/server/persistence/FileTxnLog.java,661,0,0.0,0,0,0.0,0,0,0.0,0,0,0.0,0,0,0,0,NO
18,src/java/main/org/apache/zookeeper/server/persistence/FileTxnSnapLog.java,381,0,0.0,0,0,0.0,0,0,0.0,0,0,0.0,0,0,0,0,YES
18,src/java/main/org/apache/zookeeper/server/persistence/SnapShot.java,66,0,0.0,0,0,0.0,0,0,0.0,0,0,0.0,0,0,0,0,NO
18,src/java/main/org/apache/zookeeper/server/persistence/TxnLog.java,120,0,0.0,0,0,0.0,0,0,0.0,0,0,0.0,0,0,0,0,NO
18,src/java/main/org/apache/zookeeper/server/persistence/Util.java,326,0,0.0,0,0,0.0,0,0,0.0,0,0,0.0,0,0,0,0,NO
18,src/java/main/org/apache/zookeeper/server/quorum/AckRequestProcessor.java,54,0,0.0,0,0,0.0,0,0,0.0,0,0,0.0,0,0,0,0,NO
18,src/java/main/org/apache/zookeeper/server/quorum/AuthFastLeaderElection.java,972,0,0.0,0,0,0.0,0,0,0.0,0,0,0.0,0,0,0,0,NO
18,src/java/main/org/apache/zookeeper/server/quorum/CommitProcessor.java,185,0,0.0,0,0,0.0,0,0,0.0,0,0,0.0,0,0,0,0,NO
18,src/java/main/org/apache/zookeeper/server/quorum/Election.java,27,0,0.0,0,0,0.0,0,0,0.0,0,0,0.0,0,0,0,0,NO
18,src/java/main/org/apache/zookeeper/server/quorum/FastLeaderElection.java,903,5,5.0,5,3,3.0,3,8,8.0,8,2,2.0,2,1,1,1,NO
18,src/java/main/org/apache/zookeeper/server/quorum/Follower.java,167,0,0.0,0,0,0.0,0,0,0.0,0,0,0.0,0,0,0,0,NO
18,src/java/main/org/apache/zookeeper/server/quorum/FollowerBean.java,50,0,0.0,0,0,0.0,0,0,0.0,0,0,0.0,0,0,0,0,NO
18,src/java/main/org/apache/zookeeper/server/quorum/FollowerMXBean.java,41,0,0.0,0,0,0.0,0,0,0.0,0,0,0.0,0,0,0,0,NO
18,src/java/main/org/apache/zookeeper/server/quorum/FollowerRequestProcessor.java,113,0,0.0,0,0,0.0,0,0,0.0,0,0,0.0,0,0,0,0,NO
18,src/java/main/org/apache/zookeeper/server/quorum/FollowerZooKeeperServer.java,160,0,0.0,0,0,0.0,0,0,0.0,0,0,0.0,0,0,0,0,NO
18,src/java/main/org/apache/zookeeper/server/quorum/Leader.java,958,0,0.0,0,0,0.0,0,0,0.0,0,0,0.0,0,0,0,0,YES
18,src/java/main/org/apache/zookeeper/server/quorum/LeaderBean.java,53,0,0.0,0,0,0.0,0,0,0.0,0,0,0.0,0,0,0,0,NO
18,src/java/main/org/apache/zookeeper/server/quorum/LeaderElection.java,293,0,0.0,0,0,0.0,0,0,0.0,0,0,0.0,0,0,0,0,NO
18,src/java/main/org/apache/zookeeper/server/quorum/LeaderElectionBean.java,42,0,0.0,0,0,0.0,0,0,0.0,0,0,0.0,0,0,0,0,NO
18,src/java/main/org/apache/zookeeper/server/quorum/LeaderElectionMXBean.java,31,0,0.0,0,0,0.0,0,0,0.0,0,0,0.0,0,0,0,0,NO
18,src/java/main/org/apache/zookeeper/server/quorum/LeaderMXBean.java,36,0,0.0,0,0,0.0,0,0,0.0,0,0,0.0,0,0,0,0,NO
18,src/java/main/org/apache/zookeeper/server/quorum/LeaderZooKeeperServer.java,177,0,0.0,0,0,0.0,0,0,0.0,0,0,0.0,0,0,0,0,NO
18,src/java/main/org/apache/zookeeper/server/quorum/Learner.java,482,0,0.0,0,0,0.0,0,0,0.0,0,0,0.0,0,0,0,0,YES
18,src/java/main/org/apache/zookeeper/server/quorum/LearnerHandler.java,629,0,0.0,0,0,0.0,0,0,0.0,0,0,0.0,0,0,0,0,YES
18,src/java/main/org/apache/zookeeper/server/quorum/LearnerSessionTracker.java,96,0,0.0,0,0,0.0,0,0,0.0,0,0,0.0,0,0,0,0,NO
18,src/java/main/org/apache/zookeeper/server/quorum/LearnerSyncRequest.java,34,0,0.0,0,0,0.0,0,0,0.0,0,0,0.0,0,0,0,0,NO
18,src/java/main/org/apache/zookeeper/server/quorum/LearnerZooKeeperServer.java,144,0,0.0,0,0,0.0,0,0,0.0,0,0,0.0,0,0,0,0,NO
18,src/java/main/org/apache/zookeeper/server/quorum/LocalPeerBean.java,79,0,0.0,0,0,0.0,0,0,0.0,0,0,0.0,0,0,0,0,NO
18,src/java/main/org/apache/zookeeper/server/quorum/LocalPeerMXBean.java,77,0,0.0,0,0,0.0,0,0,0.0,0,0,0.0,0,0,0,0,NO
18,src/java/main/org/apache/zookeeper/server/quorum/Observer.java,134,0,0.0,0,0,0.0,0,0,0.0,0,0,0.0,0,0,0,0,NO
18,src/java/main/org/apache/zookeeper/server/quorum/ObserverMXBean.java,37,0,0.0,0,0,0.0,0,0,0.0,0,0,0.0,0,0,0,0,NO
18,src/java/main/org/apache/zookeeper/server/quorum/ObserverRequestProcessor.java,127,0,0.0,0,0,0.0,0,0,0.0,0,0,0.0,0,0,0,0,NO
18,src/java/main/org/apache/zookeeper/server/quorum/ObserverZooKeeperServer.java,115,0,0.0,0,0,0.0,0,0,0.0,0,0,0.0,0,0,0,0,YES
18,src/java/main/org/apache/zookeeper/server/quorum/ProposalRequestProcessor.java,93,0,0.0,0,0,0.0,0,0,0.0,0,0,0.0,0,0,0,0,NO
18,src/java/main/org/apache/zookeeper/server/quorum/QuorumBean.java,44,0,0.0,0,0,0.0,0,0,0.0,0,0,0.0,0,0,0,0,NO
18,src/java/main/org/apache/zookeeper/server/quorum/QuorumCnxManager.java,884,0,0.0,0,0,0.0,0,0,0.0,0,0,0.0,0,0,0,0,NO
18,src/java/main/org/apache/zookeeper/server/quorum/QuorumMXBean.java,34,0,0.0,0,0,0.0,0,0,0.0,0,0,0.0,0,0,0,0,NO
18,src/java/main/org/apache/zookeeper/server/quorum/QuorumPeer.java,1343,0,0.0,0,0,0.0,0,0,0.0,0,0,0.0,0,0,0,0,YES
18,src/java/main/org/apache/zookeeper/server/quorum/QuorumPeerConfig.java,511,0,0.0,0,0,0.0,0,0,0.0,0,0,0.0,0,0,0,0,NO
18,src/java/main/org/apache/zookeeper/server/quorum/QuorumPeerMain.java,164,0,0.0,0,0,0.0,0,0,0.0,0,0,0.0,0,0,0,0,NO
18,src/java/main/org/apache/zookeeper/server/quorum/QuorumStats.java,68,0,0.0,0,0,0.0,0,0,0.0,0,0,0.0,0,0,0,0,NO
18,src/java/main/org/apache/zookeeper/server/quorum/QuorumZooKeeperServer.java,58,0,0.0,0,0,0.0,0,0,0.0,0,0,0.0,0,0,0,0,NO
18,src/java/main/org/apache/zookeeper/server/quorum/ReadOnlyBean.java,38,0,0.0,0,0,0.0,0,0,0.0,0,0,0.0,0,0,0,0,NO
18,src/java/main/org/apache/zookeeper/server/quorum/ReadOnlyRequestProcessor.java,129,0,0.0,0,0,0.0,0,0,0.0,0,0,0.0,0,0,0,0,NO
18,src/java/main/org/apache/zookeeper/server/quorum/ReadOnlyZooKeeperServer.java,144,0,0.0,0,0,0.0,0,0,0.0,0,0,0.0,0,0,0,0,NO
18,src/java/main/org/apache/zookeeper/server/quorum/RemotePeerBean.java,45,0,0.0,0,0,0.0,0,0,0.0,0,0,0.0,0,0,0,0,NO
18,src/java/main/org/apache/zookeeper/server/quorum/RemotePeerMXBean.java,33,0,0.0,0,0,0.0,0,0,0.0,0,0,0.0,0,0,0,0,NO
18,src/java/main/org/apache/zookeeper/server/quorum/SendAckRequestProcessor.java,80,0,0.0,0,0,0.0,0,0,0.0,0,0,0.0,0,0,0,0,NO
18,src/java/main/org/apache/zookeeper/server/quorum/ServerBean.java,38,0,0.0,0,0,0.0,0,0,0.0,0,0,0.0,0,0,0,0,NO
18,src/java/main/org/apache/zookeeper/server/quorum/ServerMXBean.java,33,0,0.0,0,0,0.0,0,0,0.0,0,0,0.0,0,0,0,0,NO
18,src/java/main/org/apache/zookeeper/server/quorum/StateSummary.java,57,0,0.0,0,0,0.0,0,0,0.0,0,0,0.0,0,0,0,0,NO
18,src/java/main/org/apache/zookeeper/server/quorum/Vote.java,106,0,0.0,0,0,0.0,0,0,0.0,0,0,0.0,0,0,0,0,NO
18,src/java/main/org/apache/zookeeper/server/quorum/flexible/QuorumHierarchical.java,374,0,0.0,0,0,0.0,0,0,0.0,0,0,0.0,0,0,0,0,NO
18,src/java/main/org/apache/zookeeper/server/quorum/flexible/QuorumMaj.java,153,0,0.0,0,0,0.0,0,0,0.0,0,0,0.0,0,0,0,0,NO
18,src/java/main/org/apache/zookeeper/server/quorum/flexible/QuorumVerifier.java,42,0,0.0,0,0,0.0,0,0,0.0,0,0,0.0,0,0,0,0,NO
18,src/java/main/org/apache/zookeeper/server/util/KerberosUtil.java,45,0,0.0,0,0,0.0,0,0,0.0,0,0,0.0,0,0,0,0,NO
18,src/java/main/org/apache/zookeeper/server/util/SerializeUtils.java,141,0,0.0,0,0,0.0,0,0,0.0,0,0,0.0,0,0,0,0,NO
18,src/java/main/org/apache/zookeeper/server/util/VerifyingFileFactory.java,82,0,0.0,0,0,0.0,0,0,0.0,0,0,0.0,0,0,0,0,NO
18,src/java/main/org/apache/zookeeper/server/util/ZxidUtils.java,34,0,0.0,0,0,0.0,0,0,0.0,0,0,0.0,0,0,0,0,NO
18,src/java/main/org/apache/zookeeper/version/util/VerGen.java,177,0,0.0,0,0,0.0,0,0,0.0,0,0,0.0,0,0,0,0,NO
18,src/recipes/election/src/java/org/apache/zookeeper/recipes/leader/LeaderElectionAware.java,37,0,0.0,0,0,0.0,0,0,0.0,0,0,0.0,0,0,0,0,NO
18,src/recipes/election/src/java/org/apache/zookeeper/recipes/leader/LeaderElectionSupport.java,461,0,0.0,0,0,0.0,0,0,0.0,0,0,0.0,0,0,0,0,NO
18,src/recipes/election/src/java/org/apache/zookeeper/recipes/leader/LeaderOffer.java,84,0,0.0,0,0,0.0,0,0,0.0,0,0,0.0,0,0,0,0,NO
18,src/recipes/lock/src/java/org/apache/zookeeper/recipes/lock/LockListener.java,38,0,0.0,0,0,0.0,0,0,0.0,0,0,0.0,0,0,0,0,NO
18,src/recipes/lock/src/java/org/apache/zookeeper/recipes/lock/ProtocolSupport.java,193,0,0.0,0,0,0.0,0,0,0.0,0,0,0.0,0,0,0,0,NO
18,src/recipes/lock/src/java/org/apache/zookeeper/recipes/lock/WriteLock.java,295,0,0.0,0,0,0.0,0,0,0.0,0,0,0.0,0,0,0,0,NO
18,src/recipes/lock/src/java/org/apache/zookeeper/recipes/lock/ZNodeName.java,110,0,0.0,0,0,0.0,0,0,0.0,0,0,0.0,0,0,0,0,NO
18,src/recipes/lock/src/java/org/apache/zookeeper/recipes/lock/ZooKeeperOperation.java,38,0,0.0,0,0,0.0,0,0,0.0,0,0,0.0,0,0,0,0,NO
18,src/recipes/queue/src/java/org/apache/zookeeper/recipes/queue/DistributedQueue.java,313,0,0.0,0,0,0.0,0,0,0.0,0,0,0.0,0,0,0,0,NO
19,src/contrib/fatjar/src/java/org/apache/zookeeper/util/FatJarMain.java,126,0,0.0,0,0,0.0,0,0,0.0,0,0,0.0,0,0,0,0,NO
19,src/contrib/loggraph/src/java/org/apache/zookeeper/graph/FilterException.java,22,0,0.0,0,0,0.0,0,0,0.0,0,0,0.0,0,0,0,0,NO
19,src/contrib/loggraph/src/java/org/apache/zookeeper/graph/FilterOp.java,75,0,0.0,0,0,0.0,0,0,0.0,0,0,0.0,0,0,0,0,NO
19,src/contrib/loggraph/src/java/org/apache/zookeeper/graph/FilterParser.java,131,0,0.0,0,0,0.0,0,0,0.0,0,0,0.0,0,0,0,0,NO
19,src/contrib/loggraph/src/java/org/apache/zookeeper/graph/JsonGenerator.java,223,0,0.0,0,0,0.0,0,0,0.0,0,0,0.0,0,0,0,0,NO
19,src/contrib/loggraph/src/java/org/apache/zookeeper/graph/Log4JEntry.java,40,0,0.0,0,0,0.0,0,0,0.0,0,0,0.0,0,0,0,0,NO
19,src/contrib/loggraph/src/java/org/apache/zookeeper/graph/Log4JSource.java,381,0,0.0,0,0,0.0,0,0,0.0,0,0,0.0,0,0,0,0,NO
19,src/contrib/loggraph/src/java/org/apache/zookeeper/graph/LogEntry.java,46,0,0.0,0,0,0.0,0,0,0.0,0,0,0.0,0,0,0,0,NO
19,src/contrib/loggraph/src/java/org/apache/zookeeper/graph/LogIterator.java,26,0,0.0,0,0,0.0,0,0,0.0,0,0,0.0,0,0,0,0,NO
19,src/contrib/loggraph/src/java/org/apache/zookeeper/graph/LogServer.java,66,0,0.0,0,0,0.0,0,0,0.0,0,0,0.0,0,0,0,0,NO
19,src/contrib/loggraph/src/java/org/apache/zookeeper/graph/LogSkipList.java,95,0,0.0,0,0,0.0,0,0,0.0,0,0,0.0,0,0,0,0,NO
19,src/contrib/loggraph/src/java/org/apache/zookeeper/graph/LogSource.java,33,0,0.0,0,0,0.0,0,0,0.0,0,0,0.0,0,0,0,0,NO
19,src/contrib/loggraph/src/java/org/apache/zookeeper/graph/MeasureThroughput.java,103,0,0.0,0,0,0.0,0,0,0.0,0,0,0.0,0,0,0,0,NO
19,src/contrib/loggraph/src/java/org/apache/zookeeper/graph/MergedLogSource.java,219,0,0.0,0,0,0.0,0,0,0.0,0,0,0.0,0,0,0,0,NO
19,src/contrib/loggraph/src/java/org/apache/zookeeper/graph/RandomAccessFileReader.java,328,0,0.0,0,0,0.0,0,0,0.0,0,0,0.0,0,0,0,0,NO
19,src/contrib/loggraph/src/java/org/apache/zookeeper/graph/TransactionEntry.java,59,0,0.0,0,0,0.0,0,0,0.0,0,0,0.0,0,0,0,0,NO
19,src/contrib/loggraph/src/java/org/apache/zookeeper/graph/TxnLogSource.java,376,0,0.0,0,0,0.0,0,0,0.0,0,0,0.0,0,0,0,0,NO
19,src/contrib/loggraph/src/java/org/apache/zookeeper/graph/filterops/AndOp.java,33,0,0.0,0,0,0.0,0,0,0.0,0,0,0.0,0,0,0,0,NO
19,src/contrib/loggraph/src/java/org/apache/zookeeper/graph/filterops/Arg.java,36,0,0.0,0,0,0.0,0,0,0.0,0,0,0.0,0,0,0,0,NO
19,src/contrib/loggraph/src/java/org/apache/zookeeper/graph/filterops/EqualsOp.java,44,0,0.0,0,0,0.0,0,0,0.0,0,0,0.0,0,0,0,0,NO
19,src/contrib/loggraph/src/java/org/apache/zookeeper/graph/filterops/GreaterThanOp.java,70,0,0.0,0,0,0.0,0,0,0.0,0,0,0.0,0,0,0,0,NO
19,src/contrib/loggraph/src/java/org/apache/zookeeper/graph/filterops/LessThanOp.java,69,0,0.0,0,0,0.0,0,0,0.0,0,0,0.0,0,0,0,0,NO
19,src/contrib/loggraph/src/java/org/apache/zookeeper/graph/filterops/NotOp.java,31,0,0.0,0,0,0.0,0,0,0.0,0,0,0.0,0,0,0,0,NO
19,src/contrib/loggraph/src/java/org/apache/zookeeper/graph/filterops/NumberArg.java,27,0,0.0,0,0,0.0,0,0,0.0,0,0,0.0,0,0,0,0,NO
19,src/contrib/loggraph/src/java/org/apache/zookeeper/graph/filterops/OrOp.java,33,0,0.0,0,0,0.0,0,0,0.0,0,0,0.0,0,0,0,0,NO
19,src/contrib/loggraph/src/java/org/apache/zookeeper/graph/filterops/StringArg.java,27,0,0.0,0,0,0.0,0,0,0.0,0,0,0.0,0,0,0,0,NO
19,src/contrib/loggraph/src/java/org/apache/zookeeper/graph/filterops/SymbolArg.java,27,0,0.0,0,0,0.0,0,0,0.0,0,0,0.0,0,0,0,0,NO
19,src/contrib/loggraph/src/java/org/apache/zookeeper/graph/filterops/XorOp.java,40,0,0.0,0,0,0.0,0,0,0.0,0,0,0.0,0,0,0,0,NO
19,src/contrib/loggraph/src/java/org/apache/zookeeper/graph/servlets/FileLoader.java,60,0,0.0,0,0,0.0,0,0,0.0,0,0,0.0,0,0,0,0,NO
19,src/contrib/loggraph/src/java/org/apache/zookeeper/graph/servlets/Fs.java,69,0,0.0,0,0,0.0,0,0,0.0,0,0,0.0,0,0,0,0,NO
19,src/contrib/loggraph/src/java/org/apache/zookeeper/graph/servlets/GraphData.java,85,0,0.0,0,0,0.0,0,0,0.0,0,0,0.0,0,0,0,0,NO
19,src/contrib/loggraph/src/java/org/apache/zookeeper/graph/servlets/JsonServlet.java,85,0,0.0,0,0,0.0,0,0,0.0,0,0,0.0,0,0,0,0,NO
19,src/contrib/loggraph/src/java/org/apache/zookeeper/graph/servlets/NumEvents.java,86,0,0.0,0,0,0.0,0,0,0.0,0,0,0.0,0,0,0,0,NO
19,src/contrib/loggraph/src/java/org/apache/zookeeper/graph/servlets/StaticContent.java,50,0,0.0,0,0,0.0,0,0,0.0,0,0,0.0,0,0,0,0,NO
19,src/contrib/loggraph/src/java/org/apache/zookeeper/graph/servlets/Throughput.java,125,0,0.0,0,0,0.0,0,0,0.0,0,0,0.0,0,0,0,0,NO
19,src/contrib/rest/src/java/org/apache/zookeeper/server/jersey/RestMain.java,151,0,0.0,0,0,0.0,0,0,0.0,0,0,0.0,0,0,0,0,NO
19,src/contrib/rest/src/java/org/apache/zookeeper/server/jersey/ZooKeeperService.java,242,0,0.0,0,0,0.0,0,0,0.0,0,0,0.0,0,0,0,0,NO
19,src/contrib/rest/src/java/org/apache/zookeeper/server/jersey/cfg/Credentials.java,47,0,0.0,0,0,0.0,0,0,0.0,0,0,0.0,0,0,0,0,NO
19,src/contrib/rest/src/java/org/apache/zookeeper/server/jersey/cfg/Endpoint.java,72,0,0.0,0,0,0.0,0,0,0.0,0,0,0.0,0,0,0,0,NO
19,src/contrib/rest/src/java/org/apache/zookeeper/server/jersey/cfg/HostPort.java,51,0,0.0,0,0,0.0,0,0,0.0,0,0,0.0,0,0,0,0,NO
19,src/contrib/rest/src/java/org/apache/zookeeper/server/jersey/cfg/HostPortSet.java,51,0,0.0,0,0,0.0,0,0,0.0,0,0,0.0,0,0,0,0,NO
19,src/contrib/rest/src/java/org/apache/zookeeper/server/jersey/cfg/RestCfg.java,106,0,0.0,0,0,0.0,0,0,0.0,0,0,0.0,0,0,0,0,NO
19,src/contrib/rest/src/java/org/apache/zookeeper/server/jersey/filters/HTTPBasicAuth.java,87,0,0.0,0,0,0.0,0,0,0.0,0,0,0.0,0,0,0,0,NO
19,src/contrib/rest/src/java/org/apache/zookeeper/server/jersey/jaxb/ZChildren.java,80,0,0.0,0,0,0.0,0,0,0.0,0,0,0.0,0,0,0,0,NO
19,src/contrib/rest/src/java/org/apache/zookeeper/server/jersey/jaxb/ZChildrenJSON.java,76,0,0.0,0,0,0.0,0,0,0.0,0,0,0.0,0,0,0,0,NO
19,src/contrib/rest/src/java/org/apache/zookeeper/server/jersey/jaxb/ZError.java,41,0,0.0,0,0,0.0,0,0,0.0,0,0,0.0,0,0,0,0,NO
19,src/contrib/rest/src/java/org/apache/zookeeper/server/jersey/jaxb/ZPath.java,63,0,0.0,0,0,0.0,0,0,0.0,0,0,0.0,0,0,0,0,NO
19,src/contrib/rest/src/java/org/apache/zookeeper/server/jersey/jaxb/ZSession.java,55,0,0.0,0,0,0.0,0,0,0.0,0,0,0.0,0,0,0,0,NO
19,src/contrib/rest/src/java/org/apache/zookeeper/server/jersey/jaxb/ZStat.java,106,0,0.0,0,0,0.0,0,0,0.0,0,0,0.0,0,0,0,0,NO
19,src/contrib/rest/src/java/org/apache/zookeeper/server/jersey/resources/JAXBContextResolver.java,72,0,0.0,0,0,0.0,0,0,0.0,0,0,0.0,0,0,0,0,NO
19,src/contrib/rest/src/java/org/apache/zookeeper/server/jersey/resources/KeeperExceptionMapper.java,86,0,0.0,0,0,0.0,0,0,0.0,0,0,0.0,0,0,0,0,NO
19,src/contrib/rest/src/java/org/apache/zookeeper/server/jersey/resources/RuntimeExceptionMapper.java,55,0,0.0,0,0,0.0,0,0,0.0,0,0,0.0,0,0,0,0,NO
19,src/contrib/rest/src/java/org/apache/zookeeper/server/jersey/resources/SessionsResource.java,135,0,0.0,0,0,0.0,0,0,0.0,0,0,0.0,0,0,0,0,NO
19,src/contrib/rest/src/java/org/apache/zookeeper/server/jersey/resources/ZErrorWriter.java,63,0,0.0,0,0,0.0,0,0,0.0,0,0,0.0,0,0,0,0,NO
19,src/contrib/rest/src/java/org/apache/zookeeper/server/jersey/resources/ZNodeResource.java,412,0,0.0,0,0,0.0,0,0,0.0,0,0,0.0,0,0,0,0,NO
19,src/contrib/zooinspector/src/java/com/nitido/utils/toaster/Toaster.java,533,0,0.0,0,0,0.0,0,0,0.0,0,0,0.0,0,0,0,0,NO
19,src/contrib/zooinspector/src/java/org/apache/zookeeper/inspector/ZooInspector.java,67,0,0.0,0,0,0.0,0,0,0.0,0,0,0.0,0,0,0,0,NO
19,src/contrib/zooinspector/src/java/org/apache/zookeeper/inspector/encryption/BasicDataEncryptionManager.java,50,0,0.0,0,0,0.0,0,0,0.0,0,0,0.0,0,0,0,0,NO
19,src/contrib/zooinspector/src/java/org/apache/zookeeper/inspector/encryption/DataEncryptionManager.java,39,0,0.0,0,0,0.0,0,0,0.0,0,0,0.0,0,0,0,0,NO
19,src/contrib/zooinspector/src/java/org/apache/zookeeper/inspector/gui/IconResource.java,88,0,0.0,0,0,0.0,0,0,0.0,0,0,0.0,0,0,0,0,NO
19,src/contrib/zooinspector/src/java/org/apache/zookeeper/inspector/gui/NodeViewersChangeListener.java,37,0,0.0,0,0,0.0,0,0,0.0,0,0,0.0,0,0,0,0,NO
19,src/contrib/zooinspector/src/java/org/apache/zookeeper/inspector/gui/Toolbar.java,74,0,0.0,0,0,0.0,0,0,0.0,0,0,0.0,0,0,0,0,NO
19,src/contrib/zooinspector/src/java/org/apache/zookeeper/inspector/gui/ZooInspectorAboutDialog.java,79,0,0.0,0,0,0.0,0,0,0.0,0,0,0.0,0,0,0,0,NO
19,src/contrib/zooinspector/src/java/org/apache/zookeeper/inspector/gui/ZooInspectorConnectionPropertiesDialog.java,321,0,0.0,0,0,0.0,0,0,0.0,0,0,0.0,0,0,0,0,NO
19,src/contrib/zooinspector/src/java/org/apache/zookeeper/inspector/gui/ZooInspectorNodeViewersDialog.java,631,0,0.0,0,0,0.0,0,0,0.0,0,0,0.0,0,0,0,0,NO
19,src/contrib/zooinspector/src/java/org/apache/zookeeper/inspector/gui/ZooInspectorNodeViewersPanel.java,140,0,0.0,0,0,0.0,0,0,0.0,0,0,0.0,0,0,0,0,NO
19,src/contrib/zooinspector/src/java/org/apache/zookeeper/inspector/gui/ZooInspectorPanel.java,318,0,0.0,0,0,0.0,0,0,0.0,0,0,0.0,0,0,0,0,NO
19,src/contrib/zooinspector/src/java/org/apache/zookeeper/inspector/gui/ZooInspectorTreeViewer.java,356,0,0.0,0,0,0.0,0,0,0.0,0,0,0.0,0,0,0,0,NO
19,src/contrib/zooinspector/src/java/org/apache/zookeeper/inspector/gui/nodeviewer/NodeViewerACL.java,187,0,0.0,0,0,0.0,0,0,0.0,0,0,0.0,0,0,0,0,NO
19,src/contrib/zooinspector/src/java/org/apache/zookeeper/inspector/gui/nodeviewer/NodeViewerData.java,142,0,0.0,0,0,0.0,0,0,0.0,0,0,0.0,0,0,0,0,NO
19,src/contrib/zooinspector/src/java/org/apache/zookeeper/inspector/gui/nodeviewer/NodeViewerMetaData.java,186,0,0.0,0,0,0.0,0,0,0.0,0,0,0.0,0,0,0,0,NO
19,src/contrib/zooinspector/src/java/org/apache/zookeeper/inspector/gui/nodeviewer/ZooInspectorNodeViewer.java,138,0,0.0,0,0,0.0,0,0,0.0,0,0,0.0,0,0,0,0,NO
19,src/contrib/zooinspector/src/java/org/apache/zookeeper/inspector/logger/LoggerFactory.java,36,0,0.0,0,0,0.0,0,0,0.0,0,0,0.0,0,0,0,0,NO
19,src/contrib/zooinspector/src/java/org/apache/zookeeper/inspector/manager/NodeListener.java,37,0,0.0,0,0,0.0,0,0,0.0,0,0,0.0,0,0,0,0,NO
19,src/contrib/zooinspector/src/java/org/apache/zookeeper/inspector/manager/Pair.java,120,0,0.0,0,0,0.0,0,0,0.0,0,0,0.0,0,0,0,0,NO
19,src/contrib/zooinspector/src/java/org/apache/zookeeper/inspector/manager/ZooInspectorManager.java,139,0,0.0,0,0,0.0,0,0,0.0,0,0,0.0,0,0,0,0,NO
19,src/contrib/zooinspector/src/java/org/apache/zookeeper/inspector/manager/ZooInspectorManagerImpl.java,852,0,0.0,0,0,0.0,0,0,0.0,0,0,0.0,0,0,0,0,YES
19,src/contrib/zooinspector/src/java/org/apache/zookeeper/inspector/manager/ZooInspectorNodeManager.java,33,0,0.0,0,0,0.0,0,0,0.0,0,0,0.0,0,0,0,0,NO
19,src/contrib/zooinspector/src/java/org/apache/zookeeper/inspector/manager/ZooInspectorNodeTreeManager.java,43,0,0.0,0,0,0.0,0,0,0.0,0,0,0.0,0,0,0,0,NO
19,src/contrib/zooinspector/src/java/org/apache/zookeeper/inspector/manager/ZooInspectorReadOnlyManager.java,99,0,0.0,0,0,0.0,0,0,0.0,0,0,0.0,0,0,0,0,NO
19,src/contrib/zooinspector/src/java/org/apache/zookeeper/retry/ZooKeeperRetry.java,288,0,0.0,0,0,0.0,0,0,0.0,0,0,0.0,0,0,0,0,NO
19,src/java/main/org/apache/jute/BinaryInputArchive.java,131,0,0.0,0,0,0.0,0,0,0.0,0,0,0.0,0,0,0,0,YES
19,src/java/main/org/apache/jute/BinaryOutputArchive.java,146,0,0.0,0,0,0.0,0,0,0.0,0,0,0.0,0,0,0,0,NO
19,src/java/main/org/apache/jute/CsvInputArchive.java,204,0,0.0,0,0,0.0,0,0,0.0,0,0,0.0,0,0,0,0,NO
19,src/java/main/org/apache/jute/CsvOutputArchive.java,150,0,0.0,0,0,0.0,0,0,0.0,0,0,0.0,0,0,0,0,NO
19,src/java/main/org/apache/jute/Index.java,38,0,0.0,0,0,0.0,0,0,0.0,0,0,0.0,0,0,0,0,NO
19,src/java/main/org/apache/jute/InputArchive.java,43,0,0.0,0,0,0.0,0,0,0.0,0,0,0.0,0,0,0,0,NO
19,src/java/main/org/apache/jute/OutputArchive.java,47,0,0.0,0,0,0.0,0,0,0.0,0,0,0.0,0,0,0,0,NO
19,src/java/main/org/apache/jute/Record.java,32,0,0.0,0,0,0.0,0,0,0.0,0,0,0.0,0,0,0,0,NO
19,src/java/main/org/apache/jute/RecordReader.java,93,0,0.0,0,0,0.0,0,0,0.0,0,0,0.0,0,0,0,0,NO
19,src/java/main/org/apache/jute/RecordWriter.java,93,0,0.0,0,0,0.0,0,0,0.0,0,0,0.0,0,0,0,0,NO
19,src/java/main/org/apache/jute/Utils.java,282,0,0.0,0,0,0.0,0,0,0.0,0,0,0.0,0,0,0,0,NO
19,src/java/main/org/apache/jute/XmlInputArchive.java,251,0,0.0,0,0,0.0,0,0,0.0,0,0,0.0,0,0,0,0,NO
19,src/java/main/org/apache/jute/XmlOutputArchive.java,251,0,0.0,0,0,0.0,0,0,0.0,0,0,0.0,0,0,0,0,NO
19,src/java/main/org/apache/jute/compiler/CGenerator.java,130,0,0.0,0,0,0.0,0,0,0.0,0,0,0.0,0,0,0,0,NO
19,src/java/main/org/apache/jute/compiler/CSharpGenerator.java,53,0,0.0,0,0,0.0,0,0,0.0,0,0,0.0,0,0,0,0,NO
19,src/java/main/org/apache/jute/compiler/CppGenerator.java,125,0,0.0,0,0,0.0,0,0,0.0,0,0,0.0,0,0,0,0,NO
19,src/java/main/org/apache/jute/compiler/JBoolean.java,50,0,0.0,0,0,0.0,0,0,0.0,0,0,0.0,0,0,0,0,NO
19,src/java/main/org/apache/jute/compiler/JBuffer.java,106,0,0.0,0,0,0.0,0,0,0.0,0,0,0.0,0,0,0,0,NO
19,src/java/main/org/apache/jute/compiler/JByte.java,34,0,0.0,0,0,0.0,0,0,0.0,0,0,0.0,0,0,0,0,NO
19,src/java/main/org/apache/jute/compiler/JCompType.java,66,0,0.0,0,0,0.0,0,0,0.0,0,0,0.0,0,0,0,0,NO
19,src/java/main/org/apache/jute/compiler/JDouble.java,40,0,0.0,0,0,0.0,0,0,0.0,0,0,0.0,0,0,0,0,NO
19,src/java/main/org/apache/jute/compiler/JField.java,140,0,0.0,0,0,0.0,0,0,0.0,0,0,0.0,0,0,0,0,NO
19,src/java/main/org/apache/jute/compiler/JFile.java,84,0,0.0,0,0,0.0,0,0,0.0,0,0,0.0,0,0,0,0,NO
19,src/java/main/org/apache/jute/compiler/JFloat.java,39,0,0.0,0,0,0.0,0,0,0.0,0,0,0.0,0,0,0,0,NO
19,src/java/main/org/apache/jute/compiler/JInt.java,34,0,0.0,0,0,0.0,0,0,0.0,0,0,0.0,0,0,0,0,NO
19,src/java/main/org/apache/jute/compiler/JLong.java,38,0,0.0,0,0,0.0,0,0,0.0,0,0,0.0,0,0,0,0,NO
19,src/java/main/org/apache/jute/compiler/JMap.java,149,0,0.0,0,0,0.0,0,0,0.0,0,0,0.0,0,0,0,0,NO
19,src/java/main/org/apache/jute/compiler/JRecord.java,761,0,0.0,0,0,0.0,0,0,0.0,0,0,0.0,0,0,0,0,NO
19,src/java/main/org/apache/jute/compiler/JString.java,46,0,0.0,0,0,0.0,0,0,0.0,0,0,0.0,0,0,0,0,NO
19,src/java/main/org/apache/jute/compiler/JType.java,204,0,0.0,0,0,0.0,0,0,0.0,0,0,0.0,0,0,0,0,NO
19,src/java/main/org/apache/jute/compiler/JVector.java,153,0,0.0,0,0,0.0,0,0,0.0,0,0,0.0,0,0,0,0,NO
19,src/java/main/org/apache/jute/compiler/JavaGenerator.java,57,0,0.0,0,0,0.0,0,0,0.0,0,0,0.0,0,0,0,0,NO
19,src/java/main/org/apache/zookeeper/AsyncCallback.java,57,0,0.0,0,0,0.0,0,0,0.0,0,0,0.0,0,0,0,0,NO
19,src/java/main/org/apache/zookeeper/ClientCnxn.java,1379,0,0.0,0,0,0.0,0,0,0.0,0,0,0.0,0,0,0,0,YES
19,src/java/main/org/apache/zookeeper/ClientCnxnSocket.java,174,0,0.0,0,0,0.0,0,0,0.0,0,0,0.0,0,0,0,0,NO
19,src/java/main/org/apache/zookeeper/ClientCnxnSocketNIO.java,416,53,53.0,53,51,51.0,51,104,104.0,104,2,2.0,2,1,1,1,NO
19,src/java/main/org/apache/zookeeper/ClientWatchManager.java,40,0,0.0,0,0,0.0,0,0,0.0,0,0,0.0,0,0,0,0,NO
19,src/java/main/org/apache/zookeeper/CreateMode.java,90,0,0.0,0,0,0.0,0,0,0.0,0,0,0.0,0,0,0,0,YES
19,src/java/main/org/apache/zookeeper/Environment.java,102,0,0.0,0,0,0.0,0,0,0.0,0,0,0.0,0,0,0,0,NO
19,src/java/main/org/apache/zookeeper/JLineZNodeCompletor.java,84,0,0.0,0,0,0.0,0,0,0.0,0,0,0.0,0,0,0,0,NO
19,src/java/main/org/apache/zookeeper/KeeperException.java,702,0,0.0,0,0,0.0,0,0,0.0,0,0,0.0,0,0,0,0,NO
19,src/java/main/org/apache/zookeeper/Login.java,396,4,4.0,4,0,0.0,0,4,4.0,4,4,4.0,4,1,1,1,NO
19,src/java/main/org/apache/zookeeper/MultiResponse.java,165,0,0.0,0,0,0.0,0,0,0.0,0,0,0.0,0,0,0,0,NO
19,src/java/main/org/apache/zookeeper/MultiTransactionRecord.java,159,0,0.0,0,0,0.0,0,0,0.0,0,0,0.0,0,0,0,0,NO
19,src/java/main/org/apache/zookeeper/Op.java,332,0,0.0,0,0,0.0,0,0,0.0,0,0,0.0,0,0,0,0,YES
19,src/java/main/org/apache/zookeeper/OpResult.java,185,0,0.0,0,0,0.0,0,0,0.0,0,0,0.0,0,0,0,0,NO
19,src/java/main/org/apache/zookeeper/Quotas.java,68,0,0.0,0,0,0.0,0,0,0.0,0,0,0.0,0,0,0,0,NO
19,src/java/main/org/apache/zookeeper/ServerAdminClient.java,277,0,0.0,0,0,0.0,0,0,0.0,0,0,0.0,0,0,0,0,NO
19,src/java/main/org/apache/zookeeper/Shell.java,476,0,0.0,0,0,0.0,0,0,0.0,0,0,0.0,0,0,0,0,NO
19,src/java/main/org/apache/zookeeper/StatsTrack.java,101,0,0.0,0,0,0.0,0,0,0.0,0,0,0.0,0,0,0,0,NO
19,src/java/main/org/apache/zookeeper/Transaction.java,63,0,0.0,0,0,0.0,0,0,0.0,0,0,0.0,0,0,0,0,NO
19,src/java/main/org/apache/zookeeper/Version.java,79,0,0.0,0,0,0.0,0,0,0.0,0,0,0.0,0,0,0,0,NO
19,src/java/main/org/apache/zookeeper/WatchedEvent.java,79,0,0.0,0,0,0.0,0,0,0.0,0,0,0.0,0,0,0,0,NO
19,src/java/main/org/apache/zookeeper/Watcher.java,149,0,0.0,0,0,0.0,0,0,0.0,0,0,0.0,0,0,0,0,NO
19,src/java/main/org/apache/zookeeper/ZKUtil.java,124,0,0.0,0,0,0.0,0,0,0.0,0,0,0.0,0,0,0,0,NO
19,src/java/main/org/apache/zookeeper/ZooDefs.java,119,0,0.0,0,0,0.0,0,0,0.0,0,0,0.0,0,0,0,0,NO
19,src/java/main/org/apache/zookeeper/ZooKeeper.java,1844,68,34.0,68,3,1.5,3,71,35.5,71,65,32.5,65,2,1,2,YES
19,src/java/main/org/apache/zookeeper/ZooKeeperMain.java,670,0,0.0,0,0,0.0,0,0,0.0,0,0,0.0,0,0,0,0,YES
19,src/java/main/org/apache/zookeeper/cli/AclParser.java,81,0,0.0,0,0,0.0,0,0,0.0,0,0,0.0,0,0,0,0,NO
19,src/java/main/org/apache/zookeeper/cli/AddAuthCommand.java,64,0,0.0,0,0,0.0,0,0,0.0,0,0,0.0,0,0,0,0,NO
19,src/java/main/org/apache/zookeeper/cli/CliCommand.java,119,0,0.0,0,0,0.0,0,0,0.0,0,0,0.0,0,0,0,0,NO
19,src/java/main/org/apache/zookeeper/cli/CloseCommand.java,46,0,0.0,0,0,0.0,0,0,0.0,0,0,0.0,0,0,0,0,NO
19,src/java/main/org/apache/zookeeper/cli/CreateCommand.java,81,0,0.0,0,0,0.0,0,0,0.0,0,0,0.0,0,0,0,0,NO
19,src/java/main/org/apache/zookeeper/cli/DelQuotaCommand.java,152,0,0.0,0,0,0.0,0,0,0.0,0,0,0.0,0,0,0,0,NO
19,src/java/main/org/apache/zookeeper/cli/DeleteAllCommand.java,72,0,0.0,0,0,0.0,0,0,0.0,0,0,0.0,0,0,0,0,NO
19,src/java/main/org/apache/zookeeper/cli/DeleteCommand.java,88,0,0.0,0,0,0.0,0,0,0.0,0,0,0.0,0,0,0,0,NO
19,src/java/main/org/apache/zookeeper/cli/GetAclCommand.java,94,0,0.0,0,0,0.0,0,0,0.0,0,0,0.0,0,0,0,0,NO
19,src/java/main/org/apache/zookeeper/cli/GetCommand.java,83,0,0.0,0,0,0.0,0,0,0.0,0,0,0.0,0,0,0,0,NO
19,src/java/main/org/apache/zookeeper/cli/ListQuotaCommand.java,74,0,0.0,0,0,0.0,0,0,0.0,0,0,0.0,0,0,0,0,NO
19,src/java/main/org/apache/zookeeper/cli/Ls2Command.java,62,0,0.0,0,0,0.0,0,0,0.0,0,0,0.0,0,0,0,0,NO
19,src/java/main/org/apache/zookeeper/cli/LsCommand.java,85,0,0.0,0,0,0.0,0,0,0.0,0,0,0.0,0,0,0,0,NO
19,src/java/main/org/apache/zookeeper/cli/SetAclCommand.java,82,0,0.0,0,0,0.0,0,0,0.0,0,0,0.0,0,0,0,0,NO
19,src/java/main/org/apache/zookeeper/cli/SetCommand.java,75,0,0.0,0,0,0.0,0,0,0.0,0,0,0.0,0,0,0,0,NO
19,src/java/main/org/apache/zookeeper/cli/SetQuotaCommand.java,200,0,0.0,0,0,0.0,0,0,0.0,0,0,0.0,0,0,0,0,NO
19,src/java/main/org/apache/zookeeper/cli/StatCommand.java,81,0,0.0,0,0,0.0,0,0,0.0,0,0,0.0,0,0,0,0,NO
19,src/java/main/org/apache/zookeeper/cli/StatPrinter.java,49,0,0.0,0,0,0.0,0,0,0.0,0,0,0.0,0,0,0,0,NO
19,src/java/main/org/apache/zookeeper/cli/SyncCommand.java,64,0,0.0,0,0,0.0,0,0,0.0,0,0,0.0,0,0,0,0,NO
19,src/java/main/org/apache/zookeeper/client/ConnectStringParser.java,87,0,0.0,0,0,0.0,0,0,0.0,0,0,0.0,0,0,0,0,NO
19,src/java/main/org/apache/zookeeper/client/FourLetterWordMain.java,79,0,0.0,0,0,0.0,0,0,0.0,0,0,0.0,0,0,0,0,NO
19,src/java/main/org/apache/zookeeper/client/HostProvider.java,72,11,11.0,11,0,0.0,0,11,11.0,11,11,11.0,11,1,0,1,NO
19,src/java/main/org/apache/zookeeper/client/StaticHostProvider.java,306,221,221.0,221,16,16.0,16,237,237.0,237,205,205.0,205,1,0,1,NO
19,src/java/main/org/apache/zookeeper/client/ZooKeeperSaslClient.java,526,11,11.0,11,7,7.0,7,18,18.0,18,4,4.0,4,1,1,1,YES
19,src/java/main/org/apache/zookeeper/common/AtomicFileOutputStream.java,115,0,0.0,0,0,0.0,0,0,0.0,0,0,0.0,0,0,0,0,NO
19,src/java/main/org/apache/zookeeper/common/IOUtils.java,123,0,0.0,0,0,0.0,0,0,0.0,0,0,0.0,0,0,0,0,NO
19,src/java/main/org/apache/zookeeper/common/PathTrie.java,284,0,0.0,0,0,0.0,0,0,0.0,0,0,0.0,0,0,0,0,YES
19,src/java/main/org/apache/zookeeper/common/PathUtils.java,103,0,0.0,0,0,0.0,0,0,0.0,0,0,0.0,0,0,0,0,YES
19,src/java/main/org/apache/zookeeper/jmx/CommonNames.java,29,0,0.0,0,0,0.0,0,0,0.0,0,0,0.0,0,0,0,0,NO
19,src/java/main/org/apache/zookeeper/jmx/MBeanRegistry.java,215,0,0.0,0,0,0.0,0,0,0.0,0,0,0.0,0,0,0,0,NO
19,src/java/main/org/apache/zookeeper/jmx/ManagedUtil.java,71,0,0.0,0,0,0.0,0,0,0.0,0,0,0.0,0,0,0,0,NO
19,src/java/main/org/apache/zookeeper/jmx/ZKMBeanInfo.java,36,0,0.0,0,0,0.0,0,0,0.0,0,0,0.0,0,0,0,0,NO
19,src/java/main/org/apache/zookeeper/server/ByteBufferInputStream.java,82,0,0.0,0,0,0.0,0,0,0.0,0,0,0.0,0,0,0,0,NO
19,src/java/main/org/apache/zookeeper/server/ByteBufferOutputStream.java,51,0,0.0,0,0,0.0,0,0,0.0,0,0,0.0,0,0,0,0,NO
19,src/java/main/org/apache/zookeeper/server/ConnectionBean.java,173,0,0.0,0,0,0.0,0,0,0.0,0,0,0.0,0,0,0,0,NO
19,src/java/main/org/apache/zookeeper/server/ConnectionMXBean.java,98,0,0.0,0,0,0.0,0,0,0.0,0,0,0.0,0,0,0,0,NO
19,src/java/main/org/apache/zookeeper/server/DataNode.java,174,0,0.0,0,0,0.0,0,0,0.0,0,0,0.0,0,0,0,0,NO
19,src/java/main/org/apache/zookeeper/server/DataTree.java,1302,0,0.0,0,0,0.0,0,0,0.0,0,0,0.0,0,0,0,0,YES
19,src/java/main/org/apache/zookeeper/server/DataTreeBean.java,61,0,0.0,0,0,0.0,0,0,0.0,0,0,0.0,0,0,0,0,NO
19,src/java/main/org/apache/zookeeper/server/DataTreeMXBean.java,47,0,0.0,0,0,0.0,0,0,0.0,0,0,0.0,0,0,0,0,NO
19,src/java/main/org/apache/zookeeper/server/DatadirCleanupManager.java,192,0,0.0,0,0,0.0,0,0,0.0,0,0,0.0,0,0,0,0,NO
19,src/java/main/org/apache/zookeeper/server/FinalRequestProcessor.java,414,0,0.0,0,0,0.0,0,0,0.0,0,0,0.0,0,0,0,0,NO
19,src/java/main/org/apache/zookeeper/server/LogFormatter.java,104,0,0.0,0,0,0.0,0,0,0.0,0,0,0.0,0,0,0,0,NO
19,src/java/main/org/apache/zookeeper/server/NIOServerCnxn.java,1157,0,0.0,0,0,0.0,0,0,0.0,0,0,0.0,0,0,0,0,YES
19,src/java/main/org/apache/zookeeper/server/NIOServerCnxnFactory.java,309,0,0.0,0,0,0.0,0,0,0.0,0,0,0.0,0,0,0,0,NO
19,src/java/main/org/apache/zookeeper/server/NettyServerCnxn.java,852,0,0.0,0,0,0.0,0,0,0.0,0,0,0.0,0,0,0,0,YES
19,src/java/main/org/apache/zookeeper/server/NettyServerCnxnFactory.java,400,2,2.0,2,1,1.0,1,3,3.0,3,1,1.0,1,1,0,1,YES
19,src/java/main/org/apache/zookeeper/server/ObserverBean.java,45,0,0.0,0,0,0.0,0,0,0.0,0,0,0.0,0,0,0,0,NO
19,src/java/main/org/apache/zookeeper/server/PrepRequestProcessor.java,738,0,0.0,0,0,0.0,0,0,0.0,0,0,0.0,0,0,0,0,YES
19,src/java/main/org/apache/zookeeper/server/PurgeTxnLog.java,129,0,0.0,0,0,0.0,0,0,0.0,0,0,0.0,0,0,0,0,NO
19,src/java/main/org/apache/zookeeper/server/Request.java,256,0,0.0,0,0,0.0,0,0,0.0,0,0,0.0,0,0,0,0,NO
19,src/java/main/org/apache/zookeeper/server/RequestProcessor.java,44,0,0.0,0,0,0.0,0,0,0.0,0,0,0.0,0,0,0,0,NO
19,src/java/main/org/apache/zookeeper/server/ServerCnxn.java,452,0,0.0,0,0,0.0,0,0,0.0,0,0,0.0,0,0,0,0,NO
19,src/java/main/org/apache/zookeeper/server/ServerCnxnFactory.java,209,0,0.0,0,0,0.0,0,0,0.0,0,0,0.0,0,0,0,0,NO
19,src/java/main/org/apache/zookeeper/server/ServerConfig.java,112,0,0.0,0,0,0.0,0,0,0.0,0,0,0.0,0,0,0,0,NO
19,src/java/main/org/apache/zookeeper/server/ServerStats.java,140,0,0.0,0,0,0.0,0,0,0.0,0,0,0.0,0,0,0,0,NO
19,src/java/main/org/apache/zookeeper/server/SessionTracker.java,81,0,0.0,0,0,0.0,0,0,0.0,0,0,0.0,0,0,0,0,NO
19,src/java/main/org/apache/zookeeper/server/SessionTrackerImpl.java,279,0,0.0,0,0,0.0,0,0,0.0,0,0,0.0,0,0,0,0,YES
19,src/java/main/org/apache/zookeeper/server/SnapshotFormatter.java,124,0,0.0,0,0,0.0,0,0,0.0,0,0,0.0,0,0,0,0,NO
19,src/java/main/org/apache/zookeeper/server/Stats.java,68,0,0.0,0,0,0.0,0,0,0.0,0,0,0.0,0,0,0,0,NO
19,src/java/main/org/apache/zookeeper/server/SyncRequestProcessor.java,192,0,0.0,0,0,0.0,0,0,0.0,0,0,0.0,0,0,0,0,YES
19,src/java/main/org/apache/zookeeper/server/TraceFormatter.java,123,0,0.0,0,0,0.0,0,0,0.0,0,0,0.0,0,0,0,0,NO
19,src/java/main/org/apache/zookeeper/server/WatchManager.java,171,0,0.0,0,0,0.0,0,0,0.0,0,0,0.0,0,0,0,0,NO
19,src/java/main/org/apache/zookeeper/server/ZKDatabase.java,490,0,0.0,0,0,0.0,0,0,0.0,0,0,0.0,0,0,0,0,YES
19,src/java/main/org/apache/zookeeper/server/ZooKeeperSaslServer.java,130,0,0.0,0,0,0.0,0,0,0.0,0,0,0.0,0,0,0,0,YES
19,src/java/main/org/apache/zookeeper/server/ZooKeeperServer.java,961,0,0.0,0,0,0.0,0,0,0.0,0,0,0.0,0,0,0,0,YES
19,src/java/main/org/apache/zookeeper/server/ZooKeeperServerBean.java,147,0,0.0,0,0,0.0,0,0,0.0,0,0,0.0,0,0,0,0,NO
19,src/java/main/org/apache/zookeeper/server/ZooKeeperServerMXBean.java,110,0,0.0,0,0,0.0,0,0,0.0,0,0,0.0,0,0,0,0,NO
19,src/java/main/org/apache/zookeeper/server/ZooKeeperServerMain.java,128,0,0.0,0,0,0.0,0,0,0.0,0,0,0.0,0,0,0,0,NO
19,src/java/main/org/apache/zookeeper/server/ZooTrace.java,93,0,0.0,0,0,0.0,0,0,0.0,0,0,0.0,0,0,0,0,NO
19,src/java/main/org/apache/zookeeper/server/auth/AuthenticationProvider.java,82,0,0.0,0,0,0.0,0,0,0.0,0,0,0.0,0,0,0,0,NO
19,src/java/main/org/apache/zookeeper/server/auth/DigestAuthenticationProvider.java,139,0,0.0,0,0,0.0,0,0,0.0,0,0,0.0,0,0,0,0,NO
19,src/java/main/org/apache/zookeeper/server/auth/DigestLoginModule.java,59,0,0.0,0,0,0.0,0,0,0.0,0,0,0.0,0,0,0,0,NO
19,src/java/main/org/apache/zookeeper/server/auth/IPAuthenticationProvider.java,117,0,0.0,0,0,0.0,0,0,0.0,0,0,0.0,0,0,0,0,NO
19,src/java/main/org/apache/zookeeper/server/auth/KerberosName.java,418,0,0.0,0,0,0.0,0,0,0.0,0,0,0.0,0,0,0,0,NO
19,src/java/main/org/apache/zookeeper/server/auth/ProviderRegistry.java,77,0,0.0,0,0,0.0,0,0,0.0,0,0,0.0,0,0,0,0,NO
19,src/java/main/org/apache/zookeeper/server/auth/SASLAuthenticationProvider.java,70,0,0.0,0,0,0.0,0,0,0.0,0,0,0.0,0,0,0,0,NO
19,src/java/main/org/apache/zookeeper/server/auth/SaslServerCallbackHandler.java,152,0,0.0,0,0,0.0,0,0,0.0,0,0,0.0,0,0,0,0,NO
19,src/java/main/org/apache/zookeeper/server/persistence/FileSnap.java,250,0,0.0,0,0,0.0,0,0,0.0,0,0,0.0,0,0,0,0,NO
19,src/java/main/org/apache/zookeeper/server/persistence/FileTxnLog.java,661,0,0.0,0,0,0.0,0,0,0.0,0,0,0.0,0,0,0,0,YES
19,src/java/main/org/apache/zookeeper/server/persistence/FileTxnSnapLog.java,381,0,0.0,0,0,0.0,0,0,0.0,0,0,0.0,0,0,0,0,YES
19,src/java/main/org/apache/zookeeper/server/persistence/SnapShot.java,66,0,0.0,0,0,0.0,0,0,0.0,0,0,0.0,0,0,0,0,NO
19,src/java/main/org/apache/zookeeper/server/persistence/TxnLog.java,120,0,0.0,0,0,0.0,0,0,0.0,0,0,0.0,0,0,0,0,NO
19,src/java/main/org/apache/zookeeper/server/persistence/Util.java,326,0,0.0,0,0,0.0,0,0,0.0,0,0,0.0,0,0,0,0,NO
19,src/java/main/org/apache/zookeeper/server/quorum/AckRequestProcessor.java,54,0,0.0,0,0,0.0,0,0,0.0,0,0,0.0,0,0,0,0,NO
19,src/java/main/org/apache/zookeeper/server/quorum/AuthFastLeaderElection.java,972,0,0.0,0,0,0.0,0,0,0.0,0,0,0.0,0,0,0,0,NO
19,src/java/main/org/apache/zookeeper/server/quorum/CommitProcessor.java,185,0,0.0,0,0,0.0,0,0,0.0,0,0,0.0,0,0,0,0,NO
19,src/java/main/org/apache/zookeeper/server/quorum/Election.java,27,0,0.0,0,0,0.0,0,0,0.0,0,0,0.0,0,0,0,0,NO
19,src/java/main/org/apache/zookeeper/server/quorum/FastLeaderElection.java,903,0,0.0,0,0,0.0,0,0,0.0,0,0,0.0,0,0,0,0,YES
19,src/java/main/org/apache/zookeeper/server/quorum/Follower.java,167,0,0.0,0,0,0.0,0,0,0.0,0,0,0.0,0,0,0,0,NO
19,src/java/main/org/apache/zookeeper/server/quorum/FollowerBean.java,50,0,0.0,0,0,0.0,0,0,0.0,0,0,0.0,0,0,0,0,NO
19,src/java/main/org/apache/zookeeper/server/quorum/FollowerMXBean.java,41,0,0.0,0,0,0.0,0,0,0.0,0,0,0.0,0,0,0,0,NO
19,src/java/main/org/apache/zookeeper/server/quorum/FollowerRequestProcessor.java,113,0,0.0,0,0,0.0,0,0,0.0,0,0,0.0,0,0,0,0,NO
19,src/java/main/org/apache/zookeeper/server/quorum/FollowerZooKeeperServer.java,160,0,0.0,0,0,0.0,0,0,0.0,0,0,0.0,0,0,0,0,NO
19,src/java/main/org/apache/zookeeper/server/quorum/Leader.java,958,0,0.0,0,0,0.0,0,0,0.0,0,0,0.0,0,0,0,0,YES
19,src/java/main/org/apache/zookeeper/server/quorum/LeaderBean.java,53,0,0.0,0,0,0.0,0,0,0.0,0,0,0.0,0,0,0,0,NO
19,src/java/main/org/apache/zookeeper/server/quorum/LeaderElection.java,293,0,0.0,0,0,0.0,0,0,0.0,0,0,0.0,0,0,0,0,NO
19,src/java/main/org/apache/zookeeper/server/quorum/LeaderElectionBean.java,42,0,0.0,0,0,0.0,0,0,0.0,0,0,0.0,0,0,0,0,NO
19,src/java/main/org/apache/zookeeper/server/quorum/LeaderElectionMXBean.java,31,0,0.0,0,0,0.0,0,0,0.0,0,0,0.0,0,0,0,0,NO
19,src/java/main/org/apache/zookeeper/server/quorum/LeaderMXBean.java,36,0,0.0,0,0,0.0,0,0,0.0,0,0,0.0,0,0,0,0,NO
19,src/java/main/org/apache/zookeeper/server/quorum/LeaderZooKeeperServer.java,177,0,0.0,0,0,0.0,0,0,0.0,0,0,0.0,0,0,0,0,NO
19,src/java/main/org/apache/zookeeper/server/quorum/Learner.java,482,0,0.0,0,0,0.0,0,0,0.0,0,0,0.0,0,0,0,0,YES
19,src/java/main/org/apache/zookeeper/server/quorum/LearnerHandler.java,629,0,0.0,0,0,0.0,0,0,0.0,0,0,0.0,0,0,0,0,YES
19,src/java/main/org/apache/zookeeper/server/quorum/LearnerSessionTracker.java,96,0,0.0,0,0,0.0,0,0,0.0,0,0,0.0,0,0,0,0,NO
19,src/java/main/org/apache/zookeeper/server/quorum/LearnerSyncRequest.java,34,0,0.0,0,0,0.0,0,0,0.0,0,0,0.0,0,0,0,0,NO
19,src/java/main/org/apache/zookeeper/server/quorum/LearnerZooKeeperServer.java,144,0,0.0,0,0,0.0,0,0,0.0,0,0,0.0,0,0,0,0,NO
19,src/java/main/org/apache/zookeeper/server/quorum/LocalPeerBean.java,79,0,0.0,0,0,0.0,0,0,0.0,0,0,0.0,0,0,0,0,NO
19,src/java/main/org/apache/zookeeper/server/quorum/LocalPeerMXBean.java,77,0,0.0,0,0,0.0,0,0,0.0,0,0,0.0,0,0,0,0,NO
19,src/java/main/org/apache/zookeeper/server/quorum/Observer.java,134,0,0.0,0,0,0.0,0,0,0.0,0,0,0.0,0,0,0,0,NO
19,src/java/main/org/apache/zookeeper/server/quorum/ObserverMXBean.java,37,0,0.0,0,0,0.0,0,0,0.0,0,0,0.0,0,0,0,0,NO
19,src/java/main/org/apache/zookeeper/server/quorum/ObserverRequestProcessor.java,127,0,0.0,0,0,0.0,0,0,0.0,0,0,0.0,0,0,0,0,NO
19,src/java/main/org/apache/zookeeper/server/quorum/ObserverZooKeeperServer.java,115,0,0.0,0,0,0.0,0,0,0.0,0,0,0.0,0,0,0,0,YES
19,src/java/main/org/apache/zookeeper/server/quorum/ProposalRequestProcessor.java,93,0,0.0,0,0,0.0,0,0,0.0,0,0,0.0,0,0,0,0,NO
19,src/java/main/org/apache/zookeeper/server/quorum/QuorumBean.java,44,0,0.0,0,0,0.0,0,0,0.0,0,0,0.0,0,0,0,0,NO
19,src/java/main/org/apache/zookeeper/server/quorum/QuorumCnxManager.java,884,0,0.0,0,0,0.0,0,0,0.0,0,0,0.0,0,0,0,0,NO
19,src/java/main/org/apache/zookeeper/server/quorum/QuorumMXBean.java,34,0,0.0,0,0,0.0,0,0,0.0,0,0,0.0,0,0,0,0,NO
19,src/java/main/org/apache/zookeeper/server/quorum/QuorumPeer.java,1343,0,0.0,0,0,0.0,0,0,0.0,0,0,0.0,0,0,0,0,YES
19,src/java/main/org/apache/zookeeper/server/quorum/QuorumPeerConfig.java,511,1,1.0,1,1,1.0,1,2,2.0,2,0,0.0,0,1,0,1,NO
19,src/java/main/org/apache/zookeeper/server/quorum/QuorumPeerMain.java,164,0,0.0,0,0,0.0,0,0,0.0,0,0,0.0,0,0,0,0,NO
19,src/java/main/org/apache/zookeeper/server/quorum/QuorumStats.java,68,0,0.0,0,0,0.0,0,0,0.0,0,0,0.0,0,0,0,0,NO
19,src/java/main/org/apache/zookeeper/server/quorum/QuorumZooKeeperServer.java,58,0,0.0,0,0,0.0,0,0,0.0,0,0,0.0,0,0,0,0,NO
19,src/java/main/org/apache/zookeeper/server/quorum/ReadOnlyBean.java,38,0,0.0,0,0,0.0,0,0,0.0,0,0,0.0,0,0,0,0,NO
19,src/java/main/org/apache/zookeeper/server/quorum/ReadOnlyRequestProcessor.java,129,0,0.0,0,0,0.0,0,0,0.0,0,0,0.0,0,0,0,0,NO
19,src/java/main/org/apache/zookeeper/server/quorum/ReadOnlyZooKeeperServer.java,144,0,0.0,0,0,0.0,0,0,0.0,0,0,0.0,0,0,0,0,NO
19,src/java/main/org/apache/zookeeper/server/quorum/RemotePeerBean.java,45,0,0.0,0,0,0.0,0,0,0.0,0,0,0.0,0,0,0,0,NO
19,src/java/main/org/apache/zookeeper/server/quorum/RemotePeerMXBean.java,33,0,0.0,0,0,0.0,0,0,0.0,0,0,0.0,0,0,0,0,NO
19,src/java/main/org/apache/zookeeper/server/quorum/SendAckRequestProcessor.java,80,0,0.0,0,0,0.0,0,0,0.0,0,0,0.0,0,0,0,0,NO
19,src/java/main/org/apache/zookeeper/server/quorum/ServerBean.java,38,0,0.0,0,0,0.0,0,0,0.0,0,0,0.0,0,0,0,0,NO
19,src/java/main/org/apache/zookeeper/server/quorum/ServerMXBean.java,33,0,0.0,0,0,0.0,0,0,0.0,0,0,0.0,0,0,0,0,NO
19,src/java/main/org/apache/zookeeper/server/quorum/StateSummary.java,57,0,0.0,0,0,0.0,0,0,0.0,0,0,0.0,0,0,0,0,NO
19,src/java/main/org/apache/zookeeper/server/quorum/Vote.java,106,0,0.0,0,0,0.0,0,0,0.0,0,0,0.0,0,0,0,0,NO
19,src/java/main/org/apache/zookeeper/server/quorum/flexible/QuorumHierarchical.java,374,0,0.0,0,0,0.0,0,0,0.0,0,0,0.0,0,0,0,0,YES
19,src/java/main/org/apache/zookeeper/server/quorum/flexible/QuorumMaj.java,153,0,0.0,0,0,0.0,0,0,0.0,0,0,0.0,0,0,0,0,NO
19,src/java/main/org/apache/zookeeper/server/quorum/flexible/QuorumVerifier.java,42,0,0.0,0,0,0.0,0,0,0.0,0,0,0.0,0,0,0,0,NO
19,src/java/main/org/apache/zookeeper/server/util/KerberosUtil.java,45,0,0.0,0,0,0.0,0,0,0.0,0,0,0.0,0,0,0,0,NO
19,src/java/main/org/apache/zookeeper/server/util/SerializeUtils.java,141,0,0.0,0,0,0.0,0,0,0.0,0,0,0.0,0,0,0,0,NO
19,src/java/main/org/apache/zookeeper/server/util/VerifyingFileFactory.java,82,0,0.0,0,0,0.0,0,0,0.0,0,0,0.0,0,0,0,0,NO
19,src/java/main/org/apache/zookeeper/server/util/ZxidUtils.java,34,0,0.0,0,0,0.0,0,0,0.0,0,0,0.0,0,0,0,0,NO
19,src/java/main/org/apache/zookeeper/version/util/VerGen.java,177,0,0.0,0,0,0.0,0,0,0.0,0,0,0.0,0,0,0,0,NO
19,src/recipes/election/src/java/org/apache/zookeeper/recipes/leader/LeaderElectionAware.java,37,0,0.0,0,0,0.0,0,0,0.0,0,0,0.0,0,0,0,0,NO
19,src/recipes/election/src/java/org/apache/zookeeper/recipes/leader/LeaderElectionSupport.java,461,0,0.0,0,0,0.0,0,0,0.0,0,0,0.0,0,0,0,0,NO
19,src/recipes/election/src/java/org/apache/zookeeper/recipes/leader/LeaderOffer.java,84,0,0.0,0,0,0.0,0,0,0.0,0,0,0.0,0,0,0,0,NO
19,src/recipes/lock/src/java/org/apache/zookeeper/recipes/lock/LockListener.java,38,0,0.0,0,0,0.0,0,0,0.0,0,0,0.0,0,0,0,0,NO
19,src/recipes/lock/src/java/org/apache/zookeeper/recipes/lock/ProtocolSupport.java,193,0,0.0,0,0,0.0,0,0,0.0,0,0,0.0,0,0,0,0,NO
19,src/recipes/lock/src/java/org/apache/zookeeper/recipes/lock/WriteLock.java,295,0,0.0,0,0,0.0,0,0,0.0,0,0,0.0,0,0,0,0,NO
19,src/recipes/lock/src/java/org/apache/zookeeper/recipes/lock/ZNodeName.java,110,0,0.0,0,0,0.0,0,0,0.0,0,0,0.0,0,0,0,0,NO
19,src/recipes/lock/src/java/org/apache/zookeeper/recipes/lock/ZooKeeperOperation.java,38,0,0.0,0,0,0.0,0,0,0.0,0,0,0.0,0,0,0,0,NO
19,src/recipes/queue/src/java/org/apache/zookeeper/recipes/queue/DistributedQueue.java,313,0,0.0,0,0,0.0,0,0,0.0,0,0,0.0,0,0,0,0,NO
20,src/contrib/fatjar/src/java/org/apache/zookeeper/util/FatJarMain.java,126,0,0.0,0,0,0.0,0,0,0.0,0,0,0.0,0,0,0,0,NO
20,src/contrib/loggraph/src/java/org/apache/zookeeper/graph/FilterException.java,22,0,0.0,0,0,0.0,0,0,0.0,0,0,0.0,0,0,0,0,NO
20,src/contrib/loggraph/src/java/org/apache/zookeeper/graph/FilterOp.java,75,0,0.0,0,0,0.0,0,0,0.0,0,0,0.0,0,0,0,0,NO
20,src/contrib/loggraph/src/java/org/apache/zookeeper/graph/FilterParser.java,131,0,0.0,0,0,0.0,0,0,0.0,0,0,0.0,0,0,0,0,NO
20,src/contrib/loggraph/src/java/org/apache/zookeeper/graph/JsonGenerator.java,223,0,0.0,0,0,0.0,0,0,0.0,0,0,0.0,0,0,0,0,NO
20,src/contrib/loggraph/src/java/org/apache/zookeeper/graph/Log4JEntry.java,40,0,0.0,0,0,0.0,0,0,0.0,0,0,0.0,0,0,0,0,NO
20,src/contrib/loggraph/src/java/org/apache/zookeeper/graph/Log4JSource.java,381,0,0.0,0,0,0.0,0,0,0.0,0,0,0.0,0,0,0,0,NO
20,src/contrib/loggraph/src/java/org/apache/zookeeper/graph/LogEntry.java,46,0,0.0,0,0,0.0,0,0,0.0,0,0,0.0,0,0,0,0,NO
20,src/contrib/loggraph/src/java/org/apache/zookeeper/graph/LogIterator.java,26,0,0.0,0,0,0.0,0,0,0.0,0,0,0.0,0,0,0,0,NO
20,src/contrib/loggraph/src/java/org/apache/zookeeper/graph/LogServer.java,66,0,0.0,0,0,0.0,0,0,0.0,0,0,0.0,0,0,0,0,NO
20,src/contrib/loggraph/src/java/org/apache/zookeeper/graph/LogSkipList.java,95,0,0.0,0,0,0.0,0,0,0.0,0,0,0.0,0,0,0,0,NO
20,src/contrib/loggraph/src/java/org/apache/zookeeper/graph/LogSource.java,33,0,0.0,0,0,0.0,0,0,0.0,0,0,0.0,0,0,0,0,NO
20,src/contrib/loggraph/src/java/org/apache/zookeeper/graph/MeasureThroughput.java,103,0,0.0,0,0,0.0,0,0,0.0,0,0,0.0,0,0,0,0,NO
20,src/contrib/loggraph/src/java/org/apache/zookeeper/graph/MergedLogSource.java,219,0,0.0,0,0,0.0,0,0,0.0,0,0,0.0,0,0,0,0,NO
20,src/contrib/loggraph/src/java/org/apache/zookeeper/graph/RandomAccessFileReader.java,328,0,0.0,0,0,0.0,0,0,0.0,0,0,0.0,0,0,0,0,NO
20,src/contrib/loggraph/src/java/org/apache/zookeeper/graph/TransactionEntry.java,59,0,0.0,0,0,0.0,0,0,0.0,0,0,0.0,0,0,0,0,NO
20,src/contrib/loggraph/src/java/org/apache/zookeeper/graph/TxnLogSource.java,376,0,0.0,0,0,0.0,0,0,0.0,0,0,0.0,0,0,0,0,NO
20,src/contrib/loggraph/src/java/org/apache/zookeeper/graph/filterops/AndOp.java,33,0,0.0,0,0,0.0,0,0,0.0,0,0,0.0,0,0,0,0,NO
20,src/contrib/loggraph/src/java/org/apache/zookeeper/graph/filterops/Arg.java,36,0,0.0,0,0,0.0,0,0,0.0,0,0,0.0,0,0,0,0,NO
20,src/contrib/loggraph/src/java/org/apache/zookeeper/graph/filterops/EqualsOp.java,44,0,0.0,0,0,0.0,0,0,0.0,0,0,0.0,0,0,0,0,NO
20,src/contrib/loggraph/src/java/org/apache/zookeeper/graph/filterops/GreaterThanOp.java,70,0,0.0,0,0,0.0,0,0,0.0,0,0,0.0,0,0,0,0,NO
20,src/contrib/loggraph/src/java/org/apache/zookeeper/graph/filterops/LessThanOp.java,69,0,0.0,0,0,0.0,0,0,0.0,0,0,0.0,0,0,0,0,NO
20,src/contrib/loggraph/src/java/org/apache/zookeeper/graph/filterops/NotOp.java,31,0,0.0,0,0,0.0,0,0,0.0,0,0,0.0,0,0,0,0,NO
20,src/contrib/loggraph/src/java/org/apache/zookeeper/graph/filterops/NumberArg.java,27,0,0.0,0,0,0.0,0,0,0.0,0,0,0.0,0,0,0,0,NO
20,src/contrib/loggraph/src/java/org/apache/zookeeper/graph/filterops/OrOp.java,33,0,0.0,0,0,0.0,0,0,0.0,0,0,0.0,0,0,0,0,NO
20,src/contrib/loggraph/src/java/org/apache/zookeeper/graph/filterops/StringArg.java,27,0,0.0,0,0,0.0,0,0,0.0,0,0,0.0,0,0,0,0,NO
20,src/contrib/loggraph/src/java/org/apache/zookeeper/graph/filterops/SymbolArg.java,27,0,0.0,0,0,0.0,0,0,0.0,0,0,0.0,0,0,0,0,NO
20,src/contrib/loggraph/src/java/org/apache/zookeeper/graph/filterops/XorOp.java,40,0,0.0,0,0,0.0,0,0,0.0,0,0,0.0,0,0,0,0,NO
20,src/contrib/loggraph/src/java/org/apache/zookeeper/graph/servlets/FileLoader.java,60,0,0.0,0,0,0.0,0,0,0.0,0,0,0.0,0,0,0,0,NO
20,src/contrib/loggraph/src/java/org/apache/zookeeper/graph/servlets/Fs.java,69,0,0.0,0,0,0.0,0,0,0.0,0,0,0.0,0,0,0,0,NO
20,src/contrib/loggraph/src/java/org/apache/zookeeper/graph/servlets/GraphData.java,85,0,0.0,0,0,0.0,0,0,0.0,0,0,0.0,0,0,0,0,NO
20,src/contrib/loggraph/src/java/org/apache/zookeeper/graph/servlets/JsonServlet.java,85,0,0.0,0,0,0.0,0,0,0.0,0,0,0.0,0,0,0,0,NO
20,src/contrib/loggraph/src/java/org/apache/zookeeper/graph/servlets/NumEvents.java,86,0,0.0,0,0,0.0,0,0,0.0,0,0,0.0,0,0,0,0,NO
20,src/contrib/loggraph/src/java/org/apache/zookeeper/graph/servlets/StaticContent.java,50,0,0.0,0,0,0.0,0,0,0.0,0,0,0.0,0,0,0,0,NO
20,src/contrib/loggraph/src/java/org/apache/zookeeper/graph/servlets/Throughput.java,125,0,0.0,0,0,0.0,0,0,0.0,0,0,0.0,0,0,0,0,NO
20,src/contrib/rest/src/java/org/apache/zookeeper/server/jersey/RestMain.java,151,0,0.0,0,0,0.0,0,0,0.0,0,0,0.0,0,0,0,0,NO
20,src/contrib/rest/src/java/org/apache/zookeeper/server/jersey/ZooKeeperService.java,242,0,0.0,0,0,0.0,0,0,0.0,0,0,0.0,0,0,0,0,NO
20,src/contrib/rest/src/java/org/apache/zookeeper/server/jersey/cfg/Credentials.java,47,0,0.0,0,0,0.0,0,0,0.0,0,0,0.0,0,0,0,0,NO
20,src/contrib/rest/src/java/org/apache/zookeeper/server/jersey/cfg/Endpoint.java,72,0,0.0,0,0,0.0,0,0,0.0,0,0,0.0,0,0,0,0,NO
20,src/contrib/rest/src/java/org/apache/zookeeper/server/jersey/cfg/HostPort.java,51,0,0.0,0,0,0.0,0,0,0.0,0,0,0.0,0,0,0,0,NO
20,src/contrib/rest/src/java/org/apache/zookeeper/server/jersey/cfg/HostPortSet.java,51,0,0.0,0,0,0.0,0,0,0.0,0,0,0.0,0,0,0,0,NO
20,src/contrib/rest/src/java/org/apache/zookeeper/server/jersey/cfg/RestCfg.java,106,0,0.0,0,0,0.0,0,0,0.0,0,0,0.0,0,0,0,0,NO
20,src/contrib/rest/src/java/org/apache/zookeeper/server/jersey/filters/HTTPBasicAuth.java,87,0,0.0,0,0,0.0,0,0,0.0,0,0,0.0,0,0,0,0,NO
20,src/contrib/rest/src/java/org/apache/zookeeper/server/jersey/jaxb/ZChildren.java,80,0,0.0,0,0,0.0,0,0,0.0,0,0,0.0,0,0,0,0,NO
20,src/contrib/rest/src/java/org/apache/zookeeper/server/jersey/jaxb/ZChildrenJSON.java,76,0,0.0,0,0,0.0,0,0,0.0,0,0,0.0,0,0,0,0,NO
20,src/contrib/rest/src/java/org/apache/zookeeper/server/jersey/jaxb/ZError.java,41,0,0.0,0,0,0.0,0,0,0.0,0,0,0.0,0,0,0,0,NO
20,src/contrib/rest/src/java/org/apache/zookeeper/server/jersey/jaxb/ZPath.java,63,0,0.0,0,0,0.0,0,0,0.0,0,0,0.0,0,0,0,0,NO
20,src/contrib/rest/src/java/org/apache/zookeeper/server/jersey/jaxb/ZSession.java,55,0,0.0,0,0,0.0,0,0,0.0,0,0,0.0,0,0,0,0,NO
20,src/contrib/rest/src/java/org/apache/zookeeper/server/jersey/jaxb/ZStat.java,106,0,0.0,0,0,0.0,0,0,0.0,0,0,0.0,0,0,0,0,NO
20,src/contrib/rest/src/java/org/apache/zookeeper/server/jersey/resources/JAXBContextResolver.java,72,0,0.0,0,0,0.0,0,0,0.0,0,0,0.0,0,0,0,0,NO
20,src/contrib/rest/src/java/org/apache/zookeeper/server/jersey/resources/KeeperExceptionMapper.java,86,0,0.0,0,0,0.0,0,0,0.0,0,0,0.0,0,0,0,0,NO
20,src/contrib/rest/src/java/org/apache/zookeeper/server/jersey/resources/RuntimeExceptionMapper.java,55,0,0.0,0,0,0.0,0,0,0.0,0,0,0.0,0,0,0,0,NO
20,src/contrib/rest/src/java/org/apache/zookeeper/server/jersey/resources/SessionsResource.java,135,0,0.0,0,0,0.0,0,0,0.0,0,0,0.0,0,0,0,0,NO
20,src/contrib/rest/src/java/org/apache/zookeeper/server/jersey/resources/ZErrorWriter.java,63,0,0.0,0,0,0.0,0,0,0.0,0,0,0.0,0,0,0,0,NO
20,src/contrib/rest/src/java/org/apache/zookeeper/server/jersey/resources/ZNodeResource.java,412,0,0.0,0,0,0.0,0,0,0.0,0,0,0.0,0,0,0,0,NO
20,src/contrib/zooinspector/src/java/com/nitido/utils/toaster/Toaster.java,533,0,0.0,0,0,0.0,0,0,0.0,0,0,0.0,0,0,0,0,NO
20,src/contrib/zooinspector/src/java/org/apache/zookeeper/inspector/ZooInspector.java,71,5,5.0,5,1,1.0,1,6,6.0,6,4,4.0,4,1,0,1,NO
20,src/contrib/zooinspector/src/java/org/apache/zookeeper/inspector/encryption/BasicDataEncryptionManager.java,50,0,0.0,0,0,0.0,0,0,0.0,0,0,0.0,0,0,0,0,NO
20,src/contrib/zooinspector/src/java/org/apache/zookeeper/inspector/encryption/DataEncryptionManager.java,39,0,0.0,0,0,0.0,0,0,0.0,0,0,0.0,0,0,0,0,NO
20,src/contrib/zooinspector/src/java/org/apache/zookeeper/inspector/gui/IconResource.java,88,0,0.0,0,0,0.0,0,0,0.0,0,0,0.0,0,0,0,0,NO
20,src/contrib/zooinspector/src/java/org/apache/zookeeper/inspector/gui/NodeViewersChangeListener.java,37,0,0.0,0,0,0.0,0,0,0.0,0,0,0.0,0,0,0,0,NO
20,src/contrib/zooinspector/src/java/org/apache/zookeeper/inspector/gui/Toolbar.java,74,0,0.0,0,0,0.0,0,0,0.0,0,0,0.0,0,0,0,0,NO
20,src/contrib/zooinspector/src/java/org/apache/zookeeper/inspector/gui/ZooInspectorAboutDialog.java,79,0,0.0,0,0,0.0,0,0,0.0,0,0,0.0,0,0,0,0,NO
20,src/contrib/zooinspector/src/java/org/apache/zookeeper/inspector/gui/ZooInspectorConnectionPropertiesDialog.java,321,0,0.0,0,0,0.0,0,0,0.0,0,0,0.0,0,0,0,0,NO
20,src/contrib/zooinspector/src/java/org/apache/zookeeper/inspector/gui/ZooInspectorNodeViewersDialog.java,631,0,0.0,0,0,0.0,0,0,0.0,0,0,0.0,0,0,0,0,NO
20,src/contrib/zooinspector/src/java/org/apache/zookeeper/inspector/gui/ZooInspectorNodeViewersPanel.java,140,0,0.0,0,0,0.0,0,0,0.0,0,0,0.0,0,0,0,0,NO
20,src/contrib/zooinspector/src/java/org/apache/zookeeper/inspector/gui/ZooInspectorPanel.java,318,0,0.0,0,0,0.0,0,0,0.0,0,0,0.0,0,0,0,0,NO
20,src/contrib/zooinspector/src/java/org/apache/zookeeper/inspector/gui/ZooInspectorTreeViewer.java,356,0,0.0,0,0,0.0,0,0,0.0,0,0,0.0,0,0,0,0,NO
20,src/contrib/zooinspector/src/java/org/apache/zookeeper/inspector/gui/nodeviewer/NodeViewerACL.java,187,0,0.0,0,0,0.0,0,0,0.0,0,0,0.0,0,0,0,0,NO
20,src/contrib/zooinspector/src/java/org/apache/zookeeper/inspector/gui/nodeviewer/NodeViewerData.java,143,3,3.0,3,2,2.0,2,5,5.0,5,1,1.0,1,1,0,1,NO
20,src/contrib/zooinspector/src/java/org/apache/zookeeper/inspector/gui/nodeviewer/NodeViewerMetaData.java,186,0,0.0,0,0,0.0,0,0,0.0,0,0,0.0,0,0,0,0,NO
20,src/contrib/zooinspector/src/java/org/apache/zookeeper/inspector/gui/nodeviewer/ZooInspectorNodeViewer.java,138,0,0.0,0,0,0.0,0,0,0.0,0,0,0.0,0,0,0,0,NO
20,src/contrib/zooinspector/src/java/org/apache/zookeeper/inspector/logger/LoggerFactory.java,36,0,0.0,0,0,0.0,0,0,0.0,0,0,0.0,0,0,0,0,NO
20,src/contrib/zooinspector/src/java/org/apache/zookeeper/inspector/manager/NodeListener.java,37,0,0.0,0,0,0.0,0,0,0.0,0,0,0.0,0,0,0,0,NO
20,src/contrib/zooinspector/src/java/org/apache/zookeeper/inspector/manager/Pair.java,120,0,0.0,0,0,0.0,0,0,0.0,0,0,0.0,0,0,0,0,NO
20,src/contrib/zooinspector/src/java/org/apache/zookeeper/inspector/manager/ZooInspectorManager.java,139,0,0.0,0,0,0.0,0,0,0.0,0,0,0.0,0,0,0,0,NO
20,src/contrib/zooinspector/src/java/org/apache/zookeeper/inspector/manager/ZooInspectorManagerImpl.java,885,37,9.25,37,4,1.0,4,41,10.25,41,33,8.25,33,4,1,1,NO
20,src/contrib/zooinspector/src/java/org/apache/zookeeper/inspector/manager/ZooInspectorNodeManager.java,33,0,0.0,0,0,0.0,0,0,0.0,0,0,0.0,0,0,0,0,NO
20,src/contrib/zooinspector/src/java/org/apache/zookeeper/inspector/manager/ZooInspectorNodeTreeManager.java,43,0,0.0,0,0,0.0,0,0,0.0,0,0,0.0,0,0,0,0,NO
20,src/contrib/zooinspector/src/java/org/apache/zookeeper/inspector/manager/ZooInspectorReadOnlyManager.java,99,0,0.0,0,0,0.0,0,0,0.0,0,0,0.0,0,0,0,0,NO
20,src/contrib/zooinspector/src/java/org/apache/zookeeper/retry/ZooKeeperRetry.java,288,0,0.0,0,0,0.0,0,0,0.0,0,0,0.0,0,0,0,0,NO
20,src/java/main/org/apache/jute/BinaryInputArchive.java,126,6,6.0,6,11,11.0,11,17,17.0,17,5,5.0,5,1,1,1,NO
20,src/java/main/org/apache/jute/BinaryOutputArchive.java,146,0,0.0,0,0,0.0,0,0,0.0,0,0,0.0,0,0,0,0,NO
20,src/java/main/org/apache/jute/CsvInputArchive.java,204,0,0.0,0,0,0.0,0,0,0.0,0,0,0.0,0,0,0,0,NO
20,src/java/main/org/apache/jute/CsvOutputArchive.java,150,0,0.0,0,0,0.0,0,0,0.0,0,0,0.0,0,0,0,0,NO
20,src/java/main/org/apache/jute/Index.java,38,0,0.0,0,0,0.0,0,0,0.0,0,0,0.0,0,0,0,0,NO
20,src/java/main/org/apache/jute/InputArchive.java,43,0,0.0,0,0,0.0,0,0,0.0,0,0,0.0,0,0,0,0,NO
20,src/java/main/org/apache/jute/OutputArchive.java,47,0,0.0,0,0,0.0,0,0,0.0,0,0,0.0,0,0,0,0,NO
20,src/java/main/org/apache/jute/Record.java,32,0,0.0,0,0,0.0,0,0,0.0,0,0,0.0,0,0,0,0,NO
20,src/java/main/org/apache/jute/RecordReader.java,93,0,0.0,0,0,0.0,0,0,0.0,0,0,0.0,0,0,0,0,NO
20,src/java/main/org/apache/jute/RecordWriter.java,93,0,0.0,0,0,0.0,0,0,0.0,0,0,0.0,0,0,0,0,NO
20,src/java/main/org/apache/jute/Utils.java,282,0,0.0,0,0,0.0,0,0,0.0,0,0,0.0,0,0,0,0,NO
20,src/java/main/org/apache/jute/XmlInputArchive.java,251,0,0.0,0,0,0.0,0,0,0.0,0,0,0.0,0,0,0,0,NO
20,src/java/main/org/apache/jute/XmlOutputArchive.java,251,0,0.0,0,0,0.0,0,0,0.0,0,0,0.0,0,0,0,0,NO
20,src/java/main/org/apache/jute/compiler/CGenerator.java,130,0,0.0,0,0,0.0,0,0,0.0,0,0,0.0,0,0,0,0,NO
20,src/java/main/org/apache/jute/compiler/CSharpGenerator.java,53,0,0.0,0,0,0.0,0,0,0.0,0,0,0.0,0,0,0,0,NO
20,src/java/main/org/apache/jute/compiler/CppGenerator.java,125,0,0.0,0,0,0.0,0,0,0.0,0,0,0.0,0,0,0,0,NO
20,src/java/main/org/apache/jute/compiler/JBoolean.java,50,0,0.0,0,0,0.0,0,0,0.0,0,0,0.0,0,0,0,0,NO
20,src/java/main/org/apache/jute/compiler/JBuffer.java,106,0,0.0,0,0,0.0,0,0,0.0,0,0,0.0,0,0,0,0,NO
20,src/java/main/org/apache/jute/compiler/JByte.java,34,0,0.0,0,0,0.0,0,0,0.0,0,0,0.0,0,0,0,0,NO
20,src/java/main/org/apache/jute/compiler/JCompType.java,66,0,0.0,0,0,0.0,0,0,0.0,0,0,0.0,0,0,0,0,NO
20,src/java/main/org/apache/jute/compiler/JDouble.java,40,0,0.0,0,0,0.0,0,0,0.0,0,0,0.0,0,0,0,0,NO
20,src/java/main/org/apache/jute/compiler/JField.java,140,0,0.0,0,0,0.0,0,0,0.0,0,0,0.0,0,0,0,0,NO
20,src/java/main/org/apache/jute/compiler/JFile.java,84,0,0.0,0,0,0.0,0,0,0.0,0,0,0.0,0,0,0,0,NO
20,src/java/main/org/apache/jute/compiler/JFloat.java,39,0,0.0,0,0,0.0,0,0,0.0,0,0,0.0,0,0,0,0,NO
20,src/java/main/org/apache/jute/compiler/JInt.java,34,0,0.0,0,0,0.0,0,0,0.0,0,0,0.0,0,0,0,0,NO
20,src/java/main/org/apache/jute/compiler/JLong.java,38,0,0.0,0,0,0.0,0,0,0.0,0,0,0.0,0,0,0,0,NO
20,src/java/main/org/apache/jute/compiler/JMap.java,149,0,0.0,0,0,0.0,0,0,0.0,0,0,0.0,0,0,0,0,NO
20,src/java/main/org/apache/jute/compiler/JRecord.java,761,0,0.0,0,0,0.0,0,0,0.0,0,0,0.0,0,0,0,0,NO
20,src/java/main/org/apache/jute/compiler/JString.java,46,0,0.0,0,0,0.0,0,0,0.0,0,0,0.0,0,0,0,0,NO
20,src/java/main/org/apache/jute/compiler/JType.java,204,0,0.0,0,0,0.0,0,0,0.0,0,0,0.0,0,0,0,0,NO
20,src/java/main/org/apache/jute/compiler/JVector.java,153,0,0.0,0,0,0.0,0,0,0.0,0,0,0.0,0,0,0,0,NO
20,src/java/main/org/apache/jute/compiler/JavaGenerator.java,57,0,0.0,0,0,0.0,0,0,0.0,0,0,0.0,0,0,0,0,NO
20,src/java/main/org/apache/zookeeper/AsyncCallback.java,67,11,5.5,11,1,0.5,1,12,6.0,12,10,5.0,10,2,0,2,NO
20,src/java/main/org/apache/zookeeper/ClientCnxn.java,1560,218,31.142857,218,37,5.285714,37,255,36.42857,255,181,25.857143,181,7,4,4,NO
20,src/java/main/org/apache/zookeeper/ClientCnxnSocket.java,174,0,0.0,0,0,0.0,0,0,0.0,0,0,0.0,0,0,0,0,NO
20,src/java/main/org/apache/zookeeper/ClientCnxnSocketNIO.java,427,11,11.0,11,0,0.0,0,11,11.0,11,11,11.0,11,1,1,1,NO
20,src/java/main/org/apache/zookeeper/ClientWatchManager.java,40,0,0.0,0,0,0.0,0,0,0.0,0,0,0.0,0,0,0,0,NO
20,src/java/main/org/apache/zookeeper/CreateMode.java,92,4,4.0,4,2,2.0,2,6,6.0,6,2,2.0,2,1,1,1,NO
20,src/java/main/org/apache/zookeeper/Environment.java,102,0,0.0,0,0,0.0,0,0,0.0,0,0,0.0,0,0,0,0,NO
20,src/java/main/org/apache/zookeeper/JLineZNodeCompleter.java,84,84,84.0,84,0,0.0,0,84,84.0,84,84,84.0,84,1,0,1,NO
20,src/java/main/org/apache/zookeeper/KeeperException.java,790,98,32.666668,98,10,3.3333333,10,108,36.0,108,88,29.333334,88,3,0,3,NO
20,src/java/main/org/apache/zookeeper/Login.java,396,1,1.0,1,1,1.0,1,2,2.0,2,0,0.0,0,1,0,1,NO
20,src/java/main/org/apache/zookeeper/MultiResponse.java,177,12,12.0,12,0,0.0,0,12,12.0,12,12,12.0,12,1,0,1,NO
20,src/java/main/org/apache/zookeeper/MultiTransactionRecord.java,167,8,8.0,8,0,0.0,0,8,8.0,8,8,8.0,8,1,0,1,NO
20,src/java/main/org/apache/zookeeper/Op.java,351,19,19.0,19,0,0.0,0,19,19.0,19,19,19.0,19,1,1,1,NO
20,src/java/main/org/apache/zookeeper/OpResult.java,205,23,23.0,23,3,3.0,3,26,26.0,26,20,20.0,20,1,0,1,NO
20,src/java/main/org/apache/zookeeper/Quotas.java,68,0,0.0,0,0,0.0,0,0,0.0,0,0,0.0,0,0,0,0,NO
20,src/java/main/org/apache/zookeeper/ServerAdminClient.java,277,0,0.0,0,0,0.0,0,0,0.0,0,0,0.0,0,0,0,0,NO
20,src/java/main/org/apache/zookeeper/Shell.java,476,1,1.0,1,1,1.0,1,2,2.0,2,0,0.0,0,1,0,1,NO
20,src/java/main/org/apache/zookeeper/StatsTrack.java,101,0,0.0,0,0,0.0,0,0,0.0,0,0,0.0,0,0,0,0,NO
20,src/java/main/org/apache/zookeeper/Transaction.java,68,5,5.0,5,0,0.0,0,5,5.0,5,5,5.0,5,1,0,1,NO
20,src/java/main/org/apache/zookeeper/Version.java,79,0,0.0,0,0,0.0,0,0,0.0,0,0,0.0,0,0,0,0,NO
20,src/java/main/org/apache/zookeeper/WatchDeregistration.java,70,70,70.0,70,0,0.0,0,70,70.0,70,70,70.0,70,1,0,1,NO
20,src/java/main/org/apache/zookeeper/WatchedEvent.java,79,0,0.0,0,0,0.0,0,0,0.0,0,0,0.0,0,0,0,0,NO
20,src/java/main/org/apache/zookeeper/Watcher.java,186,38,38.0,38,1,1.0,1,39,39.0,39,37,37.0,37,1,0,1,NO
20,src/java/main/org/apache/zookeeper/ZKUtil.java,124,0,0.0,0,0,0.0,0,0,0.0,0,0,0.0,0,0,0,0,NO
20,src/java/main/org/apache/zookeeper/ZooDefs.java,128,11,3.6666667,11,2,0.6666667,2,13,4.3333335,13,9,3.0,9,3,0,2,NO
20,src/java/main/org/apache/zookeeper/ZooKeeper.java,2497,672,112.0,672,19,3.1666667,19,691,115.166664,691,653,108.833336,653,6,1,3,NO
20,src/java/main/org/apache/zookeeper/ZooKeeperMain.java,677,22,5.5,22,15,3.75,15,37,9.25,37,17,4.25,17,4,2,4,NO
20,src/java/main/org/apache/zookeeper/cli/AclParser.java,81,0,0.0,0,0,0.0,0,0,0.0,0,0,0.0,0,0,0,0,NO
20,src/java/main/org/apache/zookeeper/cli/AddAuthCommand.java,64,0,0.0,0,0,0.0,0,0,0.0,0,0,0.0,0,0,0,0,NO
20,src/java/main/org/apache/zookeeper/cli/CliCommand.java,119,0,0.0,0,0,0.0,0,0,0.0,0,0,0.0,0,0,0,0,NO
20,src/java/main/org/apache/zookeeper/cli/CloseCommand.java,46,0,0.0,0,0,0.0,0,0,0.0,0,0,0.0,0,0,0,0,NO
20,src/java/main/org/apache/zookeeper/cli/CreateCommand.java,86,11,11.0,11,6,6.0,6,17,17.0,17,5,5.0,5,1,0,1,NO
20,src/java/main/org/apache/zookeeper/cli/DelQuotaCommand.java,152,0,0.0,0,0,0.0,0,0,0.0,0,0,0.0,0,0,0,0,NO
20,src/java/main/org/apache/zookeeper/cli/DeleteAllCommand.java,72,0,0.0,0,0,0.0,0,0,0.0,0,0,0.0,0,0,0,0,NO
20,src/java/main/org/apache/zookeeper/cli/DeleteCommand.java,88,0,0.0,0,0,0.0,0,0,0.0,0,0,0.0,0,0,0,0,NO
20,src/java/main/org/apache/zookeeper/cli/GetAclCommand.java,94,0,0.0,0,0,0.0,0,0,0.0,0,0,0.0,0,0,0,0,NO
20,src/java/main/org/apache/zookeeper/cli/GetCommand.java,83,0,0.0,0,0,0.0,0,0,0.0,0,0,0.0,0,0,0,0,NO
20,src/java/main/org/apache/zookeeper/cli/GetConfigCommand.java,75,75,75.0,75,0,0.0,0,75,75.0,75,75,75.0,75,1,0,1,NO
20,src/java/main/org/apache/zookeeper/cli/ListQuotaCommand.java,74,0,0.0,0,0,0.0,0,0,0.0,0,0,0.0,0,0,0,0,NO
20,src/java/main/org/apache/zookeeper/cli/Ls2Command.java,62,0,0.0,0,0,0.0,0,0,0.0,0,0,0.0,0,0,0,0,NO
20,src/java/main/org/apache/zookeeper/cli/LsCommand.java,85,0,0.0,0,0,0.0,0,0,0.0,0,0,0.0,0,0,0,0,NO
20,src/java/main/org/apache/zookeeper/cli/ReconfigCommand.java,157,161,53.666668,161,4,1.3333334,4,165,55.0,165,161,53.666668,161,3,0,3,NO
20,src/java/main/org/apache/zookeeper/cli/SetAclCommand.java,82,0,0.0,0,0,0.0,0,0,0.0,0,0,0.0,0,0,0,0,NO
20,src/java/main/org/apache/zookeeper/cli/SetCommand.java,75,0,0.0,0,0,0.0,0,0,0.0,0,0,0.0,0,0,0,0,NO
20,src/java/main/org/apache/zookeeper/cli/SetQuotaCommand.java,200,0,0.0,0,0,0.0,0,0,0.0,0,0,0.0,0,0,0,0,NO
20,src/java/main/org/apache/zookeeper/cli/StatCommand.java,81,0,0.0,0,0,0.0,0,0,0.0,0,0,0.0,0,0,0,0,NO
20,src/java/main/org/apache/zookeeper/cli/StatPrinter.java,49,0,0.0,0,0,0.0,0,0,0.0,0,0,0.0,0,0,0,0,NO
20,src/java/main/org/apache/zookeeper/cli/SyncCommand.java,64,0,0.0,0,0,0.0,0,0,0.0,0,0,0.0,0,0,0,0,NO
20,src/java/main/org/apache/zookeeper/client/ConnectStringParser.java,90,6,6.0,6,3,3.0,3,9,9.0,9,3,3.0,3,1,0,1,NO
20,src/java/main/org/apache/zookeeper/client/FourLetterWordMain.java,79,0,0.0,0,0,0.0,0,0,0.0,0,0,0.0,0,0,0,0,NO
20,src/java/main/org/apache/zookeeper/client/HostProvider.java,72,0,0.0,0,0,0.0,0,0,0.0,0,0,0.0,0,0,0,0,NO
20,src/java/main/org/apache/zookeeper/client/StaticHostProvider.java,319,23,11.5,23,10,5.0,10,33,16.5,33,13,6.5,13,2,0,2,NO
20,src/java/main/org/apache/zookeeper/client/ZooKeeperSaslClient.java,584,110,18.333334,110,52,8.666667,52,162,27.0,162,68,11.333333,68,6,6,4,NO
20,src/java/main/org/apache/zookeeper/common/AtomicFileOutputStream.java,115,0,0.0,0,0,0.0,0,0,0.0,0,0,0.0,0,0,0,0,NO
20,src/java/main/org/apache/zookeeper/common/IOUtils.java,123,0,0.0,0,0,0.0,0,0,0.0,0,0,0.0,0,0,0,0,NO
20,src/java/main/org/apache/zookeeper/common/PathTrie.java,293,9,9.0,9,0,0.0,0,9,9.0,9,9,9.0,9,1,1,1,NO
20,src/java/main/org/apache/zookeeper/common/PathUtils.java,103,4,4.0,4,4,4.0,4,8,8.0,8,0,0.0,0,1,1,1,NO
20,src/java/main/org/apache/zookeeper/common/StringUtils.java,63,63,31.5,63,0,0.0,0,63,31.5,63,63,31.5,63,2,0,2,NO
20,src/java/main/org/apache/zookeeper/jmx/CommonNames.java,29,0,0.0,0,0,0.0,0,0,0.0,0,0,0.0,0,0,0,0,NO
20,src/java/main/org/apache/zookeeper/jmx/MBeanRegistry.java,215,2,2.0,2,2,2.0,2,4,4.0,4,0,0.0,0,1,0,1,NO
20,src/java/main/org/apache/zookeeper/jmx/ManagedUtil.java,71,0,0.0,0,0,0.0,0,0,0.0,0,0,0.0,0,0,0,0,NO
20,src/java/main/org/apache/zookeeper/jmx/ZKMBeanInfo.java,36,0,0.0,0,0,0.0,0,0,0.0,0,0,0.0,0,0,0,0,NO
20,src/java/main/org/apache/zookeeper/server/ByteBufferInputStream.java,82,0,0.0,0,0,0.0,0,0,0.0,0,0,0.0,0,0,0,0,NO
20,src/java/main/org/apache/zookeeper/server/ByteBufferOutputStream.java,51,0,0.0,0,0,0.0,0,0,0.0,0,0,0.0,0,0,0,0,NO
20,src/java/main/org/apache/zookeeper/server/ConnectionBean.java,173,0,0.0,0,0,0.0,0,0,0.0,0,0,0.0,0,0,0,0,NO
20,src/java/main/org/apache/zookeeper/server/ConnectionMXBean.java,98,0,0.0,0,0,0.0,0,0,0.0,0,0,0.0,0,0,0,0,NO
20,src/java/main/org/apache/zookeeper/server/DataNode.java,174,0,0.0,0,0,0.0,0,0,0.0,0,0,0.0,0,0,0,0,NO
20,src/java/main/org/apache/zookeeper/server/DataTree.java,1382,125,20.833334,125,45,7.5,45,170,28.333334,170,118,19.666666,118,6,3,4,NO
20,src/java/main/org/apache/zookeeper/server/DataTreeBean.java,61,0,0.0,0,0,0.0,0,0,0.0,0,0,0.0,0,0,0,0,NO
20,src/java/main/org/apache/zookeeper/server/DataTreeMXBean.java,47,0,0.0,0,0,0.0,0,0,0.0,0,0,0.0,0,0,0,0,NO
20,src/java/main/org/apache/zookeeper/server/DatadirCleanupManager.java,192,0,0.0,0,0,0.0,0,0,0.0,0,0,0.0,0,0,0,0,NO
20,src/java/main/org/apache/zookeeper/server/ExpiryQueue.java,179,180,180.0,180,0,0.0,0,180,180.0,180,180,180.0,180,1,0,1,NO
20,src/java/main/org/apache/zookeeper/server/FinalRequestProcessor.java,457,63,12.6,63,20,4.0,20,83,16.6,83,43,8.6,43,5,0,3,NO
20,src/java/main/org/apache/zookeeper/server/LogFormatter.java,104,0,0.0,0,0,0.0,0,0,0.0,0,0,0.0,0,0,0,0,NO
20,src/java/main/org/apache/zookeeper/server/NIOServerCnxn.java,1181,337,67.4,337,313,62.6,313,650,130.0,650,36,7.2,36,5,1,3,NO
20,src/java/main/org/apache/zookeeper/server/NIOServerCnxnFactory.java,941,773,257.66666,773,141,47.0,141,914,304.66666,914,632,210.66667,632,3,0,2,NO
20,src/java/main/org/apache/zookeeper/server/NettyServerCnxn.java,856,25,5.0,25,21,4.2,21,46,9.2,46,14,2.8,14,5,2,3,NO
20,src/java/main/org/apache/zookeeper/server/NettyServerCnxnFactory.java,412,33,11.0,33,21,7.0,21,54,18.0,54,12,4.0,12,3,1,2,NO
20,src/java/main/org/apache/zookeeper/server/ObserverBean.java,45,0,0.0,0,0,0.0,0,0,0.0,0,0,0.0,0,0,0,0,NO
20,src/java/main/org/apache/zookeeper/server/PrepRequestProcessor.java,980,269,44.833332,269,27,4.5,27,296,49.333332,296,242,40.333332,242,6,1,5,NO
20,src/java/main/org/apache/zookeeper/server/PurgeTxnLog.java,129,0,0.0,0,0,0.0,0,0,0.0,0,0,0.0,0,0,0,0,NO
20,src/java/main/org/apache/zookeeper/server/RateLogger.java,61,61,61.0,61,0,0.0,0,61,61.0,61,61,61.0,61,1,0,1,NO
20,src/java/main/org/apache/zookeeper/server/Request.java,284,44,11.0,44,16,4.0,16,60,15.0,60,28,7.0,28,4,0,3,NO
20,src/java/main/org/apache/zookeeper/server/RequestProcessor.java,44,0,0.0,0,0,0.0,0,0,0.0,0,0,0.0,0,0,0,0,NO
20,src/java/main/org/apache/zookeeper/server/ServerCnxn.java,461,9,9.0,9,0,0.0,0,9,9.0,9,9,9.0,9,1,0,1,NO
20,src/java/main/org/apache/zookeeper/server/ServerCnxnFactory.java,215,19,4.75,19,13,3.25,13,32,8.0,32,6,1.5,6,4,0,3,NO
20,src/java/main/org/apache/zookeeper/server/ServerConfig.java,112,0,0.0,0,0,0.0,0,0,0.0,0,0,0.0,0,0,0,0,NO
20,src/java/main/org/apache/zookeeper/server/ServerStats.java,140,0,0.0,0,0,0.0,0,0,0.0,0,0,0.0,0,0,0,0,NO
20,src/java/main/org/apache/zookeeper/server/SessionTracker.java,128,50,50.0,50,3,3.0,3,53,53.0,53,47,47.0,47,1,0,1,NO
20,src/java/main/org/apache/zookeeper/server/SessionTrackerImpl.java,265,98,24.5,98,112,28.0,112,210,52.5,210,76,19.0,76,4,1,3,NO
20,src/java/main/org/apache/zookeeper/server/SnapshotFormatter.java,128,5,5.0,5,1,1.0,1,6,6.0,6,4,4.0,4,1,1,1,NO
20,src/java/main/org/apache/zookeeper/server/Stats.java,68,0,0.0,0,0,0.0,0,0,0.0,0,0,0.0,0,0,0,0,NO
20,src/java/main/org/apache/zookeeper/server/SyncRequestProcessor.java,216,31,15.5,31,7,3.5,7,38,19.0,38,24,12.0,24,2,1,1,NO
20,src/java/main/org/apache/zookeeper/server/TraceFormatter.java,125,3,1.5,3,1,0.5,1,4,2.0,4,2,1.0,2,2,0,2,NO
20,src/java/main/org/apache/zookeeper/server/TxnLogProposalIterator.java,122,122,61.0,122,0,0.0,0,122,61.0,122,122,61.0,122,2,1,2,NO
20,src/java/main/org/apache/zookeeper/server/UnimplementedRequestProcessor.java,48,48,48.0,48,0,0.0,0,48,48.0,48,48,48.0,48,1,1,1,NO
20,src/java/main/org/apache/zookeeper/server/WatchManager.java,187,16,16.0,16,0,0.0,0,16,16.0,16,16,16.0,16,1,0,1,NO
20,src/java/main/org/apache/zookeeper/server/WorkerService.java,240,240,240.0,240,0,0.0,0,240,240.0,240,240,240.0,240,1,0,1,NO
20,src/java/main/org/apache/zookeeper/server/ZKDatabase.java,603,115,28.75,115,2,0.5,2,117,29.25,117,113,28.25,113,4,1,4,NO
20,src/java/main/org/apache/zookeeper/server/ZooKeeperSaslServer.java,169,47,23.5,47,8,4.0,8,55,27.5,55,39,19.5,39,2,1,2,NO
20,src/java/main/org/apache/zookeeper/server/ZooKeeperServer.java,1025,103,17.166666,103,39,6.5,39,142,23.666666,142,66,11.0,66,6,3,3,NO
20,src/java/main/org/apache/zookeeper/server/ZooKeeperServerBean.java,147,0,0.0,0,0,0.0,0,0,0.0,0,0,0.0,0,0,0,0,NO
20,src/java/main/org/apache/zookeeper/server/ZooKeeperServerMXBean.java,110,0,0.0,0,0,0.0,0,0,0.0,0,0,0.0,0,0,0,0,NO
20,src/java/main/org/apache/zookeeper/server/ZooKeeperServerMain.java,134,7,7.0,7,1,1.0,1,8,8.0,8,6,6.0,6,1,0,1,NO
20,src/java/main/org/apache/zookeeper/server/ZooTrace.java,93,1,1.0,1,1,1.0,1,2,2.0,2,0,0.0,0,1,0,1,NO
20,src/java/main/org/apache/zookeeper/server/auth/AuthenticationProvider.java,82,0,0.0,0,0,0.0,0,0,0.0,0,0,0.0,0,0,0,0,NO
20,src/java/main/org/apache/zookeeper/server/auth/DigestAuthenticationProvider.java,139,0,0.0,0,0,0.0,0,0,0.0,0,0,0.0,0,0,0,0,NO
20,src/java/main/org/apache/zookeeper/server/auth/DigestLoginModule.java,59,0,0.0,0,0,0.0,0,0,0.0,0,0,0.0,0,0,0,0,NO
20,src/java/main/org/apache/zookeeper/server/auth/IPAuthenticationProvider.java,117,0,0.0,0,0,0.0,0,0,0.0,0,0,0.0,0,0,0,0,NO
20,src/java/main/org/apache/zookeeper/server/auth/KerberosName.java,418,0,0.0,0,0,0.0,0,0,0.0,0,0,0.0,0,0,0,0,NO
20,src/java/main/org/apache/zookeeper/server/auth/ProviderRegistry.java,77,0,0.0,0,0,0.0,0,0,0.0,0,0,0.0,0,0,0,0,NO
20,src/java/main/org/apache/zookeeper/server/auth/SASLAuthenticationProvider.java,79,12,6.0,12,3,1.5,3,15,7.5,15,9,4.5,9,2,0,1,NO
20,src/java/main/org/apache/zookeeper/server/auth/SaslServerCallbackHandler.java,152,0,0.0,0,0,0.0,0,0,0.0,0,0,0.0,0,0,0,0,NO
20,src/java/main/org/apache/zookeeper/server/persistence/FileSnap.java,250,0,0.0,0,0,0.0,0,0,0.0,0,0,0.0,0,0,0,0,NO
20,src/java/main/org/apache/zookeeper/server/persistence/FileTxnLog.java,727,85,28.333334,85,19,6.3333335,19,104,34.666668,104,66,22.0,66,3,1,3,NO
20,src/java/main/org/apache/zookeeper/server/persistence/FileTxnSnapLog.java,409,62,20.666666,62,34,11.333333,34,96,32.0,96,38,12.666667,38,3,2,3,NO
20,src/java/main/org/apache/zookeeper/server/persistence/SnapShot.java,66,0,0.0,0,0,0.0,0,0,0.0,0,0,0.0,0,0,0,0,NO
20,src/java/main/org/apache/zookeeper/server/persistence/TxnLog.java,127,7,7.0,7,0,0.0,0,7,7.0,7,7,7.0,7,1,0,1,NO
20,src/java/main/org/apache/zookeeper/server/persistence/Util.java,326,0,0.0,0,0,0.0,0,0,0.0,0,0,0.0,0,0,0,0,NO
20,src/java/main/org/apache/zookeeper/server/quorum/AckRequestProcessor.java,54,0,0.0,0,0,0.0,0,0,0.0,0,0,0.0,0,0,0,0,NO
20,src/java/main/org/apache/zookeeper/server/quorum/AuthFastLeaderElection.java,972,0,0.0,0,0,0.0,0,0,0.0,0,0,0.0,0,0,0,0,NO
20,src/java/main/org/apache/zookeeper/server/quorum/CommitProcessor.java,347,253,84.333336,253,91,30.333334,91,344,114.666664,344,162,54.0,162,3,0,3,NO
20,src/java/main/org/apache/zookeeper/server/quorum/Election.java,27,0,0.0,0,0,0.0,0,0,0.0,0,0,0.0,0,0,0,0,NO
20,src/java/main/org/apache/zookeeper/server/quorum/FastLeaderElection.java,984,144,48.0,144,63,21.0,63,207,69.0,207,81,27.0,81,3,1,2,NO
20,src/java/main/org/apache/zookeeper/server/quorum/Follower.java,197,35,35.0,35,5,5.0,5,40,40.0,40,30,30.0,30,1,0,1,NO
20,src/java/main/org/apache/zookeeper/server/quorum/FollowerBean.java,50,0,0.0,0,0,0.0,0,0,0.0,0,0,0.0,0,0,0,0,NO
20,src/java/main/org/apache/zookeeper/server/quorum/FollowerMXBean.java,41,0,0.0,0,0,0.0,0,0,0.0,0,0,0.0,0,0,0,0,NO
20,src/java/main/org/apache/zookeeper/server/quorum/FollowerRequestProcessor.java,140,34,17.0,34,7,3.5,7,41,20.5,41,27,13.5,27,2,0,2,NO
20,src/java/main/org/apache/zookeeper/server/quorum/FollowerZooKeeperServer.java,161,2,2.0,2,1,1.0,1,3,3.0,3,1,1.0,1,1,0,1,NO
20,src/java/main/org/apache/zookeeper/server/quorum/Leader.java,1388,777,86.333336,777,347,38.555557,347,1124,124.888885,1124,568,63.11111,568,9,2,4,NO
20,src/java/main/org/apache/zookeeper/server/quorum/LeaderBean.java,53,0,0.0,0,0,0.0,0,0,0.0,0,0,0.0,0,0,0,0,NO
20,src/java/main/org/apache/zookeeper/server/quorum/LeaderElection.java,293,0,0.0,0,0,0.0,0,0,0.0,0,0,0.0,0,0,0,0,NO
20,src/java/main/org/apache/zookeeper/server/quorum/LeaderElectionBean.java,42,0,0.0,0,0,0.0,0,0,0.0,0,0,0.0,0,0,0,0,NO
20,src/java/main/org/apache/zookeeper/server/quorum/LeaderElectionMXBean.java,31,0,0.0,0,0,0.0,0,0,0.0,0,0,0.0,0,0,0,0,NO
20,src/java/main/org/apache/zookeeper/server/quorum/LeaderMXBean.java,36,0,0.0,0,0,0.0,0,0,0.0,0,0,0.0,0,0,0,0,NO
20,src/java/main/org/apache/zookeeper/server/quorum/LeaderRequestProcessor.java,81,81,81.0,81,0,0.0,0,81,81.0,81,81,81.0,81,1,0,1,NO
20,src/java/main/org/apache/zookeeper/server/quorum/LeaderSessionTracker.java,203,203,203.0,203,0,0.0,0,203,203.0,203,203,203.0,203,1,0,1,NO
20,src/java/main/org/apache/zookeeper/server/quorum/LeaderZooKeeperServer.java,207,42,21.0,42,12,6.0,12,54,27.0,54,30,15.0,30,2,0,2,NO
20,src/java/main/org/apache/zookeeper/server/quorum/Learner.java,592,133,33.25,133,23,5.75,23,156,39.0,156,112,28.0,112,4,2,3,NO
20,src/java/main/org/apache/zookeeper/server/quorum/LearnerHandler.java,939,475,52.77778,475,165,18.333334,165,640,71.111115,640,310,34.444443,310,9,2,3,NO
20,src/java/main/org/apache/zookeeper/server/quorum/LearnerSessionTracker.java,216,160,160.0,160,40,40.0,40,200,200.0,200,120,120.0,120,1,0,1,NO
20,src/java/main/org/apache/zookeeper/server/quorum/LearnerSyncRequest.java,34,0,0.0,0,0,0.0,0,0,0.0,0,0,0.0,0,0,0,0,NO
20,src/java/main/org/apache/zookeeper/server/quorum/LearnerZooKeeperServer.java,151,29,29.0,29,22,22.0,22,51,51.0,51,7,7.0,7,1,0,1,NO
20,src/java/main/org/apache/zookeeper/server/quorum/LocalPeerBean.java,79,0,0.0,0,0,0.0,0,0,0.0,0,0,0.0,0,0,0,0,NO
20,src/java/main/org/apache/zookeeper/server/quorum/LocalPeerMXBean.java,77,0,0.0,0,0,0.0,0,0,0.0,0,0,0.0,0,0,0,0,NO
20,src/java/main/org/apache/zookeeper/server/quorum/LocalSessionTracker.java,45,45,45.0,45,0,0.0,0,45,45.0,45,45,45.0,45,1,0,1,NO
20,src/java/main/org/apache/zookeeper/server/quorum/Observer.java,167,39,39.0,39,6,6.0,6,45,45.0,45,33,33.0,33,1,0,1,NO
20,src/java/main/org/apache/zookeeper/server/quorum/ObserverMXBean.java,37,0,0.0,0,0,0.0,0,0,0.0,0,0,0.0,0,0,0,0,NO
20,src/java/main/org/apache/zookeeper/server/quorum/ObserverRequestProcessor.java,152,27,13.5,27,2,1.0,2,29,14.5,29,25,12.5,25,2,0,2,NO
20,src/java/main/org/apache/zookeeper/server/quorum/ObserverZooKeeperServer.java,145,34,17.0,34,4,2.0,4,38,19.0,38,30,15.0,30,2,1,1,NO
20,src/java/main/org/apache/zookeeper/server/quorum/ProposalRequestProcessor.java,93,2,2.0,2,2,2.0,2,4,4.0,4,0,0.0,0,1,0,1,NO
20,src/java/main/org/apache/zookeeper/server/quorum/QuorumBean.java,44,1,1.0,1,1,1.0,1,2,2.0,2,0,0.0,0,1,0,1,NO
20,src/java/main/org/apache/zookeeper/server/quorum/QuorumCnxManager.java,934,107,35.666668,107,57,19.0,57,164,54.666668,164,70,23.333334,70,3,0,3,NO
20,src/java/main/org/apache/zookeeper/server/quorum/QuorumMXBean.java,34,0,0.0,0,0,0.0,0,0,0.0,0,0,0.0,0,0,0,0,NO
20,src/java/main/org/apache/zookeeper/server/quorum/QuorumPeer.java,1634,388,35.272728,388,97,8.818182,97,485,44.090908,485,299,27.181818,299,11,4,5,NO
20,src/java/main/org/apache/zookeeper/server/quorum/QuorumPeerConfig.java,588,124,17.714285,124,47,6.714286,47,171,24.428572,171,77,11.0,77,7,0,5,NO
20,src/java/main/org/apache/zookeeper/server/quorum/QuorumPeerMain.java,173,13,3.25,13,4,1.0,4,17,4.25,17,9,2.25,9,4,0,3,NO
20,src/java/main/org/apache/zookeeper/server/quorum/QuorumStats.java,68,0,0.0,0,0,0.0,0,0,0.0,0,0,0.0,0,0,0,0,NO
20,src/java/main/org/apache/zookeeper/server/quorum/QuorumZooKeeperServer.java,159,102,51.0,102,1,0.5,1,103,51.5,103,101,50.5,101,2,0,2,NO
20,src/java/main/org/apache/zookeeper/server/quorum/ReadOnlyBean.java,38,0,0.0,0,0,0.0,0,0,0.0,0,0,0.0,0,0,0,0,NO
20,src/java/main/org/apache/zookeeper/server/quorum/ReadOnlyRequestProcessor.java,130,2,1.0,2,1,0.5,1,3,1.5,3,1,0.5,1,2,0,2,NO
20,src/java/main/org/apache/zookeeper/server/quorum/ReadOnlyZooKeeperServer.java,168,27,27.0,27,3,3.0,3,30,30.0,30,24,24.0,24,1,0,1,NO
20,src/java/main/org/apache/zookeeper/server/quorum/RemotePeerBean.java,45,0,0.0,0,0,0.0,0,0,0.0,0,0,0.0,0,0,0,0,NO
20,src/java/main/org/apache/zookeeper/server/quorum/RemotePeerMXBean.java,33,0,0.0,0,0,0.0,0,0,0.0,0,0,0.0,0,0,0,0,NO
20,src/java/main/org/apache/zookeeper/server/quorum/SendAckRequestProcessor.java,80,0,0.0,0,0,0.0,0,0,0.0,0,0,0.0,0,0,0,0,NO
20,src/java/main/org/apache/zookeeper/server/quorum/ServerBean.java,38,0,0.0,0,0,0.0,0,0,0.0,0,0,0.0,0,0,0,0,NO
20,src/java/main/org/apache/zookeeper/server/quorum/ServerMXBean.java,33,0,0.0,0,0,0.0,0,0,0.0,0,0,0.0,0,0,0,0,NO
20,src/java/main/org/apache/zookeeper/server/quorum/StateSummary.java,57,0,0.0,0,0,0.0,0,0,0.0,0,0,0.0,0,0,0,0,NO
20,src/java/main/org/apache/zookeeper/server/quorum/UpgradeableSessionTracker.java,89,89,89.0,89,0,0.0,0,89,89.0,89,89,89.0,89,1,0,1,NO
20,src/java/main/org/apache/zookeeper/server/quorum/Vote.java,106,0,0.0,0,0,0.0,0,0,0.0,0,0,0.0,0,0,0,0,NO
20,src/java/main/org/apache/zookeeper/server/quorum/flexible/QuorumHierarchical.java,379,10,5.0,10,5,2.5,5,15,7.5,15,5,2.5,5,2,1,2,NO
20,src/java/main/org/apache/zookeeper/server/quorum/flexible/QuorumMaj.java,156,7,7.0,7,4,4.0,4,11,11.0,11,3,3.0,3,1,0,1,NO
20,src/java/main/org/apache/zookeeper/server/quorum/flexible/QuorumVerifier.java,43,2,2.0,2,1,1.0,1,3,3.0,3,1,1.0,1,1,0,1,NO
20,src/java/main/org/apache/zookeeper/server/util/ConfigUtils.java,60,60,60.0,60,0,0.0,0,60,60.0,60,60,60.0,60,1,0,1,NO
20,src/java/main/org/apache/zookeeper/server/util/KerberosUtil.java,45,0,0.0,0,0,0.0,0,0,0.0,0,0,0.0,0,0,0,0,NO
20,src/java/main/org/apache/zookeeper/server/util/OSMXBean.java,182,183,91.5,183,1,0.5,1,184,92.0,184,182,91.0,182,2,1,2,NO
20,src/java/main/org/apache/zookeeper/server/util/SerializeUtils.java,143,2,1.0,2,0,0.0,0,2,1.0,2,2,1.0,2,2,0,2,NO
20,src/java/main/org/apache/zookeeper/server/util/VerifyingFileFactory.java,82,0,0.0,0,0,0.0,0,0,0.0,0,0,0.0,0,0,0,0,NO
20,src/java/main/org/apache/zookeeper/server/util/ZxidUtils.java,34,0,0.0,0,0,0.0,0,0,0.0,0,0,0.0,0,0,0,0,NO
20,src/java/main/org/apache/zookeeper/version/util/VerGen.java,177,4,4.0,4,4,4.0,4,8,8.0,8,0,0.0,0,1,0,1,NO
20,src/recipes/election/src/java/org/apache/zookeeper/recipes/leader/LeaderElectionAware.java,37,0,0.0,0,0,0.0,0,0,0.0,0,0,0.0,0,0,0,0,NO
20,src/recipes/election/src/java/org/apache/zookeeper/recipes/leader/LeaderElectionSupport.java,461,0,0.0,0,0,0.0,0,0,0.0,0,0,0.0,0,0,0,0,NO
20,src/recipes/election/src/java/org/apache/zookeeper/recipes/leader/LeaderOffer.java,84,0,0.0,0,0,0.0,0,0,0.0,0,0,0.0,0,0,0,0,NO
20,src/recipes/lock/src/java/org/apache/zookeeper/recipes/lock/LockListener.java,38,0,0.0,0,0,0.0,0,0,0.0,0,0,0.0,0,0,0,0,NO
20,src/recipes/lock/src/java/org/apache/zookeeper/recipes/lock/ProtocolSupport.java,193,0,0.0,0,0,0.0,0,0,0.0,0,0,0.0,0,0,0,0,NO
20,src/recipes/lock/src/java/org/apache/zookeeper/recipes/lock/WriteLock.java,295,0,0.0,0,0,0.0,0,0,0.0,0,0,0.0,0,0,0,0,NO
20,src/recipes/lock/src/java/org/apache/zookeeper/recipes/lock/ZNodeName.java,110,0,0.0,0,0,0.0,0,0,0.0,0,0,0.0,0,0,0,0,NO
20,src/recipes/lock/src/java/org/apache/zookeeper/recipes/lock/ZooKeeperOperation.java,38,0,0.0,0,0,0.0,0,0,0.0,0,0,0.0,0,0,0,0,NO
20,src/recipes/queue/src/java/org/apache/zookeeper/recipes/queue/DistributedQueue.java,313,0,0.0,0,0,0.0,0,0,0.0,0,0,0.0,0,0,0,0,NO
