RELEASE_ID,FILE_NAME,SIZE,LOC_ADDED,LOC_ADDED_AVG,LOC_ADDED_MAX,LOC_REMOVED,LOC_REMOVED_AVG,LOC_REMOVED_MAX,LOC_TOUCHED,LOC_TOUCHED_AVG,LOC_TOUCHED_MAX,CHURN,CHURN_AVG,CHURN_MAX,NUMBER_OF_REVISIONS,NUMBER_OF_DEFECT_FIXES,NUMBER_OF_AUTHORS,IS_BUGGY
1,bookkeeper-benchmark/src/main/java/org/apache/bookkeeper/benchmark/MySqlClient.java,137,235,58.75,235,98,24.5,98,333,83.25,333,139,34.75,139,4,0,2,NO
1,bookkeeper-benchmark/src/main/java/org/apache/bookkeeper/benchmark/TestClient.java,244,340,68.0,340,96,19.2,96,436,87.2,436,262,52.4,262,5,0,2,NO
1,bookkeeper-server/src/main/java/org/apache/bookkeeper/bookie/Bookie.java,1026,1246,89.0,1246,220,15.714286,220,1466,104.71429,1466,1026,73.28571,1026,14,0,3,YES
1,bookkeeper-server/src/main/java/org/apache/bookkeeper/bookie/BookieException.java,92,121,40.333332,121,29,9.666667,29,150,50.0,150,92,30.666666,92,3,0,3,YES
1,bookkeeper-server/src/main/java/org/apache/bookkeeper/bookie/BufferedChannel.java,180,195,48.75,195,15,3.75,15,210,52.5,210,180,45.0,180,4,0,2,NO
1,bookkeeper-server/src/main/java/org/apache/bookkeeper/bookie/EntryLogger.java,471,633,70.333336,633,162,18.0,162,795,88.333336,795,551,61.22222,551,9,0,3,YES
1,bookkeeper-server/src/main/java/org/apache/bookkeeper/bookie/FileInfo.java,204,210,42.0,210,6,1.2,6,216,43.2,216,204,40.8,204,5,0,3,YES
1,bookkeeper-server/src/main/java/org/apache/bookkeeper/bookie/LedgerCache.java,551,621,88.71429,621,70,10.0,70,691,98.71429,691,557,79.57143,557,7,0,3,YES
1,bookkeeper-server/src/main/java/org/apache/bookkeeper/bookie/LedgerDescriptor.java,149,168,33.6,168,19,3.8,19,187,37.4,187,149,29.8,149,5,0,3,YES
1,bookkeeper-server/src/main/java/org/apache/bookkeeper/bookie/LedgerEntryPage.java,157,164,54.666668,164,7,2.3333333,7,171,57.0,171,157,52.333332,157,3,0,3,YES
1,bookkeeper-server/src/main/java/org/apache/bookkeeper/bookie/MarkerFileChannel.java,147,147,147.0,147,0,0.0,0,147,147.0,147,147,147.0,147,1,0,1,NO
1,bookkeeper-server/src/main/java/org/apache/bookkeeper/client/AsyncCallback.java,137,269,53.8,269,132,26.4,132,401,80.2,401,141,28.2,141,5,0,3,YES
1,bookkeeper-server/src/main/java/org/apache/bookkeeper/client/BKException.java,271,280,70.0,280,9,2.25,9,289,72.25,289,271,67.75,271,4,0,3,NO
1,bookkeeper-server/src/main/java/org/apache/bookkeeper/client/BookKeeper.java,548,1040,115.55556,1040,492,54.666668,492,1532,170.22223,1532,548,60.88889,548,9,0,3,YES
1,bookkeeper-server/src/main/java/org/apache/bookkeeper/client/BookKeeperAdmin.java,728,931,155.16667,931,203,33.833332,203,1134,189.0,1134,882,147.0,882,6,0,2,YES
1,bookkeeper-server/src/main/java/org/apache/bookkeeper/client/BookieWatcher.java,205,212,53.0,212,7,1.75,7,219,54.75,219,205,51.25,205,4,0,2,YES
1,bookkeeper-server/src/main/java/org/apache/bookkeeper/client/CRC32DigestManager.java,50,53,26.5,53,3,1.5,3,56,28.0,56,50,25.0,50,2,0,2,NO
1,bookkeeper-server/src/main/java/org/apache/bookkeeper/client/DigestManager.java,185,207,41.4,207,22,4.4,22,229,45.8,229,185,37.0,185,5,0,3,YES
1,bookkeeper-server/src/main/java/org/apache/bookkeeper/client/DistributionSchedule.java,61,66,22.0,66,5,1.6666666,5,71,23.666666,71,61,20.333334,61,3,0,3,YES
1,bookkeeper-server/src/main/java/org/apache/bookkeeper/client/LedgerCreateOp.java,157,210,26.25,210,53,6.625,53,263,32.875,263,181,22.625,181,8,0,3,YES
1,bookkeeper-server/src/main/java/org/apache/bookkeeper/client/LedgerDeleteOp.java,81,92,23.0,92,11,2.75,11,103,25.75,103,81,20.25,81,4,0,3,YES
1,bookkeeper-server/src/main/java/org/apache/bookkeeper/client/LedgerEntry.java,84,133,44.333332,133,49,16.333334,49,182,60.666668,182,84,28.0,84,3,0,2,NO
1,bookkeeper-server/src/main/java/org/apache/bookkeeper/client/LedgerHandle.java,762,1462,121.833336,1462,700,58.333332,700,2162,180.16667,2162,770,64.166664,770,12,0,3,YES
1,bookkeeper-server/src/main/java/org/apache/bookkeeper/client/LedgerMetadata.java,248,288,41.142857,288,40,5.714286,40,328,46.857143,328,252,36.0,252,7,0,3,YES
1,bookkeeper-server/src/main/java/org/apache/bookkeeper/client/LedgerOpenOp.java,169,232,25.777779,232,63,7.0,63,295,32.77778,295,171,19.0,171,9,0,3,YES
1,bookkeeper-server/src/main/java/org/apache/bookkeeper/client/LedgerRecoveryOp.java,196,224,37.333332,224,28,4.6666665,28,252,42.0,252,196,32.666668,196,6,0,3,YES
1,bookkeeper-server/src/main/java/org/apache/bookkeeper/client/MacDigestManager.java,67,76,19.0,76,9,2.25,9,85,21.25,85,67,16.75,67,4,0,3,NO
1,bookkeeper-server/src/main/java/org/apache/bookkeeper/client/PendingAddOp.java,165,182,45.5,182,17,4.25,17,199,49.75,199,165,41.25,165,4,0,3,YES
1,bookkeeper-server/src/main/java/org/apache/bookkeeper/client/PendingReadOp.java,173,193,48.25,193,20,5.0,20,213,53.25,213,173,43.25,173,4,0,3,YES
1,bookkeeper-server/src/main/java/org/apache/bookkeeper/client/ReadLastConfirmedOp.java,103,127,21.166666,127,24,4.0,24,151,25.166666,151,107,17.833334,107,6,0,2,YES
1,bookkeeper-server/src/main/java/org/apache/bookkeeper/client/ReadOnlyLedgerHandle.java,78,78,78.0,78,0,0.0,0,78,78.0,78,78,78.0,78,1,0,1,YES
1,bookkeeper-server/src/main/java/org/apache/bookkeeper/client/RoundRobinDistributionSchedule.java,87,88,44.0,88,1,0.5,1,89,44.5,89,87,43.5,87,2,0,2,YES
1,bookkeeper-server/src/main/java/org/apache/bookkeeper/client/SyncCounter.java,85,86,43.0,86,1,0.5,1,87,43.5,87,85,42.5,85,2,0,2,NO
1,bookkeeper-server/src/main/java/org/apache/bookkeeper/conf/AbstractConfiguration.java,105,106,53.0,106,1,0.5,1,107,53.5,107,105,52.5,105,2,0,1,YES
1,bookkeeper-server/src/main/java/org/apache/bookkeeper/conf/ClientConfiguration.java,216,224,56.0,224,8,2.0,8,232,58.0,232,216,54.0,216,4,0,2,YES
1,bookkeeper-server/src/main/java/org/apache/bookkeeper/conf/ServerConfiguration.java,377,397,99.25,397,20,5.0,20,417,104.25,417,377,94.25,377,4,0,2,YES
1,bookkeeper-server/src/main/java/org/apache/bookkeeper/meta/AbstractZkLedgerManager.java,253,255,127.5,255,2,1.0,2,257,128.5,257,253,126.5,253,2,0,1,YES
1,bookkeeper-server/src/main/java/org/apache/bookkeeper/meta/FlatLedgerManager.java,193,193,193.0,193,0,0.0,0,193,193.0,193,193,193.0,193,1,0,1,YES
1,bookkeeper-server/src/main/java/org/apache/bookkeeper/meta/HierarchicalLedgerManager.java,514,514,514.0,514,0,0.0,0,514,514.0,514,514,514.0,514,1,0,1,YES
1,bookkeeper-server/src/main/java/org/apache/bookkeeper/meta/LedgerLayout.java,204,204,204.0,204,0,0.0,0,204,204.0,204,204,204.0,204,1,0,1,NO
1,bookkeeper-server/src/main/java/org/apache/bookkeeper/meta/LedgerManager.java,144,144,144.0,144,0,0.0,0,144,144.0,144,144,144.0,144,1,0,1,YES
1,bookkeeper-server/src/main/java/org/apache/bookkeeper/meta/LedgerManagerFactory.java,98,98,98.0,98,0,0.0,0,98,98.0,98,98,98.0,98,1,0,1,NO
1,bookkeeper-server/src/main/java/org/apache/bookkeeper/proto/BookieClient.java,181,203,29.0,203,22,3.142857,22,225,32.142857,225,189,27.0,189,7,0,3,YES
1,bookkeeper-server/src/main/java/org/apache/bookkeeper/proto/BookieProtocol.java,154,162,40.5,162,8,2.0,8,170,42.5,170,154,38.5,154,4,0,3,YES
1,bookkeeper-server/src/main/java/org/apache/bookkeeper/proto/BookieServer.java,393,489,44.454544,489,96,8.727273,96,585,53.18182,585,399,36.272728,399,11,0,3,YES
1,bookkeeper-server/src/main/java/org/apache/bookkeeper/proto/BookkeeperInternalCallbacks.java,132,139,46.333332,139,7,2.3333333,7,146,48.666668,146,132,44.0,132,3,0,3,NO
1,bookkeeper-server/src/main/java/org/apache/bookkeeper/proto/NIOServerFactory.java,533,556,69.5,556,23,2.875,23,579,72.375,579,535,66.875,535,8,0,3,YES
1,bookkeeper-server/src/main/java/org/apache/bookkeeper/proto/PerChannelBookieClient.java,603,683,75.888885,683,80,8.888889,80,763,84.77778,763,607,67.44444,607,9,0,3,YES
1,bookkeeper-server/src/main/java/org/apache/bookkeeper/proto/ServerStats.java,148,148,148.0,148,0,0.0,0,148,148.0,148,148,148.0,148,1,0,1,YES
1,bookkeeper-server/src/main/java/org/apache/bookkeeper/streaming/LedgerInputStream.java,174,184,61.333332,184,10,3.3333333,10,194,64.666664,194,174,58.0,174,3,0,2,NO
1,bookkeeper-server/src/main/java/org/apache/bookkeeper/streaming/LedgerOutputStream.java,148,158,52.666668,158,10,3.3333333,10,168,56.0,168,148,49.333332,148,3,0,2,NO
1,bookkeeper-server/src/main/java/org/apache/bookkeeper/tools/BookKeeperTools.java,92,834,139.0,834,742,123.666664,742,1576,262.66666,1576,1442,240.33333,1442,6,0,3,NO
1,bookkeeper-server/src/main/java/org/apache/bookkeeper/util/LocalBookKeeper.java,234,438,73.0,438,204,34.0,204,642,107.0,642,234,39.0,234,6,0,3,YES
1,bookkeeper-server/src/main/java/org/apache/bookkeeper/util/Main.java,54,59,19.666666,59,5,1.6666666,5,64,21.333334,64,54,18.0,54,3,0,3,NO
1,bookkeeper-server/src/main/java/org/apache/bookkeeper/util/MathUtils.java,38,43,21.5,43,5,2.5,5,48,24.0,48,38,19.0,38,2,0,2,YES
1,bookkeeper-server/src/main/java/org/apache/bookkeeper/util/OrderedSafeExecutor.java,98,102,51.0,102,4,2.0,4,106,53.0,106,98,49.0,98,2,0,2,YES
1,bookkeeper-server/src/main/java/org/apache/bookkeeper/util/SafeRunnable.java,39,49,16.333334,49,10,3.3333333,10,59,19.666666,59,39,13.0,39,3,0,2,NO
1,bookkeeper-server/src/main/java/org/apache/bookkeeper/util/StringUtils.java,69,98,32.666668,98,29,9.666667,29,127,42.333332,127,119,39.666668,119,3,0,3,YES
1,bookkeeper-server/src/main/java/org/apache/bookkeeper/util/ZkUtils.java,94,94,94.0,94,0,0.0,0,94,94.0,94,94,94.0,94,1,0,1,YES
1,hedwig-client/src/main/java/org/apache/hedwig/client/HedwigClient.java,72,72,72.0,72,0,0.0,0,72,72.0,72,72,72.0,72,1,0,1,NO
1,hedwig-client/src/main/java/org/apache/hedwig/client/api/Client.java,42,42,42.0,42,0,0.0,0,42,42.0,42,42,42.0,42,1,0,1,NO
1,hedwig-client/src/main/java/org/apache/hedwig/client/api/MessageHandler.java,48,56,18.666666,56,8,2.6666667,8,64,21.333334,64,48,16.0,48,3,0,2,NO
1,hedwig-client/src/main/java/org/apache/hedwig/client/api/Publisher.java,63,67,33.5,67,4,2.0,4,71,35.5,71,63,31.5,63,2,0,2,YES
1,hedwig-client/src/main/java/org/apache/hedwig/client/api/Subscriber.java,237,257,128.5,257,20,10.0,20,277,138.5,277,237,118.5,237,2,0,2,YES
1,hedwig-client/src/main/java/org/apache/hedwig/client/benchmark/BenchmarkPublisher.java,133,139,46.333332,139,6,2.0,6,145,48.333332,145,133,44.333332,133,3,0,2,YES
1,hedwig-client/src/main/java/org/apache/hedwig/client/benchmark/BenchmarkSubscriber.java,137,150,37.5,150,13,3.25,13,163,40.75,163,137,34.25,137,4,0,2,YES
1,hedwig-client/src/main/java/org/apache/hedwig/client/benchmark/BenchmarkUtils.java,177,181,60.333332,181,4,1.3333334,4,185,61.666668,185,177,59.0,177,3,0,2,YES
1,hedwig-client/src/main/java/org/apache/hedwig/client/benchmark/BenchmarkWorker.java,46,47,23.5,47,1,0.5,1,48,24.0,48,46,23.0,46,2,0,2,NO
1,hedwig-client/src/main/java/org/apache/hedwig/client/benchmark/HedwigBenchmark.java,128,137,27.4,137,9,1.8,9,146,29.2,146,128,25.6,128,5,0,3,NO
1,hedwig-client/src/main/java/org/apache/hedwig/client/conf/ClientConfiguration.java,149,152,50.666668,152,3,1.0,3,155,51.666668,155,149,49.666668,149,3,0,2,NO
1,hedwig-client/src/main/java/org/apache/hedwig/client/data/MessageConsumeData.java,58,59,29.5,59,1,0.5,1,60,30.0,60,58,29.0,58,2,0,2,NO
1,hedwig-client/src/main/java/org/apache/hedwig/client/data/PubSubData.java,149,152,76.0,152,3,1.5,3,155,77.5,155,149,74.5,149,2,0,2,YES
1,hedwig-client/src/main/java/org/apache/hedwig/client/data/TopicSubscriber.java,74,78,39.0,78,4,2.0,4,82,41.0,82,74,37.0,74,2,0,2,NO
1,hedwig-client/src/main/java/org/apache/hedwig/client/exceptions/InvalidSubscriberIdException.java,37,37,37.0,37,0,0.0,0,37,37.0,37,37,37.0,37,1,0,1,NO
1,hedwig-client/src/main/java/org/apache/hedwig/client/exceptions/ServerRedirectLoopException.java,38,40,20.0,40,2,1.0,2,42,21.0,42,38,19.0,38,2,0,2,NO
1,hedwig-client/src/main/java/org/apache/hedwig/client/exceptions/TooManyServerRedirectsException.java,39,40,20.0,40,1,0.5,1,41,20.5,41,39,19.5,39,2,0,2,NO
1,hedwig-client/src/main/java/org/apache/hedwig/client/handlers/MessageConsumeCallback.java,96,107,26.75,107,11,2.75,11,118,29.5,118,96,24.0,96,4,0,2,YES
1,hedwig-client/src/main/java/org/apache/hedwig/client/handlers/PubSubCallback.java,88,91,30.333334,91,3,1.0,3,94,31.333334,94,88,29.333334,88,3,0,2,NO
1,hedwig-client/src/main/java/org/apache/hedwig/client/handlers/PublishResponseHandler.java,71,78,19.5,78,7,1.75,7,85,21.25,85,71,17.75,71,4,0,2,NO
1,hedwig-client/src/main/java/org/apache/hedwig/client/handlers/SubscribeReconnectCallback.java,114,123,30.75,123,9,2.25,9,132,33.0,132,114,28.5,114,4,0,2,NO
1,hedwig-client/src/main/java/org/apache/hedwig/client/handlers/SubscribeResponseHandler.java,336,414,69.0,414,78,13.0,78,492,82.0,492,336,56.0,336,6,0,3,YES
1,hedwig-client/src/main/java/org/apache/hedwig/client/handlers/UnsubscribeResponseHandler.java,84,93,23.25,93,9,2.25,9,102,25.5,102,84,21.0,84,4,0,2,NO
1,hedwig-client/src/main/java/org/apache/hedwig/client/netty/ClientChannelPipelineFactory.java,58,63,21.0,63,5,1.6666666,5,68,22.666666,68,58,19.333334,58,3,0,2,NO
1,hedwig-client/src/main/java/org/apache/hedwig/client/netty/ConnectCallback.java,123,130,32.5,130,7,1.75,7,137,34.25,137,123,30.75,123,4,0,2,YES
1,hedwig-client/src/main/java/org/apache/hedwig/client/netty/HedwigClientImpl.java,369,369,369.0,369,0,0.0,0,369,369.0,369,369,369.0,369,1,0,1,YES
1,hedwig-client/src/main/java/org/apache/hedwig/client/netty/HedwigPublisher.java,231,243,48.6,243,12,2.4,12,255,51.0,255,231,46.2,231,5,0,2,YES
1,hedwig-client/src/main/java/org/apache/hedwig/client/netty/HedwigSubscriber.java,586,645,161.25,645,59,14.75,59,704,176.0,704,586,146.5,586,4,0,2,YES
1,hedwig-client/src/main/java/org/apache/hedwig/client/netty/ResponseHandler.java,366,390,78.0,390,24,4.8,24,414,82.8,414,366,73.2,366,5,0,2,YES
1,hedwig-client/src/main/java/org/apache/hedwig/client/netty/WriteCallback.java,99,108,27.0,108,9,2.25,9,117,29.25,117,99,24.75,99,4,0,2,YES
1,hedwig-client/src/main/java/org/apache/hedwig/client/ssl/SslClientContextFactory.java,41,41,41.0,41,0,0.0,0,41,41.0,41,41,41.0,41,1,0,1,NO
1,hedwig-client/src/main/java/org/apache/hedwig/client/ssl/SslContextFactory.java,66,79,39.5,79,13,6.5,13,92,46.0,92,66,33.0,66,2,0,2,NO
1,hedwig-client/src/main/java/org/apache/hedwig/conf/AbstractConfiguration.java,54,55,18.333334,55,1,0.33333334,1,56,18.666666,56,54,18.0,54,3,0,3,NO
1,hedwig-client/src/main/java/org/apache/hedwig/util/Callback.java,47,51,25.5,51,4,2.0,4,55,27.5,55,47,23.5,47,2,0,2,NO
1,hedwig-client/src/main/java/org/apache/hedwig/util/CallbackUtils.java,183,203,50.75,203,20,5.0,20,223,55.75,223,187,46.75,187,4,0,3,NO
1,hedwig-client/src/main/java/org/apache/hedwig/util/ConcurrencyUtils.java,49,49,49.0,49,0,0.0,0,49,49.0,49,49,49.0,49,1,0,1,NO
1,hedwig-client/src/main/java/org/apache/hedwig/util/Either.java,50,50,50.0,50,0,0.0,0,50,50.0,50,50,50.0,50,1,0,1,NO
1,hedwig-client/src/main/java/org/apache/hedwig/util/FileUtils.java,98,100,50.0,100,2,1.0,2,102,51.0,102,98,49.0,98,2,0,2,NO
1,hedwig-client/src/main/java/org/apache/hedwig/util/HedwigSocketAddress.java,138,138,138.0,138,0,0.0,0,138,138.0,138,138,138.0,138,1,0,1,NO
1,hedwig-client/src/main/java/org/apache/hedwig/util/Option.java,43,43,43.0,43,0,0.0,0,43,43.0,43,43,43.0,43,1,0,1,NO
1,hedwig-client/src/main/java/org/apache/hedwig/util/Pair.java,42,42,42.0,42,0,0.0,0,42,42.0,42,42,42.0,42,1,0,1,NO
1,hedwig-client/src/main/java/org/apache/hedwig/util/PathUtils.java,56,56,56.0,56,0,0.0,0,56,56.0,56,56,56.0,56,1,0,1,NO
1,hedwig-protocol/src/main/java/org/apache/hedwig/exceptions/PubSubException.java,162,163,81.5,163,1,0.5,1,164,82.0,164,162,81.0,162,2,0,2,YES
1,hedwig-protocol/src/main/java/org/apache/hedwig/protocol/PubSubProtocol.java,6367,12222,6111.0,12222,5855,2927.5,5855,18077,9038.5,18077,6367,3183.5,6367,2,0,2,YES
1,hedwig-protocol/src/main/java/org/apache/hedwig/protoextensions/MessageIdUtils.java,153,155,77.5,155,2,1.0,2,157,78.5,157,153,76.5,153,2,0,2,NO
1,hedwig-protocol/src/main/java/org/apache/hedwig/protoextensions/PubSubResponseUtils.java,43,43,43.0,43,0,0.0,0,43,43.0,43,43,43.0,43,1,0,1,NO
1,hedwig-protocol/src/main/java/org/apache/hedwig/protoextensions/SubscriptionStateUtils.java,41,42,21.0,42,1,0.5,1,43,21.5,43,41,20.5,41,2,0,2,NO
1,hedwig-server/src/main/java/org/apache/hedwig/server/benchmark/AbstractBenchmark.java,105,155,51.666668,155,50,16.666666,50,205,68.333336,205,105,35.0,105,3,0,2,YES
1,hedwig-server/src/main/java/org/apache/hedwig/server/benchmark/BookieBenchmark.java,105,148,29.6,148,43,8.6,43,191,38.2,191,105,21.0,105,5,0,3,YES
1,hedwig-server/src/main/java/org/apache/hedwig/server/benchmark/BookkeeperBenchmark.java,92,126,31.5,126,34,8.5,34,160,40.0,160,92,23.0,92,4,0,3,YES
1,hedwig-server/src/main/java/org/apache/hedwig/server/benchmark/FakeBookie.java,101,151,50.333332,151,50,16.666666,50,201,67.0,201,101,33.666668,101,3,0,2,NO
1,hedwig-server/src/main/java/org/apache/hedwig/server/common/ByteStringInterner.java,45,45,45.0,45,0,0.0,0,45,45.0,45,45,45.0,45,1,0,1,YES
1,hedwig-server/src/main/java/org/apache/hedwig/server/common/ServerConfiguration.java,289,290,145.0,290,1,0.5,1,291,145.5,291,289,144.5,289,2,0,2,YES
1,hedwig-server/src/main/java/org/apache/hedwig/server/common/TerminateJVMExceptionHandler.java,32,35,17.5,35,3,1.5,3,38,19.0,38,32,16.0,32,2,0,2,NO
1,hedwig-server/src/main/java/org/apache/hedwig/server/common/TopicOpQueuer.java,111,111,111.0,111,0,0.0,0,111,111.0,111,111,111.0,111,1,0,1,NO
1,hedwig-server/src/main/java/org/apache/hedwig/server/common/UnexpectedError.java,35,36,18.0,36,1,0.5,1,37,18.5,37,35,17.5,35,2,0,2,NO
1,hedwig-server/src/main/java/org/apache/hedwig/server/delivery/ChannelEndPoint.java,81,81,81.0,81,0,0.0,0,81,81.0,81,81,81.0,81,1,0,1,YES
1,hedwig-server/src/main/java/org/apache/hedwig/server/delivery/DeliveryCallback.java,27,27,27.0,27,0,0.0,0,27,27.0,27,27,27.0,27,1,0,1,NO
1,hedwig-server/src/main/java/org/apache/hedwig/server/delivery/DeliveryEndPoint.java,28,28,28.0,28,0,0.0,0,28,28.0,28,28,28.0,28,1,0,1,NO
1,hedwig-server/src/main/java/org/apache/hedwig/server/delivery/DeliveryManager.java,29,30,15.0,30,1,0.5,1,31,15.5,31,29,14.5,29,2,0,2,YES
1,hedwig-server/src/main/java/org/apache/hedwig/server/delivery/FIFODeliveryManager.java,566,600,150.0,600,34,8.5,34,634,158.5,634,566,141.5,566,4,0,3,YES
1,hedwig-server/src/main/java/org/apache/hedwig/server/handlers/BaseHandler.java,64,80,40.0,80,16,8.0,16,96,48.0,96,64,32.0,64,2,0,2,NO
1,hedwig-server/src/main/java/org/apache/hedwig/server/handlers/ChannelDisconnectListener.java,29,30,15.0,30,1,0.5,1,31,15.5,31,29,14.5,29,2,0,2,NO
1,hedwig-server/src/main/java/org/apache/hedwig/server/handlers/ConsumeHandler.java,64,65,32.5,65,1,0.5,1,66,33.0,66,64,32.0,64,2,0,2,NO
1,hedwig-server/src/main/java/org/apache/hedwig/server/handlers/Handler.java,37,40,20.0,40,3,1.5,3,43,21.5,43,37,18.5,37,2,0,2,NO
1,hedwig-server/src/main/java/org/apache/hedwig/server/handlers/PublishHandler.java,68,79,39.5,79,11,5.5,11,90,45.0,90,68,34.0,68,2,0,2,YES
1,hedwig-server/src/main/java/org/apache/hedwig/server/handlers/SubscribeHandler.java,154,165,55.0,165,11,3.6666667,11,176,58.666668,176,154,51.333332,154,3,0,2,YES
1,hedwig-server/src/main/java/org/apache/hedwig/server/handlers/UnsubscribeHandler.java,72,73,36.5,73,1,0.5,1,74,37.0,74,72,36.0,72,2,0,2,YES
1,hedwig-server/src/main/java/org/apache/hedwig/server/netty/PubSubServer.java,385,400,66.666664,400,15,2.5,15,415,69.166664,415,385,64.166664,385,6,0,3,YES
1,hedwig-server/src/main/java/org/apache/hedwig/server/netty/PubSubServerPipelineFactory.java,76,78,39.0,78,2,1.0,2,80,40.0,80,76,38.0,76,2,0,2,NO
1,hedwig-server/src/main/java/org/apache/hedwig/server/netty/UmbrellaHandler.java,159,163,54.333332,163,4,1.3333334,4,167,55.666668,167,159,53.0,159,3,0,2,NO
1,hedwig-server/src/main/java/org/apache/hedwig/server/persistence/BookkeeperPersistenceManager.java,737,886,295.33334,886,149,49.666668,149,1035,345.0,1035,737,245.66667,737,3,0,2,YES
1,hedwig-server/src/main/java/org/apache/hedwig/server/persistence/CacheKey.java,74,76,38.0,76,2,1.0,2,78,39.0,78,74,37.0,74,2,0,2,NO
1,hedwig-server/src/main/java/org/apache/hedwig/server/persistence/CacheValue.java,94,97,32.333332,97,3,1.0,3,100,33.333332,100,94,31.333334,94,3,0,2,NO
1,hedwig-server/src/main/java/org/apache/hedwig/server/persistence/Factory.java,22,22,22.0,22,0,0.0,0,22,22.0,22,22,22.0,22,1,0,1,NO
1,hedwig-server/src/main/java/org/apache/hedwig/server/persistence/LocalDBPersistenceManager.java,427,439,146.33333,439,12,4.0,12,451,150.33333,451,427,142.33333,427,3,0,2,NO
1,hedwig-server/src/main/java/org/apache/hedwig/server/persistence/MapMethods.java,62,62,62.0,62,0,0.0,0,62,62.0,62,62,62.0,62,1,0,1,NO
1,hedwig-server/src/main/java/org/apache/hedwig/server/persistence/PersistRequest.java,58,59,29.5,59,1,0.5,1,60,30.0,60,58,29.0,58,2,0,2,NO
1,hedwig-server/src/main/java/org/apache/hedwig/server/persistence/PersistenceManager.java,91,96,48.0,96,5,2.5,5,101,50.5,101,91,45.5,91,2,0,2,NO
1,hedwig-server/src/main/java/org/apache/hedwig/server/persistence/PersistenceManagerWithRangeScan.java,27,28,14.0,28,1,0.5,1,29,14.5,29,27,13.5,27,2,0,2,NO
1,hedwig-server/src/main/java/org/apache/hedwig/server/persistence/RangeScanRequest.java,77,79,39.5,79,2,1.0,2,81,40.5,81,77,38.5,77,2,0,2,NO
1,hedwig-server/src/main/java/org/apache/hedwig/server/persistence/ReadAheadCache.java,704,742,247.33333,742,38,12.666667,38,780,260.0,780,704,234.66667,704,3,0,2,YES
1,hedwig-server/src/main/java/org/apache/hedwig/server/persistence/ScanCallback.java,63,67,33.5,67,4,2.0,4,71,35.5,71,63,31.5,63,2,0,2,NO
1,hedwig-server/src/main/java/org/apache/hedwig/server/persistence/ScanCallbackWithContext.java,37,37,37.0,37,0,0.0,0,37,37.0,37,37,37.0,37,1,0,1,NO
1,hedwig-server/src/main/java/org/apache/hedwig/server/persistence/ScanRequest.java,64,65,32.5,65,1,0.5,1,66,33.0,66,64,32.0,64,2,0,2,NO
1,hedwig-server/src/main/java/org/apache/hedwig/server/proxy/ChannelTracker.java,124,127,63.5,127,3,1.5,3,130,65.0,130,124,62.0,124,2,0,2,NO
1,hedwig-server/src/main/java/org/apache/hedwig/server/proxy/HedwigProxy.java,160,167,41.75,167,7,1.75,7,174,43.5,174,160,40.0,160,4,0,2,NO
1,hedwig-server/src/main/java/org/apache/hedwig/server/proxy/ProxyConfiguration.java,36,41,20.5,41,5,2.5,5,46,23.0,46,36,18.0,36,2,0,2,NO
1,hedwig-server/src/main/java/org/apache/hedwig/server/proxy/ProxyConsumeHandler.java,58,60,30.0,60,2,1.0,2,62,31.0,62,58,29.0,58,2,0,2,NO
1,hedwig-server/src/main/java/org/apache/hedwig/server/proxy/ProxyPublishHander.java,62,62,62.0,62,0,0.0,0,62,62.0,62,62,62.0,62,1,0,1,NO
1,hedwig-server/src/main/java/org/apache/hedwig/server/proxy/ProxyStartDeliveryHandler.java,130,142,35.5,142,12,3.0,12,154,38.5,154,130,32.5,130,4,0,2,NO
1,hedwig-server/src/main/java/org/apache/hedwig/server/proxy/ProxyStopDeliveryHandler.java,74,76,38.0,76,2,1.0,2,78,39.0,78,74,37.0,74,2,0,2,NO
1,hedwig-server/src/main/java/org/apache/hedwig/server/proxy/ProxySubscribeHandler.java,83,86,28.666666,86,3,1.0,3,89,29.666666,89,83,27.666666,83,3,0,2,NO
1,hedwig-server/src/main/java/org/apache/hedwig/server/proxy/ProxyUnsubscribeHandler.java,74,74,74.0,74,0,0.0,0,74,74.0,74,74,74.0,74,1,0,1,NO
1,hedwig-server/src/main/java/org/apache/hedwig/server/regions/HedwigHubClient.java,48,50,25.0,50,2,1.0,2,52,26.0,52,48,24.0,48,2,0,2,NO
1,hedwig-server/src/main/java/org/apache/hedwig/server/regions/HedwigHubClientFactory.java,60,61,30.5,61,1,0.5,1,62,31.0,62,60,30.0,60,2,0,2,YES
1,hedwig-server/src/main/java/org/apache/hedwig/server/regions/HedwigHubSubscriber.java,70,76,25.333334,76,6,2.0,6,82,27.333334,82,70,23.333334,70,3,0,2,NO
1,hedwig-server/src/main/java/org/apache/hedwig/server/regions/RegionManager.java,183,202,50.5,202,19,4.75,19,221,55.25,221,183,45.75,183,4,0,2,NO
1,hedwig-server/src/main/java/org/apache/hedwig/server/ssl/SslServerContextFactory.java,53,53,53.0,53,0,0.0,0,53,53.0,53,53,53.0,53,1,0,1,NO
1,hedwig-server/src/main/java/org/apache/hedwig/server/subscriptions/AbstractSubscriptionManager.java,452,472,118.0,472,20,5.0,20,492,123.0,492,452,113.0,452,4,0,2,YES
1,hedwig-server/src/main/java/org/apache/hedwig/server/subscriptions/AllToAllTopologyFilter.java,39,39,39.0,39,0,0.0,0,39,39.0,39,39,39.0,39,1,0,1,NO
1,hedwig-server/src/main/java/org/apache/hedwig/server/subscriptions/InMemorySubscriptionManager.java,78,82,41.0,82,4,2.0,4,86,43.0,86,78,39.0,78,2,0,2,YES
1,hedwig-server/src/main/java/org/apache/hedwig/server/subscriptions/InMemorySubscriptionState.java,64,65,32.5,65,1,0.5,1,66,33.0,66,64,32.0,64,2,0,2,YES
1,hedwig-server/src/main/java/org/apache/hedwig/server/subscriptions/MessageFilter.java,31,32,16.0,32,1,0.5,1,33,16.5,33,31,15.5,31,2,0,2,NO
1,hedwig-server/src/main/java/org/apache/hedwig/server/subscriptions/SubscriptionEventListener.java,57,61,30.5,61,4,2.0,4,65,32.5,65,57,28.5,57,2,0,2,NO
1,hedwig-server/src/main/java/org/apache/hedwig/server/subscriptions/SubscriptionManager.java,104,111,55.5,111,7,3.5,7,118,59.0,118,104,52.0,104,2,0,2,NO
1,hedwig-server/src/main/java/org/apache/hedwig/server/subscriptions/TrueFilter.java,32,32,32.0,32,0,0.0,0,32,32.0,32,32,32.0,32,1,0,1,NO
1,hedwig-server/src/main/java/org/apache/hedwig/server/subscriptions/ZkSubscriptionManager.java,227,279,93.0,279,52,17.333334,52,331,110.333336,331,227,75.666664,227,3,0,2,NO
1,hedwig-server/src/main/java/org/apache/hedwig/server/topics/AbstractTopicManager.java,197,208,52.0,208,11,2.75,11,219,54.75,219,197,49.25,197,4,0,3,NO
1,hedwig-server/src/main/java/org/apache/hedwig/server/topics/TopicManager.java,75,81,40.5,81,6,3.0,6,87,43.5,87,75,37.5,75,2,0,2,NO
1,hedwig-server/src/main/java/org/apache/hedwig/server/topics/TopicOwnershipChangeListener.java,28,28,28.0,28,0,0.0,0,28,28.0,28,28,28.0,28,1,0,1,NO
1,hedwig-server/src/main/java/org/apache/hedwig/server/topics/TrivialOwnAllTopicManager.java,52,54,27.0,54,2,1.0,2,56,28.0,56,52,26.0,52,2,0,2,NO
1,hedwig-server/src/main/java/org/apache/hedwig/server/topics/ZkTopicManager.java,429,506,168.66667,506,77,25.666666,77,583,194.33333,583,429,143.0,429,3,0,2,NO
1,hedwig-server/src/main/java/org/apache/hedwig/zookeeper/SafeAsynBKCallback.java,103,134,67.0,134,30,15.0,30,164,82.0,164,104,52.0,104,2,0,2,NO
1,hedwig-server/src/main/java/org/apache/hedwig/zookeeper/SafeAsyncCallback.java,35,35,35.0,35,0,0.0,0,35,35.0,35,35,35.0,35,1,0,1,NO
1,hedwig-server/src/main/java/org/apache/hedwig/zookeeper/SafeAsyncZKCallback.java,98,99,49.5,99,1,0.5,1,100,50.0,100,98,49.0,98,2,0,2,NO
1,hedwig-server/src/main/java/org/apache/hedwig/zookeeper/ZkUtils.java,79,94,31.333334,94,15,5.0,15,109,36.333332,109,79,26.333334,79,3,0,2,NO
2,bookkeeper-benchmark/src/main/java/org/apache/bookkeeper/benchmark/BenchBookie.java,215,227,75.666664,227,12,4.0,12,239,79.666664,239,215,71.666664,215,3,1,1,NO
2,bookkeeper-benchmark/src/main/java/org/apache/bookkeeper/benchmark/BenchReadThroughputLatency.java,271,284,142.0,284,13,6.5,13,297,148.5,297,271,135.5,271,2,0,1,YES
2,bookkeeper-benchmark/src/main/java/org/apache/bookkeeper/benchmark/BenchThroughputLatency.java,451,534,106.8,534,83,16.6,83,617,123.4,617,459,91.8,459,5,0,3,YES
2,bookkeeper-benchmark/src/main/java/org/apache/bookkeeper/benchmark/MySqlClient.java,137,0,0.0,0,0,0.0,0,0,0.0,0,0,0.0,0,0,0,0,YES
2,bookkeeper-benchmark/src/main/java/org/apache/bookkeeper/benchmark/TestClient.java,368,305,152.5,305,181,90.5,181,486,243.0,486,124,62.0,124,2,0,2,YES
2,bookkeeper-server/src/main/java/org/apache/bookkeeper/bookie/Bookie.java,764,580,29.0,580,842,42.1,842,1422,71.1,1422,612,30.6,612,20,7,3,YES
2,bookkeeper-server/src/main/java/org/apache/bookkeeper/bookie/BookieBean.java,51,53,26.5,53,2,1.0,2,55,27.5,55,53,26.5,53,2,0,2,NO
2,bookkeeper-server/src/main/java/org/apache/bookkeeper/bookie/BookieException.java,150,63,31.5,63,5,2.5,5,68,34.0,68,58,29.0,58,2,1,2,YES
2,bookkeeper-server/src/main/java/org/apache/bookkeeper/bookie/BookieMXBean.java,31,33,16.5,33,2,1.0,2,35,17.5,35,35,17.5,35,2,0,2,NO
2,bookkeeper-server/src/main/java/org/apache/bookkeeper/bookie/BufferedChannel.java,180,0,0.0,0,0,0.0,0,0,0.0,0,0,0.0,0,0,0,0,NO
2,bookkeeper-server/src/main/java/org/apache/bookkeeper/bookie/Cookie.java,196,202,101.0,202,6,3.0,6,208,104.0,208,196,98.0,196,2,1,1,YES
2,bookkeeper-server/src/main/java/org/apache/bookkeeper/bookie/EntryLogger.java,473,375,31.25,375,373,31.083334,373,748,62.333332,748,282,23.5,282,12,5,3,YES
2,bookkeeper-server/src/main/java/org/apache/bookkeeper/bookie/ExitCode.java,40,40,40.0,40,0,0.0,0,40,40.0,40,40,40.0,40,1,1,1,NO
2,bookkeeper-server/src/main/java/org/apache/bookkeeper/bookie/FileInfo.java,255,130,32.5,130,79,19.75,79,209,52.25,209,51,12.75,51,4,2,1,YES
2,bookkeeper-server/src/main/java/org/apache/bookkeeper/bookie/FileSystemUpgrade.java,379,401,100.25,401,22,5.5,22,423,105.75,423,379,94.75,379,4,1,3,YES
2,bookkeeper-server/src/main/java/org/apache/bookkeeper/bookie/GarbageCollectorThread.java,509,545,77.85714,545,36,5.142857,36,581,83.0,581,541,77.28571,541,7,1,3,YES
2,bookkeeper-server/src/main/java/org/apache/bookkeeper/bookie/HandleFactory.java,32,32,32.0,32,0,0.0,0,32,32.0,32,32,32.0,32,1,0,1,NO
2,bookkeeper-server/src/main/java/org/apache/bookkeeper/bookie/HandleFactoryImpl.java,66,74,37.0,74,8,4.0,8,82,41.0,82,72,36.0,72,2,0,1,NO
2,bookkeeper-server/src/main/java/org/apache/bookkeeper/bookie/InterleavedLedgerStorage.java,187,211,52.75,211,24,6.0,24,235,58.75,235,191,47.75,191,4,2,2,YES
2,bookkeeper-server/src/main/java/org/apache/bookkeeper/bookie/Journal.java,576,589,196.33333,589,13,4.3333335,13,602,200.66667,602,576,192.0,576,3,0,2,YES
2,bookkeeper-server/src/main/java/org/apache/bookkeeper/bookie/JournalChannel.java,158,161,53.666668,161,3,1.0,3,164,54.666668,164,158,52.666668,158,3,0,1,YES
2,bookkeeper-server/src/main/java/org/apache/bookkeeper/bookie/LedgerCache.java,46,128,16.0,128,633,79.125,633,761,95.125,761,579,72.375,579,8,2,2,YES
2,bookkeeper-server/src/main/java/org/apache/bookkeeper/bookie/LedgerCacheBean.java,27,80,40.0,80,53,26.5,53,133,66.5,133,131,65.5,131,2,0,1,NO
2,bookkeeper-server/src/main/java/org/apache/bookkeeper/bookie/LedgerCacheImpl.java,788,842,120.28571,842,54,7.714286,54,896,128.0,896,788,112.57143,788,7,4,3,YES
2,bookkeeper-server/src/main/java/org/apache/bookkeeper/bookie/LedgerCacheMXBean.java,60,60,60.0,60,0,0.0,0,60,60.0,60,60,60.0,60,1,0,1,NO
2,bookkeeper-server/src/main/java/org/apache/bookkeeper/bookie/LedgerDescriptor.java,62,74,14.8,74,161,32.2,161,235,47.0,235,159,31.8,159,5,1,1,YES
2,bookkeeper-server/src/main/java/org/apache/bookkeeper/bookie/LedgerDescriptorImpl.java,88,118,59.0,118,30,15.0,30,148,74.0,148,138,69.0,138,2,0,1,YES
2,bookkeeper-server/src/main/java/org/apache/bookkeeper/bookie/LedgerDescriptorReadOnlyImpl.java,52,55,27.5,55,3,1.5,3,58,29.0,58,54,27.0,54,2,0,1,YES
2,bookkeeper-server/src/main/java/org/apache/bookkeeper/bookie/LedgerEntryPage.java,163,9,4.5,9,3,1.5,3,12,6.0,12,6,3.0,6,2,1,2,NO
2,bookkeeper-server/src/main/java/org/apache/bookkeeper/bookie/LedgerStorage.java,91,91,91.0,91,0,0.0,0,91,91.0,91,91,91.0,91,1,0,1,YES
2,bookkeeper-server/src/main/java/org/apache/bookkeeper/bookie/MarkerFileChannel.java,147,0,0.0,0,0,0.0,0,0,0.0,0,0,0.0,0,0,0,0,NO
2,bookkeeper-server/src/main/java/org/apache/bookkeeper/client/AsyncCallback.java,139,12,12.0,12,10,10.0,10,22,22.0,22,2,2.0,2,1,1,1,NO
2,bookkeeper-server/src/main/java/org/apache/bookkeeper/client/BKException.java,282,11,11.0,11,0,0.0,0,11,11.0,11,11,11.0,11,1,0,1,NO
2,bookkeeper-server/src/main/java/org/apache/bookkeeper/client/BookKeeper.java,582,152,25.333334,152,118,19.666666,118,270,45.0,270,116,19.333334,116,6,3,3,YES
2,bookkeeper-server/src/main/java/org/apache/bookkeeper/client/BookKeeperAdmin.java,800,91,22.75,91,19,4.75,19,110,27.5,110,72,18.0,72,4,1,2,YES
2,bookkeeper-server/src/main/java/org/apache/bookkeeper/client/BookieWatcher.java,216,19,6.3333335,19,8,2.6666667,8,27,9.0,27,11,3.6666667,11,3,2,1,YES
2,bookkeeper-server/src/main/java/org/apache/bookkeeper/client/CRC32DigestManager.java,55,9,9.0,9,4,4.0,4,13,13.0,13,5,5.0,5,1,0,1,NO
2,bookkeeper-server/src/main/java/org/apache/bookkeeper/client/DigestManager.java,184,8,2.6666667,8,9,3.0,9,17,5.6666665,17,3,1.0,3,3,2,2,NO
2,bookkeeper-server/src/main/java/org/apache/bookkeeper/client/DistributionSchedule.java,65,13,13.0,13,9,9.0,9,22,22.0,22,4,4.0,4,1,1,1,NO
2,bookkeeper-server/src/main/java/org/apache/bookkeeper/client/LedgerCreateOp.java,150,26,13.0,26,33,16.5,33,59,29.5,59,7,3.5,7,2,1,1,YES
2,bookkeeper-server/src/main/java/org/apache/bookkeeper/client/LedgerDeleteOp.java,81,0,0.0,0,0,0.0,0,0,0.0,0,0,0.0,0,0,0,0,YES
2,bookkeeper-server/src/main/java/org/apache/bookkeeper/client/LedgerEntry.java,84,0,0.0,0,0,0.0,0,0,0.0,0,0,0.0,0,0,0,0,NO
2,bookkeeper-server/src/main/java/org/apache/bookkeeper/client/LedgerHandle.java,905,221,24.555555,221,78,8.666667,78,299,33.22222,299,143,15.888889,143,9,5,3,YES
2,bookkeeper-server/src/main/java/org/apache/bookkeeper/client/LedgerMetadata.java,312,70,14.0,70,6,1.2,6,76,15.2,76,64,12.8,64,5,2,3,YES
2,bookkeeper-server/src/main/java/org/apache/bookkeeper/client/LedgerOpenOp.java,171,5,5.0,5,3,3.0,3,8,8.0,8,2,2.0,2,1,0,1,YES
2,bookkeeper-server/src/main/java/org/apache/bookkeeper/client/LedgerRecoveryOp.java,153,30,5.0,30,73,12.166667,73,103,17.166666,103,49,8.166667,49,6,3,3,YES
2,bookkeeper-server/src/main/java/org/apache/bookkeeper/client/MacDigestManager.java,84,26,26.0,26,9,9.0,9,35,35.0,35,17,17.0,17,1,0,1,YES
2,bookkeeper-server/src/main/java/org/apache/bookkeeper/client/PendingAddOp.java,169,5,2.5,5,1,0.5,1,6,3.0,6,4,2.0,4,2,1,2,YES
2,bookkeeper-server/src/main/java/org/apache/bookkeeper/client/PendingReadOp.java,189,17,5.6666665,17,1,0.33333334,1,18,6.0,18,16,5.3333335,16,3,1,2,YES
2,bookkeeper-server/src/main/java/org/apache/bookkeeper/client/ReadLastConfirmedOp.java,127,59,11.8,59,35,7.0,35,94,18.8,94,24,4.8,24,5,3,2,YES
2,bookkeeper-server/src/main/java/org/apache/bookkeeper/client/ReadOnlyLedgerHandle.java,79,2,2.0,2,1,1.0,1,3,3.0,3,1,1.0,1,1,1,1,YES
2,bookkeeper-server/src/main/java/org/apache/bookkeeper/client/RoundRobinDistributionSchedule.java,90,25,25.0,25,22,22.0,22,47,47.0,47,3,3.0,3,1,1,1,NO
2,bookkeeper-server/src/main/java/org/apache/bookkeeper/client/SyncCounter.java,85,0,0.0,0,0,0.0,0,0,0.0,0,0,0.0,0,0,0,0,NO
2,bookkeeper-server/src/main/java/org/apache/bookkeeper/conf/AbstractConfiguration.java,113,10,5.0,10,2,1.0,2,12,6.0,12,10,5.0,10,2,1,2,YES
2,bookkeeper-server/src/main/java/org/apache/bookkeeper/conf/ClientConfiguration.java,276,61,20.333334,61,1,0.33333334,1,62,20.666666,62,60,20.0,60,3,2,2,YES
2,bookkeeper-server/src/main/java/org/apache/bookkeeper/conf/ServerConfiguration.java,549,182,30.333334,182,10,1.6666666,10,192,32.0,192,182,30.333334,182,6,4,2,YES
2,bookkeeper-server/src/main/java/org/apache/bookkeeper/jmx/BKMBeanInfo.java,27,27,27.0,27,0,0.0,0,27,27.0,27,27,27.0,27,1,0,1,NO
2,bookkeeper-server/src/main/java/org/apache/bookkeeper/jmx/BKMBeanRegistry.java,88,89,44.5,89,1,0.5,1,90,45.0,90,88,44.0,88,2,0,1,YES
2,bookkeeper-server/src/main/java/org/apache/bookkeeper/meta/AbstractZkLedgerManager.java,283,36,9.0,36,6,1.5,6,42,10.5,42,30,7.5,30,4,3,3,YES
2,bookkeeper-server/src/main/java/org/apache/bookkeeper/meta/FlatLedgerManager.java,175,12,6.0,12,30,15.0,30,42,21.0,42,24,12.0,24,2,2,2,YES
2,bookkeeper-server/src/main/java/org/apache/bookkeeper/meta/HierarchicalLedgerManager.java,507,29,7.25,29,36,9.0,36,65,16.25,65,25,6.25,25,4,4,2,YES
2,bookkeeper-server/src/main/java/org/apache/bookkeeper/meta/LedgerLayout.java,209,5,5.0,5,0,0.0,0,5,5.0,5,5,5.0,5,1,0,1,NO
2,bookkeeper-server/src/main/java/org/apache/bookkeeper/meta/LedgerManager.java,147,5,5.0,5,2,2.0,2,7,7.0,7,3,3.0,3,1,1,1,NO
2,bookkeeper-server/src/main/java/org/apache/bookkeeper/meta/LedgerManagerFactory.java,98,1,1.0,1,1,1.0,1,2,2.0,2,0,0.0,0,1,0,1,YES
2,bookkeeper-server/src/main/java/org/apache/bookkeeper/meta/SnapshotMap.java,132,132,132.0,132,0,0.0,0,132,132.0,132,132,132.0,132,1,1,1,NO
2,bookkeeper-server/src/main/java/org/apache/bookkeeper/proto/BKStats.java,236,236,236.0,236,0,0.0,0,236,236.0,236,236,236.0,236,1,0,1,YES
2,bookkeeper-server/src/main/java/org/apache/bookkeeper/proto/BookieClient.java,227,49,16.333334,49,3,1.0,3,52,17.333334,52,46,15.333333,46,3,2,2,YES
2,bookkeeper-server/src/main/java/org/apache/bookkeeper/proto/BookieProtocol.java,172,20,6.6666665,20,2,0.6666667,2,22,7.3333335,22,18,6.0,18,3,2,2,NO
2,bookkeeper-server/src/main/java/org/apache/bookkeeper/proto/BookieServer.java,507,153,17.0,153,39,4.3333335,39,192,21.333334,192,114,12.666667,114,9,4,2,YES
2,bookkeeper-server/src/main/java/org/apache/bookkeeper/proto/BookieServerBean.java,90,90,90.0,90,0,0.0,0,90,90.0,90,90,90.0,90,1,0,1,YES
2,bookkeeper-server/src/main/java/org/apache/bookkeeper/proto/BookieServerMXBean.java,58,58,58.0,58,0,0.0,0,58,58.0,58,58,58.0,58,1,0,1,YES
2,bookkeeper-server/src/main/java/org/apache/bookkeeper/proto/BookkeeperInternalCallbacks.java,132,0,0.0,0,0,0.0,0,0,0.0,0,0,0.0,0,0,0,0,NO
2,bookkeeper-server/src/main/java/org/apache/bookkeeper/proto/NIOServerFactory.java,529,9,2.25,9,13,3.25,13,22,5.5,22,4,1.0,4,4,0,1,YES
2,bookkeeper-server/src/main/java/org/apache/bookkeeper/proto/PerChannelBookieClient.java,694,193,19.3,193,102,10.2,102,295,29.5,295,107,10.7,107,10,5,3,YES
2,bookkeeper-server/src/main/java/org/apache/bookkeeper/proto/ServerStats.java,148,0,0.0,0,0,0.0,0,0,0.0,0,0,0.0,0,0,0,0,YES
2,bookkeeper-server/src/main/java/org/apache/bookkeeper/streaming/LedgerInputStream.java,174,0,0.0,0,0,0.0,0,0,0.0,0,0,0.0,0,0,0,0,NO
2,bookkeeper-server/src/main/java/org/apache/bookkeeper/streaming/LedgerOutputStream.java,148,0,0.0,0,0,0.0,0,0,0.0,0,0,0.0,0,0,0,0,NO
2,bookkeeper-server/src/main/java/org/apache/bookkeeper/tools/BookKeeperTools.java,92,2,2.0,2,2,2.0,2,4,4.0,4,0,0.0,0,1,0,1,NO
2,bookkeeper-server/src/main/java/org/apache/bookkeeper/util/HardLink.java,664,666,333.0,666,1,0.5,1,667,333.5,667,665,332.5,665,2,0,1,YES
2,bookkeeper-server/src/main/java/org/apache/bookkeeper/util/IOUtils.java,55,55,55.0,55,0,0.0,0,55,55.0,55,55,55.0,55,1,0,1,NO
2,bookkeeper-server/src/main/java/org/apache/bookkeeper/util/LocalBookKeeper.java,256,43,14.333333,43,21,7.0,21,64,21.333334,64,22,7.3333335,22,3,1,2,YES
2,bookkeeper-server/src/main/java/org/apache/bookkeeper/util/Main.java,54,0,0.0,0,0,0.0,0,0,0.0,0,0,0.0,0,0,0,0,NO
2,bookkeeper-server/src/main/java/org/apache/bookkeeper/util/MathUtils.java,38,0,0.0,0,0,0.0,0,0,0.0,0,0,0.0,0,0,0,0,YES
2,bookkeeper-server/src/main/java/org/apache/bookkeeper/util/OrderedSafeExecutor.java,98,0,0.0,0,0,0.0,0,0,0.0,0,0,0.0,0,0,0,0,YES
2,bookkeeper-server/src/main/java/org/apache/bookkeeper/util/SafeRunnable.java,39,0,0.0,0,0,0.0,0,0,0.0,0,0,0.0,0,0,0,0,NO
2,bookkeeper-server/src/main/java/org/apache/bookkeeper/util/StringUtils.java,69,0,0.0,0,0,0.0,0,0,0.0,0,0,0.0,0,0,0,0,YES
2,bookkeeper-server/src/main/java/org/apache/bookkeeper/util/ZkUtils.java,94,0,0.0,0,0,0.0,0,0,0.0,0,0,0.0,0,0,0,0,YES
2,hedwig-client/src/main/java/org/apache/hedwig/client/HedwigClient.java,72,0,0.0,0,0,0.0,0,0,0.0,0,0,0.0,0,0,0,0,NO
2,hedwig-client/src/main/java/org/apache/hedwig/client/api/Client.java,42,0,0.0,0,0,0.0,0,0,0.0,0,0,0.0,0,0,0,0,NO
2,hedwig-client/src/main/java/org/apache/hedwig/client/api/MessageHandler.java,48,0,0.0,0,0,0.0,0,0,0.0,0,0,0.0,0,0,0,0,NO
2,hedwig-client/src/main/java/org/apache/hedwig/client/api/Publisher.java,63,0,0.0,0,0,0.0,0,0,0.0,0,0,0.0,0,0,0,0,YES
2,hedwig-client/src/main/java/org/apache/hedwig/client/api/Subscriber.java,318,86,28.666666,86,5,1.6666666,5,91,30.333334,91,81,27.0,81,3,0,2,YES
2,hedwig-client/src/main/java/org/apache/hedwig/client/benchmark/BenchmarkPublisher.java,136,3,3.0,3,0,0.0,0,3,3.0,3,3,3.0,3,1,0,1,YES
2,hedwig-client/src/main/java/org/apache/hedwig/client/benchmark/BenchmarkSubscriber.java,141,4,4.0,4,0,0.0,0,4,4.0,4,4,4.0,4,1,0,1,YES
2,hedwig-client/src/main/java/org/apache/hedwig/client/benchmark/BenchmarkUtils.java,190,15,15.0,15,2,2.0,2,17,17.0,17,13,13.0,13,1,0,1,YES
2,hedwig-client/src/main/java/org/apache/hedwig/client/benchmark/BenchmarkWorker.java,46,0,0.0,0,0,0.0,0,0,0.0,0,0,0.0,0,0,0,0,NO
2,hedwig-client/src/main/java/org/apache/hedwig/client/benchmark/HedwigBenchmark.java,165,59,59.0,59,22,22.0,22,81,81.0,81,37,37.0,37,1,0,1,NO
2,hedwig-client/src/main/java/org/apache/hedwig/client/conf/ClientConfiguration.java,162,13,13.0,13,0,0.0,0,13,13.0,13,13,13.0,13,1,0,1,NO
2,hedwig-client/src/main/java/org/apache/hedwig/client/data/MessageConsumeData.java,58,0,0.0,0,0,0.0,0,0,0.0,0,0,0.0,0,0,0,0,NO
2,hedwig-client/src/main/java/org/apache/hedwig/client/data/PubSubData.java,148,9,9.0,9,10,10.0,10,19,19.0,19,1,1.0,1,1,0,1,YES
2,hedwig-client/src/main/java/org/apache/hedwig/client/data/TopicSubscriber.java,74,0,0.0,0,0,0.0,0,0,0.0,0,0,0.0,0,0,0,0,NO
2,hedwig-client/src/main/java/org/apache/hedwig/client/exceptions/AlreadyStartDeliveryException.java,36,36,36.0,36,0,0.0,0,36,36.0,36,36,36.0,36,1,0,1,NO
2,hedwig-client/src/main/java/org/apache/hedwig/client/exceptions/InvalidSubscriberIdException.java,37,0,0.0,0,0,0.0,0,0,0.0,0,0,0.0,0,0,0,0,NO
2,hedwig-client/src/main/java/org/apache/hedwig/client/exceptions/ServerRedirectLoopException.java,38,0,0.0,0,0,0.0,0,0,0.0,0,0,0.0,0,0,0,0,NO
2,hedwig-client/src/main/java/org/apache/hedwig/client/exceptions/TooManyServerRedirectsException.java,39,0,0.0,0,0,0.0,0,0,0.0,0,0,0.0,0,0,0,0,NO
2,hedwig-client/src/main/java/org/apache/hedwig/client/handlers/MessageConsumeCallback.java,96,0,0.0,0,0,0.0,0,0,0.0,0,0,0.0,0,0,0,0,YES
2,hedwig-client/src/main/java/org/apache/hedwig/client/handlers/PubSubCallback.java,88,0,0.0,0,0,0.0,0,0,0.0,0,0,0.0,0,0,0,0,NO
2,hedwig-client/src/main/java/org/apache/hedwig/client/handlers/PublishResponseHandler.java,71,0,0.0,0,0,0.0,0,0,0.0,0,0,0.0,0,0,0,0,NO
2,hedwig-client/src/main/java/org/apache/hedwig/client/handlers/SubscribeReconnectCallback.java,114,14,14.0,14,14,14.0,14,28,28.0,28,0,0.0,0,1,0,1,NO
2,hedwig-client/src/main/java/org/apache/hedwig/client/handlers/SubscribeResponseHandler.java,342,42,42.0,42,36,36.0,36,78,78.0,78,6,6.0,6,1,0,1,YES
2,hedwig-client/src/main/java/org/apache/hedwig/client/handlers/UnsubscribeResponseHandler.java,84,0,0.0,0,0,0.0,0,0,0.0,0,0,0.0,0,0,0,0,NO
2,hedwig-client/src/main/java/org/apache/hedwig/client/netty/ClientChannelPipelineFactory.java,58,0,0.0,0,0,0.0,0,0,0.0,0,0,0.0,0,0,0,0,NO
2,hedwig-client/src/main/java/org/apache/hedwig/client/netty/ConnectCallback.java,129,7,7.0,7,1,1.0,1,8,8.0,8,6,6.0,6,1,1,1,NO
2,hedwig-client/src/main/java/org/apache/hedwig/client/netty/HedwigClientImpl.java,363,5,5.0,5,11,11.0,11,16,16.0,16,6,6.0,6,1,1,1,YES
2,hedwig-client/src/main/java/org/apache/hedwig/client/netty/HedwigPublisher.java,242,12,12.0,12,1,1.0,1,13,13.0,13,11,11.0,11,1,1,1,YES
2,hedwig-client/src/main/java/org/apache/hedwig/client/netty/HedwigSubscriber.java,682,120,30.0,120,24,6.0,24,144,36.0,144,96,24.0,96,4,1,1,YES
2,hedwig-client/src/main/java/org/apache/hedwig/client/netty/ResponseHandler.java,366,1,1.0,1,1,1.0,1,2,2.0,2,0,0.0,0,1,0,1,YES
2,hedwig-client/src/main/java/org/apache/hedwig/client/netty/WriteCallback.java,103,5,5.0,5,1,1.0,1,6,6.0,6,4,4.0,4,1,1,1,YES
2,hedwig-client/src/main/java/org/apache/hedwig/client/ssl/SslClientContextFactory.java,41,0,0.0,0,0,0.0,0,0,0.0,0,0,0.0,0,0,0,0,NO
2,hedwig-client/src/main/java/org/apache/hedwig/client/ssl/SslContextFactory.java,66,0,0.0,0,0,0.0,0,0,0.0,0,0,0.0,0,0,0,0,NO
2,hedwig-client/src/main/java/org/apache/hedwig/conf/AbstractConfiguration.java,63,9,9.0,9,0,0.0,0,9,9.0,9,9,9.0,9,1,0,1,NO
2,hedwig-client/src/main/java/org/apache/hedwig/util/Callback.java,47,0,0.0,0,0,0.0,0,0,0.0,0,0,0.0,0,0,0,0,NO
2,hedwig-client/src/main/java/org/apache/hedwig/util/CallbackUtils.java,183,0,0.0,0,0,0.0,0,0,0.0,0,0,0.0,0,0,0,0,NO
2,hedwig-client/src/main/java/org/apache/hedwig/util/ConcurrencyUtils.java,49,0,0.0,0,0,0.0,0,0,0.0,0,0,0.0,0,0,0,0,NO
2,hedwig-client/src/main/java/org/apache/hedwig/util/Either.java,50,0,0.0,0,0,0.0,0,0,0.0,0,0,0.0,0,0,0,0,NO
2,hedwig-client/src/main/java/org/apache/hedwig/util/FileUtils.java,98,0,0.0,0,0,0.0,0,0,0.0,0,0,0.0,0,0,0,0,NO
2,hedwig-client/src/main/java/org/apache/hedwig/util/HedwigSocketAddress.java,143,5,5.0,5,0,0.0,0,5,5.0,5,5,5.0,5,1,0,1,NO
2,hedwig-client/src/main/java/org/apache/hedwig/util/Option.java,43,0,0.0,0,0,0.0,0,0,0.0,0,0,0.0,0,0,0,0,NO
2,hedwig-client/src/main/java/org/apache/hedwig/util/Pair.java,42,0,0.0,0,0,0.0,0,0,0.0,0,0,0.0,0,0,0,0,NO
2,hedwig-client/src/main/java/org/apache/hedwig/util/PathUtils.java,56,3,3.0,3,3,3.0,3,6,6.0,6,0,0.0,0,1,0,1,NO
2,hedwig-protocol/src/main/java/org/apache/hedwig/exceptions/PubSubException.java,162,0,0.0,0,0,0.0,0,0,0.0,0,0,0.0,0,0,0,0,YES
2,hedwig-protocol/src/main/java/org/apache/hedwig/protocol/PubSubProtocol.java,6523,6504,6504.0,6504,6348,6348.0,6348,12852,12852.0,12852,156,156.0,156,1,0,1,YES
2,hedwig-protocol/src/main/java/org/apache/hedwig/protoextensions/MessageIdUtils.java,153,0,0.0,0,0,0.0,0,0,0.0,0,0,0.0,0,0,0,0,NO
2,hedwig-protocol/src/main/java/org/apache/hedwig/protoextensions/PubSubResponseUtils.java,43,1,1.0,1,1,1.0,1,2,2.0,2,0,0.0,0,1,0,1,NO
2,hedwig-protocol/src/main/java/org/apache/hedwig/protoextensions/SubscriptionStateUtils.java,41,0,0.0,0,0,0.0,0,0,0.0,0,0,0.0,0,0,0,0,NO
2,hedwig-server/src/main/java/org/apache/hedwig/admin/HedwigAdmin.java,400,407,135.66667,407,7,2.3333333,7,414,138.0,414,400,133.33333,400,3,0,2,YES
2,hedwig-server/src/main/java/org/apache/hedwig/admin/console/HedwigCommands.java,425,428,214.0,428,3,1.5,3,431,215.5,431,425,212.5,425,2,0,1,YES
2,hedwig-server/src/main/java/org/apache/hedwig/admin/console/HedwigConsole.java,1041,1057,528.5,1057,16,8.0,16,1073,536.5,1073,1041,520.5,1041,2,0,1,YES
2,hedwig-server/src/main/java/org/apache/hedwig/admin/console/JLineHedwigCompletor.java,92,92,92.0,92,0,0.0,0,92,92.0,92,92,92.0,92,1,0,1,YES
2,hedwig-server/src/main/java/org/apache/hedwig/admin/console/ReadTopic.java,355,357,178.5,357,2,1.0,2,359,179.5,359,359,179.5,359,2,0,1,YES
2,hedwig-server/src/main/java/org/apache/hedwig/server/benchmark/AbstractBenchmark.java,105,0,0.0,0,0,0.0,0,0,0.0,0,0,0.0,0,0,0,0,YES
2,hedwig-server/src/main/java/org/apache/hedwig/server/benchmark/BookieBenchmark.java,105,0,0.0,0,0,0.0,0,0,0.0,0,0,0.0,0,0,0,0,YES
2,hedwig-server/src/main/java/org/apache/hedwig/server/benchmark/BookkeeperBenchmark.java,92,0,0.0,0,0,0.0,0,0,0.0,0,0,0.0,0,0,0,0,YES
2,hedwig-server/src/main/java/org/apache/hedwig/server/benchmark/FakeBookie.java,101,0,0.0,0,0,0.0,0,0,0.0,0,0,0.0,0,0,0,0,YES
2,hedwig-server/src/main/java/org/apache/hedwig/server/common/ByteStringInterner.java,45,0,0.0,0,0,0.0,0,0,0.0,0,0,0.0,0,0,0,0,YES
2,hedwig-server/src/main/java/org/apache/hedwig/server/common/ServerConfiguration.java,299,12,6.0,12,2,1.0,2,14,7.0,14,10,5.0,10,2,0,1,YES
2,hedwig-server/src/main/java/org/apache/hedwig/server/common/TerminateJVMExceptionHandler.java,32,1,1.0,1,1,1.0,1,2,2.0,2,0,0.0,0,1,0,1,NO
2,hedwig-server/src/main/java/org/apache/hedwig/server/common/TopicOpQueuer.java,111,0,0.0,0,0,0.0,0,0,0.0,0,0,0.0,0,0,0,0,NO
2,hedwig-server/src/main/java/org/apache/hedwig/server/common/UnexpectedError.java,35,0,0.0,0,0,0.0,0,0,0.0,0,0,0.0,0,0,0,0,NO
2,hedwig-server/src/main/java/org/apache/hedwig/server/delivery/ChannelEndPoint.java,85,4,4.0,4,0,0.0,0,4,4.0,4,4,4.0,4,1,0,1,YES
2,hedwig-server/src/main/java/org/apache/hedwig/server/delivery/DeliveryCallback.java,27,0,0.0,0,0,0.0,0,0,0.0,0,0,0.0,0,0,0,0,NO
2,hedwig-server/src/main/java/org/apache/hedwig/server/delivery/DeliveryEndPoint.java,28,0,0.0,0,0,0.0,0,0,0.0,0,0,0.0,0,0,0,0,NO
2,hedwig-server/src/main/java/org/apache/hedwig/server/delivery/DeliveryManager.java,36,7,3.5,7,0,0.0,0,7,3.5,7,7,3.5,7,2,0,1,YES
2,hedwig-server/src/main/java/org/apache/hedwig/server/delivery/FIFODeliveryManager.java,574,11,5.5,11,3,1.5,3,14,7.0,14,8,4.0,8,2,0,1,YES
2,hedwig-server/src/main/java/org/apache/hedwig/server/handlers/BaseHandler.java,67,3,3.0,3,0,0.0,0,3,3.0,3,3,3.0,3,1,0,1,NO
2,hedwig-server/src/main/java/org/apache/hedwig/server/handlers/ChannelDisconnectListener.java,29,0,0.0,0,0,0.0,0,0,0.0,0,0,0.0,0,0,0,0,NO
2,hedwig-server/src/main/java/org/apache/hedwig/server/handlers/ConsumeHandler.java,72,8,8.0,8,0,0.0,0,8,8.0,8,8,8.0,8,1,0,1,NO
2,hedwig-server/src/main/java/org/apache/hedwig/server/handlers/Handler.java,37,0,0.0,0,0,0.0,0,0,0.0,0,0,0.0,0,0,0,0,NO
2,hedwig-server/src/main/java/org/apache/hedwig/server/handlers/NettyHandlerBean.java,51,52,26.0,52,1,0.5,1,53,26.5,53,51,25.5,51,2,0,1,NO
2,hedwig-server/src/main/java/org/apache/hedwig/server/handlers/NettyHandlerMXBean.java,31,31,31.0,31,0,0.0,0,31,31.0,31,31,31.0,31,1,0,1,NO
2,hedwig-server/src/main/java/org/apache/hedwig/server/handlers/PublishHandler.java,77,9,9.0,9,0,0.0,0,9,9.0,9,9,9.0,9,1,0,1,YES
2,hedwig-server/src/main/java/org/apache/hedwig/server/handlers/SubscribeHandler.java,168,14,14.0,14,0,0.0,0,14,14.0,14,14,14.0,14,1,0,1,YES
2,hedwig-server/src/main/java/org/apache/hedwig/server/handlers/UnsubscribeHandler.java,81,10,10.0,10,1,1.0,1,11,11.0,11,9,9.0,9,1,0,1,YES
2,hedwig-server/src/main/java/org/apache/hedwig/server/jmx/HedwigJMXService.java,37,37,37.0,37,0,0.0,0,37,37.0,37,37,37.0,37,1,0,1,NO
2,hedwig-server/src/main/java/org/apache/hedwig/server/jmx/HedwigMBeanInfo.java,27,27,27.0,27,0,0.0,0,27,27.0,27,27,27.0,27,1,0,1,NO
2,hedwig-server/src/main/java/org/apache/hedwig/server/jmx/HedwigMBeanRegistry.java,48,48,48.0,48,0,0.0,0,48,48.0,48,48,48.0,48,1,0,1,NO
2,hedwig-server/src/main/java/org/apache/hedwig/server/netty/PubSubServer.java,436,79,26.333334,79,28,9.333333,28,107,35.666668,107,67,22.333334,67,3,0,1,YES
2,hedwig-server/src/main/java/org/apache/hedwig/server/netty/PubSubServerBean.java,77,77,77.0,77,0,0.0,0,77,77.0,77,77,77.0,77,1,0,1,YES
2,hedwig-server/src/main/java/org/apache/hedwig/server/netty/PubSubServerMXBean.java,63,63,63.0,63,0,0.0,0,63,63.0,63,63,63.0,63,1,0,1,NO
2,hedwig-server/src/main/java/org/apache/hedwig/server/netty/PubSubServerPipelineFactory.java,76,0,0.0,0,0,0.0,0,0,0.0,0,0,0.0,0,0,0,0,NO
2,hedwig-server/src/main/java/org/apache/hedwig/server/netty/ServerStats.java,191,193,96.5,193,2,1.0,2,195,97.5,195,191,95.5,191,2,0,1,YES
2,hedwig-server/src/main/java/org/apache/hedwig/server/netty/UmbrellaHandler.java,160,1,1.0,1,0,0.0,0,1,1.0,1,1,1.0,1,1,0,1,YES
2,hedwig-server/src/main/java/org/apache/hedwig/server/persistence/BookkeeperPersistenceManager.java,906,207,69.0,207,38,12.666667,38,245,81.666664,245,169,56.333332,169,3,0,1,YES
2,hedwig-server/src/main/java/org/apache/hedwig/server/persistence/CacheKey.java,74,0,0.0,0,0,0.0,0,0,0.0,0,0,0.0,0,0,0,0,NO
2,hedwig-server/src/main/java/org/apache/hedwig/server/persistence/CacheValue.java,94,0,0.0,0,0,0.0,0,0,0.0,0,0,0.0,0,0,0,0,NO
2,hedwig-server/src/main/java/org/apache/hedwig/server/persistence/Factory.java,22,0,0.0,0,0,0.0,0,0,0.0,0,0,0.0,0,0,0,0,NO
2,hedwig-server/src/main/java/org/apache/hedwig/server/persistence/LocalDBPersistenceManager.java,481,62,31.0,62,8,4.0,8,70,35.0,70,54,27.0,54,2,0,1,YES
2,hedwig-server/src/main/java/org/apache/hedwig/server/persistence/MapMethods.java,62,0,0.0,0,0,0.0,0,0,0.0,0,0,0.0,0,0,0,0,NO
2,hedwig-server/src/main/java/org/apache/hedwig/server/persistence/PersistRequest.java,58,0,0.0,0,0,0.0,0,0,0.0,0,0,0.0,0,0,0,0,NO
2,hedwig-server/src/main/java/org/apache/hedwig/server/persistence/PersistenceManager.java,94,3,3.0,3,0,0.0,0,3,3.0,3,3,3.0,3,1,0,1,NO
2,hedwig-server/src/main/java/org/apache/hedwig/server/persistence/PersistenceManagerWithRangeScan.java,27,0,0.0,0,0,0.0,0,0,0.0,0,0,0.0,0,0,0,0,NO
2,hedwig-server/src/main/java/org/apache/hedwig/server/persistence/RangeScanRequest.java,77,0,0.0,0,0,0.0,0,0,0.0,0,0,0.0,0,0,0,0,NO
2,hedwig-server/src/main/java/org/apache/hedwig/server/persistence/ReadAheadCache.java,744,43,14.333333,43,3,1.0,3,46,15.333333,46,40,13.333333,40,3,0,1,YES
2,hedwig-server/src/main/java/org/apache/hedwig/server/persistence/ReadAheadCacheBean.java,64,64,64.0,64,0,0.0,0,64,64.0,64,64,64.0,64,1,0,1,YES
2,hedwig-server/src/main/java/org/apache/hedwig/server/persistence/ReadAheadCacheMXBean.java,45,45,45.0,45,0,0.0,0,45,45.0,45,45,45.0,45,1,0,1,NO
2,hedwig-server/src/main/java/org/apache/hedwig/server/persistence/ScanCallback.java,63,0,0.0,0,0,0.0,0,0,0.0,0,0,0.0,0,0,0,0,NO
2,hedwig-server/src/main/java/org/apache/hedwig/server/persistence/ScanCallbackWithContext.java,37,0,0.0,0,0,0.0,0,0,0.0,0,0,0.0,0,0,0,0,NO
2,hedwig-server/src/main/java/org/apache/hedwig/server/persistence/ScanRequest.java,64,0,0.0,0,0,0.0,0,0,0.0,0,0,0.0,0,0,0,0,NO
2,hedwig-server/src/main/java/org/apache/hedwig/server/proxy/ChannelTracker.java,124,0,0.0,0,0,0.0,0,0,0.0,0,0,0.0,0,0,0,0,NO
2,hedwig-server/src/main/java/org/apache/hedwig/server/proxy/HedwigProxy.java,172,21,10.5,21,9,4.5,9,30,15.0,30,12,6.0,12,2,0,1,NO
2,hedwig-server/src/main/java/org/apache/hedwig/server/proxy/ProxyConfiguration.java,36,2,2.0,2,2,2.0,2,4,4.0,4,0,0.0,0,1,0,1,NO
2,hedwig-server/src/main/java/org/apache/hedwig/server/proxy/ProxyConsumeHandler.java,58,0,0.0,0,0,0.0,0,0,0.0,0,0,0.0,0,0,0,0,NO
2,hedwig-server/src/main/java/org/apache/hedwig/server/proxy/ProxyPublishHander.java,62,0,0.0,0,0,0.0,0,0,0.0,0,0,0.0,0,0,0,0,NO
2,hedwig-server/src/main/java/org/apache/hedwig/server/proxy/ProxyStartDeliveryHandler.java,132,4,4.0,4,2,2.0,2,6,6.0,6,2,2.0,2,1,0,1,NO
2,hedwig-server/src/main/java/org/apache/hedwig/server/proxy/ProxyStopDeliveryHandler.java,74,1,1.0,1,1,1.0,1,2,2.0,2,0,0.0,0,1,0,1,NO
2,hedwig-server/src/main/java/org/apache/hedwig/server/proxy/ProxySubscribeHandler.java,83,0,0.0,0,0,0.0,0,0,0.0,0,0,0.0,0,0,0,0,YES
2,hedwig-server/src/main/java/org/apache/hedwig/server/proxy/ProxyUnsubscribeHandler.java,74,0,0.0,0,0,0.0,0,0,0.0,0,0,0.0,0,0,0,0,NO
2,hedwig-server/src/main/java/org/apache/hedwig/server/regions/HedwigHubClient.java,48,0,0.0,0,0,0.0,0,0,0.0,0,0,0.0,0,0,0,0,NO
2,hedwig-server/src/main/java/org/apache/hedwig/server/regions/HedwigHubClientFactory.java,60,0,0.0,0,0,0.0,0,0,0.0,0,0,0.0,0,0,0,0,YES
2,hedwig-server/src/main/java/org/apache/hedwig/server/regions/HedwigHubSubscriber.java,86,18,18.0,18,2,2.0,2,20,20.0,20,16,16.0,16,1,0,1,NO
2,hedwig-server/src/main/java/org/apache/hedwig/server/regions/RegionManager.java,355,253,84.333336,253,81,27.0,81,334,111.333336,334,186,62.0,186,3,0,1,NO
2,hedwig-server/src/main/java/org/apache/hedwig/server/ssl/SslServerContextFactory.java,53,0,0.0,0,0,0.0,0,0,0.0,0,0,0.0,0,0,0,0,NO
2,hedwig-server/src/main/java/org/apache/hedwig/server/subscriptions/AbstractSubscriptionManager.java,612,185,46.25,185,25,6.25,25,210,52.5,210,160,40.0,160,4,0,1,YES
2,hedwig-server/src/main/java/org/apache/hedwig/server/subscriptions/AllToAllTopologyFilter.java,39,0,0.0,0,0,0.0,0,0,0.0,0,0,0.0,0,0,0,0,NO
2,hedwig-server/src/main/java/org/apache/hedwig/server/subscriptions/InMemorySubscriptionManager.java,78,0,0.0,0,0,0.0,0,0,0.0,0,0,0.0,0,0,0,0,YES
2,hedwig-server/src/main/java/org/apache/hedwig/server/subscriptions/InMemorySubscriptionState.java,85,24,24.0,24,3,3.0,3,27,27.0,27,21,21.0,21,1,0,1,YES
2,hedwig-server/src/main/java/org/apache/hedwig/server/subscriptions/MessageFilter.java,31,0,0.0,0,0,0.0,0,0,0.0,0,0,0.0,0,0,0,0,NO
2,hedwig-server/src/main/java/org/apache/hedwig/server/subscriptions/SubscriptionEventListener.java,57,0,0.0,0,0,0.0,0,0,0.0,0,0,0.0,0,0,0,0,NO
2,hedwig-server/src/main/java/org/apache/hedwig/server/subscriptions/SubscriptionManager.java,108,4,4.0,4,0,0.0,0,4,4.0,4,4,4.0,4,1,0,1,NO
2,hedwig-server/src/main/java/org/apache/hedwig/server/subscriptions/TrueFilter.java,32,1,1.0,1,1,1.0,1,2,2.0,2,0,0.0,0,1,0,1,NO
2,hedwig-server/src/main/java/org/apache/hedwig/server/subscriptions/ZkSubscriptionManager.java,227,0,0.0,0,0,0.0,0,0,0.0,0,0,0.0,0,0,0,0,NO
2,hedwig-server/src/main/java/org/apache/hedwig/server/topics/AbstractTopicManager.java,201,4,4.0,4,0,0.0,0,4,4.0,4,4,4.0,4,1,0,1,NO
2,hedwig-server/src/main/java/org/apache/hedwig/server/topics/TopicManager.java,80,5,5.0,5,0,0.0,0,5,5.0,5,5,5.0,5,1,0,1,NO
2,hedwig-server/src/main/java/org/apache/hedwig/server/topics/TopicOwnershipChangeListener.java,28,0,0.0,0,0,0.0,0,0,0.0,0,0,0.0,0,0,0,0,NO
2,hedwig-server/src/main/java/org/apache/hedwig/server/topics/TrivialOwnAllTopicManager.java,57,5,5.0,5,0,0.0,0,5,5.0,5,5,5.0,5,1,0,1,NO
2,hedwig-server/src/main/java/org/apache/hedwig/server/topics/ZkTopicManager.java,446,18,9.0,18,1,0.5,1,19,9.5,19,17,8.5,17,2,0,1,YES
2,hedwig-server/src/main/java/org/apache/hedwig/zookeeper/SafeAsynBKCallback.java,103,0,0.0,0,0,0.0,0,0,0.0,0,0,0.0,0,0,0,0,NO
2,hedwig-server/src/main/java/org/apache/hedwig/zookeeper/SafeAsyncCallback.java,35,1,1.0,1,1,1.0,1,2,2.0,2,0,0.0,0,1,0,1,NO
2,hedwig-server/src/main/java/org/apache/hedwig/zookeeper/SafeAsyncZKCallback.java,98,0,0.0,0,0,0.0,0,0,0.0,0,0,0.0,0,0,0,0,NO
2,hedwig-server/src/main/java/org/apache/hedwig/zookeeper/ZkUtils.java,79,0,0.0,0,0,0.0,0,0,0.0,0,0,0.0,0,0,0,0,YES
3,bookkeeper-benchmark/src/main/java/org/apache/bookkeeper/benchmark/BenchBookie.java,215,0,0.0,0,0,0.0,0,0,0.0,0,0,0.0,0,0,0,0,NO
3,bookkeeper-benchmark/src/main/java/org/apache/bookkeeper/benchmark/BenchReadThroughputLatency.java,271,0,0.0,0,0,0.0,0,0,0.0,0,0,0.0,0,0,0,0,YES
3,bookkeeper-benchmark/src/main/java/org/apache/bookkeeper/benchmark/BenchThroughputLatency.java,458,14,14.0,14,7,7.0,7,21,21.0,21,7,7.0,7,1,0,1,YES
3,bookkeeper-benchmark/src/main/java/org/apache/bookkeeper/benchmark/MySqlClient.java,137,0,0.0,0,0,0.0,0,0,0.0,0,0,0.0,0,0,0,0,YES
3,bookkeeper-benchmark/src/main/java/org/apache/bookkeeper/benchmark/TestClient.java,357,15,15.0,15,26,26.0,26,41,41.0,41,11,11.0,11,1,1,1,YES
3,bookkeeper-server/src/main/java/org/apache/bookkeeper/bookie/Bookie.java,1242,635,37.35294,635,157,9.235294,157,792,46.588234,792,510,30.0,510,17,9,3,YES
3,bookkeeper-server/src/main/java/org/apache/bookkeeper/bookie/BookieBean.java,51,0,0.0,0,0,0.0,0,0,0.0,0,0,0.0,0,0,0,0,NO
3,bookkeeper-server/src/main/java/org/apache/bookkeeper/bookie/BookieException.java,154,5,5.0,5,1,1.0,1,6,6.0,6,4,4.0,4,1,0,1,YES
3,bookkeeper-server/src/main/java/org/apache/bookkeeper/bookie/BookieMXBean.java,31,0,0.0,0,0,0.0,0,0,0.0,0,0,0.0,0,0,0,0,NO
3,bookkeeper-server/src/main/java/org/apache/bookkeeper/bookie/BookieShell.java,928,945,189.0,945,17,3.4,17,962,192.4,962,938,187.6,938,5,1,3,NO
3,bookkeeper-server/src/main/java/org/apache/bookkeeper/bookie/BufferedChannel.java,180,0,0.0,0,0,0.0,0,0,0.0,0,0,0.0,0,0,0,0,NO
3,bookkeeper-server/src/main/java/org/apache/bookkeeper/bookie/Cookie.java,260,101,33.666668,101,37,12.333333,37,138,46.0,138,64,21.333334,64,3,1,2,YES
3,bookkeeper-server/src/main/java/org/apache/bookkeeper/bookie/EntryLogger.java,551,123,20.5,123,45,7.5,45,168,28.0,168,78,13.0,78,6,3,3,YES
3,bookkeeper-server/src/main/java/org/apache/bookkeeper/bookie/ExitCode.java,40,0,0.0,0,0,0.0,0,0,0.0,0,0,0.0,0,0,0,0,NO
3,bookkeeper-server/src/main/java/org/apache/bookkeeper/bookie/FileInfo.java,361,109,36.333332,109,3,1.0,3,112,37.333332,112,106,35.333332,106,3,1,1,YES
3,bookkeeper-server/src/main/java/org/apache/bookkeeper/bookie/FileSystemUpgrade.java,388,18,9.0,18,9,4.5,9,27,13.5,27,9,4.5,9,2,1,2,YES
3,bookkeeper-server/src/main/java/org/apache/bookkeeper/bookie/GarbageCollector.java,51,51,51.0,51,0,0.0,0,51,51.0,51,51,51.0,51,1,0,1,NO
3,bookkeeper-server/src/main/java/org/apache/bookkeeper/bookie/GarbageCollectorThread.java,577,122,17.428572,122,54,7.714286,54,176,25.142857,176,76,10.857142,76,7,3,3,NO
3,bookkeeper-server/src/main/java/org/apache/bookkeeper/bookie/HandleFactory.java,32,0,0.0,0,0,0.0,0,0,0.0,0,0,0.0,0,0,0,0,NO
3,bookkeeper-server/src/main/java/org/apache/bookkeeper/bookie/HandleFactoryImpl.java,66,0,0.0,0,0,0.0,0,0,0.0,0,0,0.0,0,0,0,0,NO
3,bookkeeper-server/src/main/java/org/apache/bookkeeper/bookie/InterleavedLedgerStorage.java,188,41,5.125,41,40,5.0,40,81,10.125,81,37,4.625,37,8,2,2,YES
3,bookkeeper-server/src/main/java/org/apache/bookkeeper/bookie/Journal.java,582,30,5.0,30,24,4.0,24,54,9.0,54,18,3.0,18,6,4,3,NO
3,bookkeeper-server/src/main/java/org/apache/bookkeeper/bookie/JournalChannel.java,158,2,2.0,2,2,2.0,2,4,4.0,4,0,0.0,0,1,1,1,YES
3,bookkeeper-server/src/main/java/org/apache/bookkeeper/bookie/LedgerCache.java,50,4,4.0,4,0,0.0,0,4,4.0,4,4,4.0,4,1,1,1,NO
3,bookkeeper-server/src/main/java/org/apache/bookkeeper/bookie/LedgerCacheBean.java,27,0,0.0,0,0,0.0,0,0,0.0,0,0,0.0,0,0,0,0,NO
3,bookkeeper-server/src/main/java/org/apache/bookkeeper/bookie/LedgerCacheImpl.java,928,207,23.0,207,67,7.4444447,67,274,30.444445,274,150,16.666666,150,9,4,2,YES
3,bookkeeper-server/src/main/java/org/apache/bookkeeper/bookie/LedgerCacheMXBean.java,60,0,0.0,0,0,0.0,0,0,0.0,0,0,0.0,0,0,0,0,NO
3,bookkeeper-server/src/main/java/org/apache/bookkeeper/bookie/LedgerDescriptor.java,62,2,2.0,2,2,2.0,2,4,4.0,4,0,0.0,0,1,1,1,NO
3,bookkeeper-server/src/main/java/org/apache/bookkeeper/bookie/LedgerDescriptorImpl.java,87,4,4.0,4,5,5.0,5,9,9.0,9,1,1.0,1,1,1,1,NO
3,bookkeeper-server/src/main/java/org/apache/bookkeeper/bookie/LedgerDescriptorReadOnlyImpl.java,52,1,1.0,1,1,1.0,1,2,2.0,2,0,0.0,0,1,1,1,NO
3,bookkeeper-server/src/main/java/org/apache/bookkeeper/bookie/LedgerDirsManager.java,268,270,90.0,270,2,0.6666667,2,272,90.666664,272,268,89.333336,268,3,2,2,NO
3,bookkeeper-server/src/main/java/org/apache/bookkeeper/bookie/LedgerEntryPage.java,163,0,0.0,0,0,0.0,0,0,0.0,0,0,0.0,0,0,0,0,NO
3,bookkeeper-server/src/main/java/org/apache/bookkeeper/bookie/LedgerStorage.java,109,19,19.0,19,1,1.0,1,20,20.0,20,18,18.0,18,1,1,1,NO
3,bookkeeper-server/src/main/java/org/apache/bookkeeper/bookie/MarkerFileChannel.java,147,0,0.0,0,0,0.0,0,0,0.0,0,0,0.0,0,0,0,0,NO
3,bookkeeper-server/src/main/java/org/apache/bookkeeper/bookie/ReadOnlyEntryLogger.java,58,59,29.5,59,1,0.5,1,60,30.0,60,58,29.0,58,2,0,1,NO
3,bookkeeper-server/src/main/java/org/apache/bookkeeper/bookie/ReadOnlyFileInfo.java,44,44,44.0,44,0,0.0,0,44,44.0,44,44,44.0,44,1,0,1,NO
3,bookkeeper-server/src/main/java/org/apache/bookkeeper/bookie/ScanAndCompareGarbageCollector.java,106,108,108.0,108,0,0.0,0,108,108.0,108,108,108.0,108,1,0,1,NO
3,bookkeeper-server/src/main/java/org/apache/bookkeeper/client/AsyncCallback.java,139,0,0.0,0,0,0.0,0,0,0.0,0,0,0.0,0,0,0,0,NO
3,bookkeeper-server/src/main/java/org/apache/bookkeeper/client/BKException.java,326,44,11.0,44,0,0.0,0,44,11.0,44,44,11.0,44,4,0,1,NO
3,bookkeeper-server/src/main/java/org/apache/bookkeeper/client/BookKeeper.java,648,121,12.1,121,55,5.5,55,176,17.6,176,104,10.4,104,10,5,3,NO
3,bookkeeper-server/src/main/java/org/apache/bookkeeper/client/BookKeeperAdmin.java,778,319,24.538462,319,341,26.23077,341,660,50.76923,660,330,25.384615,330,13,2,3,YES
3,bookkeeper-server/src/main/java/org/apache/bookkeeper/client/BookieWatcher.java,314,122,40.666668,122,24,8.0,24,146,48.666668,146,102,34.0,102,3,1,2,YES
3,bookkeeper-server/src/main/java/org/apache/bookkeeper/client/CRC32DigestManager.java,55,0,0.0,0,0,0.0,0,0,0.0,0,0,0.0,0,0,0,0,NO
3,bookkeeper-server/src/main/java/org/apache/bookkeeper/client/DigestManager.java,191,7,7.0,7,0,0.0,0,7,7.0,7,7,7.0,7,1,0,1,NO
3,bookkeeper-server/src/main/java/org/apache/bookkeeper/client/DistributionSchedule.java,90,38,19.0,38,13,6.5,13,51,25.5,51,25,12.5,25,2,0,1,NO
3,bookkeeper-server/src/main/java/org/apache/bookkeeper/client/LedgerChecker.java,273,285,71.25,285,12,3.0,12,297,74.25,297,281,70.25,281,4,0,1,NO
3,bookkeeper-server/src/main/java/org/apache/bookkeeper/client/LedgerCreateOp.java,137,16,4.0,16,29,7.25,29,45,11.25,45,19,4.75,19,4,1,2,NO
3,bookkeeper-server/src/main/java/org/apache/bookkeeper/client/LedgerDeleteOp.java,79,13,4.3333335,13,15,5.0,15,28,9.333333,28,6,2.0,6,3,1,2,NO
3,bookkeeper-server/src/main/java/org/apache/bookkeeper/client/LedgerEntry.java,82,0,0.0,0,2,2.0,2,2,2.0,2,2,2.0,2,1,0,1,NO
3,bookkeeper-server/src/main/java/org/apache/bookkeeper/client/LedgerFragment.java,147,168,33.6,168,21,4.2,21,189,37.8,189,147,29.4,147,5,1,2,NO
3,bookkeeper-server/src/main/java/org/apache/bookkeeper/client/LedgerFragmentReplicator.java,422,517,129.25,517,95,23.75,95,612,153.0,612,422,105.5,422,4,1,1,NO
3,bookkeeper-server/src/main/java/org/apache/bookkeeper/client/LedgerHandle.java,978,338,28.166666,338,265,22.083334,265,603,50.25,603,185,15.416667,185,12,9,3,YES
3,bookkeeper-server/src/main/java/org/apache/bookkeeper/client/LedgerMetadata.java,467,273,30.333334,273,118,13.111111,118,391,43.444443,391,181,20.11111,181,9,5,3,YES
3,bookkeeper-server/src/main/java/org/apache/bookkeeper/client/LedgerOpenOp.java,189,56,18.666666,56,38,12.666667,38,94,31.333334,94,60,20.0,60,3,1,2,NO
3,bookkeeper-server/src/main/java/org/apache/bookkeeper/client/LedgerRecoveryOp.java,153,2,1.0,2,2,1.0,2,4,2.0,4,0,0.0,0,2,1,2,NO
3,bookkeeper-server/src/main/java/org/apache/bookkeeper/client/MacDigestManager.java,84,0,0.0,0,0,0.0,0,0,0.0,0,0,0.0,0,0,0,0,YES
3,bookkeeper-server/src/main/java/org/apache/bookkeeper/client/PendingAddOp.java,182,60,12.0,60,47,9.4,47,107,21.4,107,55,11.0,55,5,4,3,NO
3,bookkeeper-server/src/main/java/org/apache/bookkeeper/client/PendingReadOp.java,358,438,36.5,438,269,22.416666,269,707,58.916668,707,425,35.416668,425,12,9,3,NO
3,bookkeeper-server/src/main/java/org/apache/bookkeeper/client/ReadLastConfirmedOp.java,126,9,3.0,9,10,3.3333333,10,19,6.3333335,19,1,0.33333334,1,3,2,2,NO
3,bookkeeper-server/src/main/java/org/apache/bookkeeper/client/ReadOnlyLedgerHandle.java,106,31,15.5,31,4,2.0,4,35,17.5,35,27,13.5,27,2,2,1,NO
3,bookkeeper-server/src/main/java/org/apache/bookkeeper/client/RoundRobinDistributionSchedule.java,109,36,18.0,36,17,8.5,17,53,26.5,53,19,9.5,19,2,0,1,NO
3,bookkeeper-server/src/main/java/org/apache/bookkeeper/client/SyncCounter.java,85,0,0.0,0,0,0.0,0,0,0.0,0,0,0.0,0,0,0,0,NO
3,bookkeeper-server/src/main/java/org/apache/bookkeeper/conf/AbstractConfiguration.java,236,127,25.4,127,4,0.8,4,131,26.2,131,129,25.8,129,5,1,2,NO
3,bookkeeper-server/src/main/java/org/apache/bookkeeper/conf/ClientConfiguration.java,314,74,18.5,74,36,9.0,36,110,27.5,110,110,27.5,110,4,3,1,YES
3,bookkeeper-server/src/main/java/org/apache/bookkeeper/conf/ServerConfiguration.java,694,153,25.5,153,8,1.3333334,8,161,26.833334,161,145,24.166666,145,6,1,3,YES
3,bookkeeper-server/src/main/java/org/apache/bookkeeper/jmx/BKMBeanInfo.java,27,0,0.0,0,0,0.0,0,0,0.0,0,0,0.0,0,0,0,0,NO
3,bookkeeper-server/src/main/java/org/apache/bookkeeper/jmx/BKMBeanRegistry.java,89,3,3.0,3,2,2.0,2,5,5.0,5,1,1.0,1,1,1,1,NO
3,bookkeeper-server/src/main/java/org/apache/bookkeeper/meta/AbstractZkLedgerManager.java,301,203,29.0,203,185,26.428572,185,388,55.42857,388,234,33.42857,234,7,1,3,YES
3,bookkeeper-server/src/main/java/org/apache/bookkeeper/meta/FlatLedgerManager.java,153,49,9.8,49,71,14.2,71,120,24.0,120,34,6.8,34,5,1,3,NO
3,bookkeeper-server/src/main/java/org/apache/bookkeeper/meta/FlatLedgerManagerFactory.java,92,97,24.25,97,5,1.25,5,102,25.5,102,102,25.5,102,4,0,2,NO
3,bookkeeper-server/src/main/java/org/apache/bookkeeper/meta/HierarchicalLedgerManager.java,466,128,25.6,128,169,33.8,169,297,59.4,297,53,10.6,53,5,1,3,YES
3,bookkeeper-server/src/main/java/org/apache/bookkeeper/meta/HierarchicalLedgerManagerFactory.java,93,98,24.5,98,5,1.25,5,103,25.75,103,103,25.75,103,4,0,2,NO
3,bookkeeper-server/src/main/java/org/apache/bookkeeper/meta/LedgerLayout.java,244,78,15.6,78,43,8.6,43,121,24.2,121,57,11.4,57,5,0,3,NO
3,bookkeeper-server/src/main/java/org/apache/bookkeeper/meta/LedgerManager.java,192,135,67.5,135,90,45.0,90,225,112.5,225,135,67.5,135,2,0,2,NO
3,bookkeeper-server/src/main/java/org/apache/bookkeeper/meta/LedgerManagerFactory.java,250,236,59.0,236,84,21.0,84,320,80.0,320,168,42.0,168,4,0,2,YES
3,bookkeeper-server/src/main/java/org/apache/bookkeeper/meta/LedgerUnderreplicationManager.java,109,109,36.333332,109,0,0.0,0,109,36.333332,109,109,36.333332,109,3,0,1,NO
3,bookkeeper-server/src/main/java/org/apache/bookkeeper/meta/MSLedgerManagerFactory.java,601,752,376.0,752,151,75.5,151,903,451.5,903,781,390.5,781,2,0,2,NO
3,bookkeeper-server/src/main/java/org/apache/bookkeeper/meta/ZkLedgerUnderreplicationManager.java,565,627,48.23077,627,62,4.769231,62,689,53.0,689,567,43.615383,567,13,0,3,YES
3,bookkeeper-server/src/main/java/org/apache/bookkeeper/meta/ZkVersion.java,69,72,36.0,72,3,1.5,3,75,37.5,75,69,34.5,69,2,1,1,NO
3,bookkeeper-server/src/main/java/org/apache/bookkeeper/metastore/InMemoryMetaStore.java,77,77,77.0,77,0,0.0,0,77,77.0,77,77,77.0,77,1,0,1,NO
3,bookkeeper-server/src/main/java/org/apache/bookkeeper/metastore/InMemoryMetastoreCursor.java,94,94,94.0,94,0,0.0,0,94,94.0,94,94,94.0,94,1,0,1,NO
3,bookkeeper-server/src/main/java/org/apache/bookkeeper/metastore/InMemoryMetastoreTable.java,337,337,337.0,337,0,0.0,0,337,337.0,337,337,337.0,337,1,0,1,NO
3,bookkeeper-server/src/main/java/org/apache/bookkeeper/metastore/MSException.java,214,214,214.0,214,0,0.0,0,214,214.0,214,214,214.0,214,1,0,1,NO
3,bookkeeper-server/src/main/java/org/apache/bookkeeper/metastore/MetaStore.java,79,79,79.0,79,0,0.0,0,79,79.0,79,79,79.0,79,1,0,1,NO
3,bookkeeper-server/src/main/java/org/apache/bookkeeper/metastore/MetastoreCallback.java,25,25,25.0,25,0,0.0,0,25,25.0,25,25,25.0,25,1,0,1,NO
3,bookkeeper-server/src/main/java/org/apache/bookkeeper/metastore/MetastoreCursor.java,84,84,84.0,84,0,0.0,0,84,84.0,84,84,84.0,84,1,0,1,NO
3,bookkeeper-server/src/main/java/org/apache/bookkeeper/metastore/MetastoreException.java,34,34,34.0,34,0,0.0,0,34,34.0,34,34,34.0,34,1,0,1,NO
3,bookkeeper-server/src/main/java/org/apache/bookkeeper/metastore/MetastoreFactory.java,33,33,33.0,33,0,0.0,0,33,33.0,33,33,33.0,33,1,0,1,NO
3,bookkeeper-server/src/main/java/org/apache/bookkeeper/metastore/MetastoreScannableTable.java,104,104,104.0,104,0,0.0,0,104,104.0,104,104,104.0,104,1,0,1,NO
3,bookkeeper-server/src/main/java/org/apache/bookkeeper/metastore/MetastoreTable.java,172,172,172.0,172,0,0.0,0,172,172.0,172,172,172.0,172,1,0,1,NO
3,bookkeeper-server/src/main/java/org/apache/bookkeeper/metastore/MetastoreTableItem.java,70,70,70.0,70,0,0.0,0,70,70.0,70,70,70.0,70,1,0,1,NO
3,bookkeeper-server/src/main/java/org/apache/bookkeeper/metastore/MetastoreUtils.java,140,140,140.0,140,0,0.0,0,140,140.0,140,140,140.0,140,1,0,1,NO
3,bookkeeper-server/src/main/java/org/apache/bookkeeper/metastore/Value.java,154,154,154.0,154,0,0.0,0,154,154.0,154,154,154.0,154,1,0,1,YES
3,bookkeeper-server/src/main/java/org/apache/bookkeeper/proto/BKStats.java,248,13,13.0,13,1,1.0,1,14,14.0,14,12,12.0,12,1,1,1,NO
3,bookkeeper-server/src/main/java/org/apache/bookkeeper/proto/BookieClient.java,275,62,31.0,62,14,7.0,14,76,38.0,76,48,24.0,48,2,2,1,YES
3,bookkeeper-server/src/main/java/org/apache/bookkeeper/proto/BookieProtocol.java,176,4,4.0,4,0,0.0,0,4,4.0,4,4,4.0,4,1,0,1,NO
3,bookkeeper-server/src/main/java/org/apache/bookkeeper/proto/BookieServer.java,624,141,14.1,141,24,2.4,24,165,16.5,165,121,12.1,121,10,4,3,YES
3,bookkeeper-server/src/main/java/org/apache/bookkeeper/proto/BookieServerBean.java,91,3,3.0,3,2,2.0,2,5,5.0,5,1,1.0,1,1,1,1,YES
3,bookkeeper-server/src/main/java/org/apache/bookkeeper/proto/BookieServerMXBean.java,58,0,0.0,0,0,0.0,0,0,0.0,0,0,0.0,0,0,0,0,YES
3,bookkeeper-server/src/main/java/org/apache/bookkeeper/proto/BookkeeperInternalCallbacks.java,132,1,1.0,1,1,1.0,1,2,2.0,2,0,0.0,0,1,0,1,NO
3,bookkeeper-server/src/main/java/org/apache/bookkeeper/proto/DataFormats.java,4088,4114,587.7143,4114,26,3.7142856,26,4140,591.4286,4140,4088,584.0,4088,7,1,2,NO
3,bookkeeper-server/src/main/java/org/apache/bookkeeper/proto/NIOServerFactory.java,558,33,16.5,33,4,2.0,4,37,18.5,37,33,16.5,33,2,1,2,NO
3,bookkeeper-server/src/main/java/org/apache/bookkeeper/proto/PerChannelBookieClient.java,727,89,12.714286,89,56,8.0,56,145,20.714285,145,49,7.0,49,7,5,3,YES
3,bookkeeper-server/src/main/java/org/apache/bookkeeper/proto/ServerStats.java,150,4,4.0,4,2,2.0,2,6,6.0,6,2,2.0,2,1,1,1,YES
3,bookkeeper-server/src/main/java/org/apache/bookkeeper/replication/Auditor.java,503,577,144.25,577,74,18.5,74,651,162.75,651,503,125.75,503,4,0,1,YES
3,bookkeeper-server/src/main/java/org/apache/bookkeeper/replication/AuditorElector.java,325,415,69.166664,415,90,15.0,90,505,84.166664,505,325,54.166668,325,6,0,2,YES
3,bookkeeper-server/src/main/java/org/apache/bookkeeper/replication/AutoRecoveryMain.java,273,293,48.833332,293,20,3.3333333,20,313,52.166668,313,287,47.833332,287,6,2,2,NO
3,bookkeeper-server/src/main/java/org/apache/bookkeeper/replication/BookieLedgerIndexer.java,136,142,47.333332,142,6,2.0,6,148,49.333332,148,142,47.333332,142,3,1,2,NO
3,bookkeeper-server/src/main/java/org/apache/bookkeeper/replication/ReplicationEnableCb.java,56,56,56.0,56,0,0.0,0,56,56.0,56,56,56.0,56,1,0,1,NO
3,bookkeeper-server/src/main/java/org/apache/bookkeeper/replication/ReplicationException.java,74,81,27.0,81,7,2.3333333,7,88,29.333334,88,74,24.666666,74,3,0,2,NO
3,bookkeeper-server/src/main/java/org/apache/bookkeeper/replication/ReplicationWorker.java,357,466,58.25,466,109,13.625,109,575,71.875,575,359,44.875,359,8,0,1,NO
3,bookkeeper-server/src/main/java/org/apache/bookkeeper/streaming/LedgerInputStream.java,174,0,0.0,0,0,0.0,0,0,0.0,0,0,0.0,0,0,0,0,NO
3,bookkeeper-server/src/main/java/org/apache/bookkeeper/streaming/LedgerOutputStream.java,148,0,0.0,0,0,0.0,0,0,0.0,0,0,0.0,0,0,0,0,NO
3,bookkeeper-server/src/main/java/org/apache/bookkeeper/tools/BookKeeperTools.java,92,0,0.0,0,0,0.0,0,0,0.0,0,0,0.0,0,0,0,0,NO
3,bookkeeper-server/src/main/java/org/apache/bookkeeper/util/BookKeeperConstants.java,45,46,23.0,46,1,0.5,1,47,23.5,47,45,22.5,45,2,0,1,NO
3,bookkeeper-server/src/main/java/org/apache/bookkeeper/util/DiskChecker.java,168,171,85.5,171,3,1.5,3,174,87.0,174,168,84.0,168,2,1,2,NO
3,bookkeeper-server/src/main/java/org/apache/bookkeeper/util/EntryFormatter.java,77,77,77.0,77,0,0.0,0,77,77.0,77,77,77.0,77,1,0,1,NO
3,bookkeeper-server/src/main/java/org/apache/bookkeeper/util/HardLink.java,664,0,0.0,0,0,0.0,0,0,0.0,0,0,0.0,0,0,0,0,YES
3,bookkeeper-server/src/main/java/org/apache/bookkeeper/util/IOUtils.java,88,33,33.0,33,0,0.0,0,33,33.0,33,33,33.0,33,1,0,1,NO
3,bookkeeper-server/src/main/java/org/apache/bookkeeper/util/LocalBookKeeper.java,260,13,4.3333335,13,9,3.0,9,22,7.3333335,22,6,2.0,6,3,1,3,YES
3,bookkeeper-server/src/main/java/org/apache/bookkeeper/util/Main.java,54,0,0.0,0,0,0.0,0,0,0.0,0,0,0.0,0,0,0,0,NO
3,bookkeeper-server/src/main/java/org/apache/bookkeeper/util/MathUtils.java,48,15,15.0,15,5,5.0,5,20,20.0,20,10,10.0,10,1,1,1,NO
3,bookkeeper-server/src/main/java/org/apache/bookkeeper/util/OrderedSafeExecutor.java,140,42,21.0,42,0,0.0,0,42,21.0,42,42,21.0,42,2,2,2,NO
3,bookkeeper-server/src/main/java/org/apache/bookkeeper/util/ReflectionUtils.java,152,152,76.0,152,0,0.0,0,152,76.0,152,152,76.0,152,2,0,1,NO
3,bookkeeper-server/src/main/java/org/apache/bookkeeper/util/SafeRunnable.java,39,0,0.0,0,0,0.0,0,0,0.0,0,0,0.0,0,0,0,0,NO
3,bookkeeper-server/src/main/java/org/apache/bookkeeper/util/SnapshotMap.java,131,131,131.0,131,0,0.0,0,131,131.0,131,131,131.0,131,1,0,1,NO
3,bookkeeper-server/src/main/java/org/apache/bookkeeper/util/StringEntryFormatter.java,47,47,47.0,47,0,0.0,0,47,47.0,47,47,47.0,47,1,0,1,NO
3,bookkeeper-server/src/main/java/org/apache/bookkeeper/util/StringUtils.java,129,64,32.0,64,4,2.0,4,68,34.0,68,60,30.0,60,2,1,2,NO
3,bookkeeper-server/src/main/java/org/apache/bookkeeper/util/Tool.java,43,43,43.0,43,0,0.0,0,43,43.0,43,43,43.0,43,1,0,1,NO
3,bookkeeper-server/src/main/java/org/apache/bookkeeper/util/ZkUtils.java,243,182,45.5,182,33,8.25,33,215,53.75,215,193,48.25,193,4,1,2,NO
3,bookkeeper-server/src/main/java/org/apache/bookkeeper/versioning/Version.java,62,63,31.5,63,1,0.5,1,64,32.0,64,62,31.0,62,2,1,1,NO
3,bookkeeper-server/src/main/java/org/apache/bookkeeper/versioning/Versioned.java,45,45,45.0,45,0,0.0,0,45,45.0,45,45,45.0,45,1,0,1,NO
3,bookkeeper-server/src/main/java/org/apache/bookkeeper/zookeeper/ZooKeeperWatcherBase.java,94,94,94.0,94,0,0.0,0,94,94.0,94,94,94.0,94,1,1,1,YES
3,hedwig-client/src/main/java/org/apache/hedwig/client/HedwigClient.java,72,0,0.0,0,0,0.0,0,0,0.0,0,0,0.0,0,0,0,0,NO
3,hedwig-client/src/main/java/org/apache/hedwig/client/api/Client.java,42,0,0.0,0,0,0.0,0,0,0.0,0,0,0.0,0,0,0,0,NO
3,hedwig-client/src/main/java/org/apache/hedwig/client/api/MessageHandler.java,48,0,0.0,0,0,0.0,0,0,0.0,0,0,0.0,0,0,0,0,NO
3,hedwig-client/src/main/java/org/apache/hedwig/client/api/Publisher.java,89,28,14.0,28,2,1.0,2,30,15.0,30,26,13.0,26,2,1,1,NO
3,hedwig-client/src/main/java/org/apache/hedwig/client/api/Subscriber.java,380,63,21.0,63,1,0.33333334,1,64,21.333334,64,62,20.666666,62,3,1,2,NO
3,hedwig-client/src/main/java/org/apache/hedwig/client/benchmark/BenchmarkPublisher.java,138,4,4.0,4,2,2.0,2,6,6.0,6,2,2.0,2,1,1,1,YES
3,hedwig-client/src/main/java/org/apache/hedwig/client/benchmark/BenchmarkSubscriber.java,142,5,2.5,5,4,2.0,4,9,4.5,9,3,1.5,3,2,1,1,YES
3,hedwig-client/src/main/java/org/apache/hedwig/client/benchmark/BenchmarkUtils.java,191,5,5.0,5,4,4.0,4,9,9.0,9,1,1.0,1,1,1,1,NO
3,hedwig-client/src/main/java/org/apache/hedwig/client/benchmark/BenchmarkWorker.java,46,0,0.0,0,0,0.0,0,0,0.0,0,0,0.0,0,0,0,0,NO
3,hedwig-client/src/main/java/org/apache/hedwig/client/benchmark/HedwigBenchmark.java,165,0,0.0,0,0,0.0,0,0,0.0,0,0,0.0,0,0,0,0,NO
3,hedwig-client/src/main/java/org/apache/hedwig/client/conf/ClientConfiguration.java,171,12,6.0,12,3,1.5,3,15,7.5,15,9,4.5,9,2,0,1,NO
3,hedwig-client/src/main/java/org/apache/hedwig/client/data/MessageConsumeData.java,56,10,10.0,10,12,12.0,12,22,22.0,22,2,2.0,2,1,0,1,NO
3,hedwig-client/src/main/java/org/apache/hedwig/client/data/PubSubData.java,179,35,11.666667,35,4,1.3333334,4,39,13.0,39,31,10.333333,31,3,1,2,NO
3,hedwig-client/src/main/java/org/apache/hedwig/client/data/TopicSubscriber.java,74,0,0.0,0,0,0.0,0,0,0.0,0,0,0.0,0,0,0,0,NO
3,hedwig-client/src/main/java/org/apache/hedwig/client/exceptions/AlreadyStartDeliveryException.java,36,0,0.0,0,0,0.0,0,0,0.0,0,0,0.0,0,0,0,0,NO
3,hedwig-client/src/main/java/org/apache/hedwig/client/exceptions/InvalidSubscriberIdException.java,37,0,0.0,0,0,0.0,0,0,0.0,0,0,0.0,0,0,0,0,NO
3,hedwig-client/src/main/java/org/apache/hedwig/client/exceptions/NoResponseHandlerException.java,34,34,34.0,34,0,0.0,0,34,34.0,34,34,34.0,34,1,1,1,NO
3,hedwig-client/src/main/java/org/apache/hedwig/client/exceptions/ResubscribeException.java,34,34,34.0,34,0,0.0,0,34,34.0,34,34,34.0,34,1,0,1,NO
3,hedwig-client/src/main/java/org/apache/hedwig/client/exceptions/ServerRedirectLoopException.java,38,0,0.0,0,0,0.0,0,0,0.0,0,0,0.0,0,0,0,0,NO
3,hedwig-client/src/main/java/org/apache/hedwig/client/exceptions/TooManyServerRedirectsException.java,39,0,0.0,0,0,0.0,0,0,0.0,0,0,0.0,0,0,0,0,NO
3,hedwig-client/src/main/java/org/apache/hedwig/client/handlers/AbstractResponseHandler.java,156,156,156.0,156,0,0.0,0,156,156.0,156,156,156.0,156,1,0,1,NO
3,hedwig-client/src/main/java/org/apache/hedwig/client/handlers/CloseSubscriptionResponseHandler.java,84,84,84.0,84,0,0.0,0,84,84.0,84,84,84.0,84,1,0,1,NO
3,hedwig-client/src/main/java/org/apache/hedwig/client/handlers/MessageConsumeCallback.java,117,75,25.0,75,54,18.0,54,129,43.0,129,33,11.0,33,3,1,2,NO
3,hedwig-client/src/main/java/org/apache/hedwig/client/handlers/PubSubCallback.java,94,13,6.5,13,7,3.5,7,20,10.0,20,10,5.0,10,2,0,1,NO
3,hedwig-client/src/main/java/org/apache/hedwig/client/handlers/PublishResponseHandler.java,71,18,9.0,18,18,9.0,18,36,18.0,36,6,3.0,6,2,0,2,NO
3,hedwig-client/src/main/java/org/apache/hedwig/client/handlers/SubscribeResponseHandler.java,183,163,23.285715,163,322,46.0,322,485,69.28571,485,253,36.142857,253,7,2,2,NO
3,hedwig-client/src/main/java/org/apache/hedwig/client/handlers/UnsubscribeResponseHandler.java,85,26,13.0,26,25,12.5,25,51,25.5,51,3,1.5,3,2,0,2,NO
3,hedwig-client/src/main/java/org/apache/hedwig/client/netty/CleanupChannelMap.java,183,183,91.5,183,0,0.0,0,183,91.5,183,183,91.5,183,2,0,1,NO
3,hedwig-client/src/main/java/org/apache/hedwig/client/netty/FilterableMessageHandler.java,70,71,35.5,71,1,0.5,1,72,36.0,72,70,35.0,70,2,0,1,NO
3,hedwig-client/src/main/java/org/apache/hedwig/client/netty/HChannel.java,54,54,54.0,54,0,0.0,0,54,54.0,54,54,54.0,54,1,0,1,NO
3,hedwig-client/src/main/java/org/apache/hedwig/client/netty/HChannelManager.java,160,160,160.0,160,0,0.0,0,160,160.0,160,160,160.0,160,1,0,1,NO
3,hedwig-client/src/main/java/org/apache/hedwig/client/netty/HedwigClientImpl.java,125,105,11.666667,105,343,38.11111,343,448,49.77778,448,360,40.0,360,9,3,2,NO
3,hedwig-client/src/main/java/org/apache/hedwig/client/netty/HedwigPublisher.java,151,119,19.833334,119,210,35.0,210,329,54.833332,329,211,35.166668,211,6,3,2,NO
3,hedwig-client/src/main/java/org/apache/hedwig/client/netty/HedwigSubscriber.java,421,273,30.333334,273,534,59.333332,534,807,89.666664,807,571,63.444443,571,9,3,2,YES
3,hedwig-client/src/main/java/org/apache/hedwig/client/netty/NetUtils.java,219,222,55.5,222,3,0.75,3,225,56.25,225,219,54.75,219,4,1,2,YES
3,hedwig-client/src/main/java/org/apache/hedwig/client/netty/SubscriptionEventEmitter.java,50,50,50.0,50,0,0.0,0,50,50.0,50,50,50.0,50,1,0,1,NO
3,hedwig-client/src/main/java/org/apache/hedwig/client/netty/VoidCallbackAdapter.java,42,42,21.0,42,0,0.0,0,42,21.0,42,42,21.0,42,2,1,2,NO
3,hedwig-client/src/main/java/org/apache/hedwig/client/netty/impl/AbstractHChannelManager.java,624,624,312.0,624,0,0.0,0,624,312.0,624,624,312.0,624,2,0,1,NO
3,hedwig-client/src/main/java/org/apache/hedwig/client/netty/impl/AbstractSubscribeResponseHandler.java,377,402,134.0,402,25,8.333333,25,427,142.33333,427,377,125.666664,377,3,1,1,NO
3,hedwig-client/src/main/java/org/apache/hedwig/client/netty/impl/ActiveSubscriber.java,383,384,192.0,384,1,0.5,1,385,192.5,385,383,191.5,383,2,0,1,NO
3,hedwig-client/src/main/java/org/apache/hedwig/client/netty/impl/ClientChannelPipelineFactory.java,72,72,72.0,72,0,0.0,0,72,72.0,72,72,72.0,72,1,0,1,NO
3,hedwig-client/src/main/java/org/apache/hedwig/client/netty/impl/DefaultServerChannel.java,92,92,92.0,92,0,0.0,0,92,92.0,92,92,92.0,92,1,0,1,NO
3,hedwig-client/src/main/java/org/apache/hedwig/client/netty/impl/HChannelHandler.java,284,284,142.0,284,0,0.0,0,284,142.0,284,284,142.0,284,2,0,1,YES
3,hedwig-client/src/main/java/org/apache/hedwig/client/netty/impl/HChannelImpl.java,371,371,371.0,371,0,0.0,0,371,371.0,371,371,371.0,371,1,0,1,NO
3,hedwig-client/src/main/java/org/apache/hedwig/client/netty/impl/NonSubscriptionChannelPipelineFactory.java,47,47,47.0,47,0,0.0,0,47,47.0,47,47,47.0,47,1,0,1,NO
3,hedwig-client/src/main/java/org/apache/hedwig/client/netty/impl/ResubscribeCallback.java,108,108,54.0,108,0,0.0,0,108,54.0,108,108,54.0,108,2,0,1,NO
3,hedwig-client/src/main/java/org/apache/hedwig/client/netty/impl/WriteCallback.java,111,111,111.0,111,0,0.0,0,111,111.0,111,111,111.0,111,1,0,1,NO
3,hedwig-client/src/main/java/org/apache/hedwig/client/netty/impl/multiplex/MultiplexHChannelManager.java,319,319,106.333336,319,0,0.0,0,319,106.333336,319,319,106.333336,319,3,0,1,NO
3,hedwig-client/src/main/java/org/apache/hedwig/client/netty/impl/multiplex/MultiplexSubscribeResponseHandler.java,129,653,217.66667,653,524,174.66667,524,1177,392.33334,1177,1153,384.33334,1153,3,0,1,NO
3,hedwig-client/src/main/java/org/apache/hedwig/client/netty/impl/multiplex/MultiplexSubscriptionChannelPipelineFactory.java,49,49,49.0,49,0,0.0,0,49,49.0,49,49,49.0,49,1,0,1,NO
3,hedwig-client/src/main/java/org/apache/hedwig/client/netty/impl/simple/SimpleHChannelManager.java,358,364,91.0,364,6,1.5,6,370,92.5,370,358,89.5,358,4,1,1,NO
3,hedwig-client/src/main/java/org/apache/hedwig/client/netty/impl/simple/SimpleSubscribeResponseHandler.java,277,774,154.8,774,497,99.4,497,1271,254.2,1271,863,172.6,863,5,1,1,NO
3,hedwig-client/src/main/java/org/apache/hedwig/client/netty/impl/simple/SimpleSubscriptionChannelPipelineFactory.java,49,49,24.5,49,0,0.0,0,49,24.5,49,49,24.5,49,2,0,1,NO
3,hedwig-client/src/main/java/org/apache/hedwig/client/netty/package-info.java,89,89,89.0,89,0,0.0,0,89,89.0,89,89,89.0,89,1,0,1,NO
3,hedwig-client/src/main/java/org/apache/hedwig/client/ssl/SslClientContextFactory.java,41,0,0.0,0,0,0.0,0,0,0.0,0,0,0.0,0,0,0,0,NO
3,hedwig-client/src/main/java/org/apache/hedwig/client/ssl/SslContextFactory.java,66,0,0.0,0,0,0.0,0,0,0.0,0,0,0.0,0,0,0,0,NO
3,hedwig-client/src/main/java/org/apache/hedwig/conf/AbstractConfiguration.java,63,0,0.0,0,0,0.0,0,0,0.0,0,0,0.0,0,0,0,0,NO
3,hedwig-client/src/main/java/org/apache/hedwig/filter/ClientMessageFilter.java,24,24,24.0,24,0,0.0,0,24,24.0,24,24,24.0,24,1,0,1,NO
3,hedwig-client/src/main/java/org/apache/hedwig/filter/MessageFilterBase.java,50,50,50.0,50,0,0.0,0,50,50.0,50,50,50.0,50,1,0,1,NO
3,hedwig-client/src/main/java/org/apache/hedwig/filter/PipelineFilter.java,72,81,40.5,81,9,4.5,9,90,45.0,90,72,36.0,72,2,0,1,NO
3,hedwig-client/src/main/java/org/apache/hedwig/filter/ServerMessageFilter.java,47,47,47.0,47,0,0.0,0,47,47.0,47,47,47.0,47,1,0,1,NO
3,hedwig-client/src/main/java/org/apache/hedwig/util/Callback.java,47,0,0.0,0,0,0.0,0,0,0.0,0,0,0.0,0,0,0,0,NO
3,hedwig-client/src/main/java/org/apache/hedwig/util/CallbackUtils.java,183,0,0.0,0,0,0.0,0,0,0.0,0,0,0.0,0,0,0,0,NO
3,hedwig-client/src/main/java/org/apache/hedwig/util/ConcurrencyUtils.java,49,0,0.0,0,0,0.0,0,0,0.0,0,0,0.0,0,0,0,0,NO
3,hedwig-client/src/main/java/org/apache/hedwig/util/Either.java,50,0,0.0,0,0,0.0,0,0,0.0,0,0,0.0,0,0,0,0,NO
3,hedwig-client/src/main/java/org/apache/hedwig/util/FileUtils.java,98,0,0.0,0,0,0.0,0,0,0.0,0,0,0.0,0,0,0,0,NO
3,hedwig-client/src/main/java/org/apache/hedwig/util/HedwigSocketAddress.java,143,0,0.0,0,0,0.0,0,0,0.0,0,0,0.0,0,0,0,0,NO
3,hedwig-client/src/main/java/org/apache/hedwig/util/Option.java,43,0,0.0,0,0,0.0,0,0,0.0,0,0,0.0,0,0,0,0,NO
3,hedwig-client/src/main/java/org/apache/hedwig/util/Pair.java,42,0,0.0,0,0,0.0,0,0,0.0,0,0,0.0,0,0,0,0,NO
3,hedwig-client/src/main/java/org/apache/hedwig/util/PathUtils.java,56,0,0.0,0,0,0.0,0,0,0.0,0,0,0.0,0,0,0,0,NO
3,hedwig-client/src/main/java/org/apache/hedwig/util/SubscriptionListener.java,44,44,44.0,44,0,0.0,0,44,44.0,44,44,44.0,44,1,0,1,NO
3,hedwig-client/src/main/java/org/apache/hedwig/util/VarArgs.java,26,26,26.0,26,0,0.0,0,26,26.0,26,26,26.0,26,1,0,1,NO
3,hedwig-protocol/src/main/java/org/apache/hedwig/exceptions/PubSubException.java,254,105,17.5,105,13,2.1666667,13,118,19.666666,118,92,15.333333,92,6,1,2,NO
3,hedwig-protocol/src/main/java/org/apache/hedwig/protocol/PubSubProtocol.java,16883,12633,902.3571,12633,2273,162.35715,2273,14906,1064.7142,14906,10362,740.1429,10362,14,3,2,NO
3,hedwig-protocol/src/main/java/org/apache/hedwig/protoextensions/MapUtils.java,74,74,74.0,74,0,0.0,0,74,74.0,74,74,74.0,74,1,0,1,NO
3,hedwig-protocol/src/main/java/org/apache/hedwig/protoextensions/MessageIdUtils.java,153,0,0.0,0,0,0.0,0,0,0.0,0,0,0.0,0,0,0,0,NO
3,hedwig-protocol/src/main/java/org/apache/hedwig/protoextensions/PubSubResponseUtils.java,68,26,8.666667,26,1,0.33333334,1,27,9.0,27,25,8.333333,25,3,0,2,NO
3,hedwig-protocol/src/main/java/org/apache/hedwig/protoextensions/SubscriptionStateUtils.java,100,59,59.0,59,0,0.0,0,59,59.0,59,59,59.0,59,1,0,1,NO
3,hedwig-server/src/main/java/org/apache/hedwig/admin/HedwigAdmin.java,549,332,55.333332,332,183,30.5,183,515,85.833336,515,185,30.833334,185,6,2,2,YES
3,hedwig-server/src/main/java/org/apache/hedwig/admin/console/HedwigCommands.java,437,12,12.0,12,0,0.0,0,12,12.0,12,12,12.0,12,1,1,1,NO
3,hedwig-server/src/main/java/org/apache/hedwig/admin/console/HedwigConsole.java,1033,149,21.285715,149,157,22.428572,157,306,43.714287,306,98,14.0,98,7,3,2,YES
3,hedwig-server/src/main/java/org/apache/hedwig/admin/console/JLineHedwigCompletor.java,101,11,11.0,11,2,2.0,2,13,13.0,13,9,9.0,9,1,0,1,YES
3,hedwig-server/src/main/java/org/apache/hedwig/admin/console/ReadTopic.java,331,23,11.5,23,47,23.5,47,70,35.0,70,24,12.0,24,2,1,1,YES
3,hedwig-server/src/main/java/org/apache/hedwig/data/MessageFormatter.java,123,123,123.0,123,0,0.0,0,123,123.0,123,123,123.0,123,1,0,1,NO
3,hedwig-server/src/main/java/org/apache/hedwig/server/benchmark/AbstractBenchmark.java,106,4,4.0,4,3,3.0,3,7,7.0,7,1,1.0,1,1,1,1,NO
3,hedwig-server/src/main/java/org/apache/hedwig/server/benchmark/BookieBenchmark.java,106,2,2.0,2,1,1.0,1,3,3.0,3,1,1.0,1,1,1,1,NO
3,hedwig-server/src/main/java/org/apache/hedwig/server/benchmark/BookkeeperBenchmark.java,93,2,2.0,2,1,1.0,1,3,3.0,3,1,1.0,1,1,1,1,YES
3,hedwig-server/src/main/java/org/apache/hedwig/server/benchmark/FakeBookie.java,101,0,0.0,0,0,0.0,0,0,0.0,0,0,0.0,0,0,0,0,YES
3,hedwig-server/src/main/java/org/apache/hedwig/server/common/ByteStringInterner.java,38,2,2.0,2,9,9.0,9,11,11.0,11,7,7.0,7,1,1,1,NO
3,hedwig-server/src/main/java/org/apache/hedwig/server/common/ServerConfiguration.java,584,316,26.333334,316,31,2.5833333,31,347,28.916666,347,285,23.75,285,12,4,3,YES
3,hedwig-server/src/main/java/org/apache/hedwig/server/common/TerminateJVMExceptionHandler.java,32,0,0.0,0,0,0.0,0,0,0.0,0,0,0.0,0,0,0,0,NO
3,hedwig-server/src/main/java/org/apache/hedwig/server/common/TopicOpQueuer.java,111,0,0.0,0,0,0.0,0,0,0.0,0,0,0.0,0,0,0,0,NO
3,hedwig-server/src/main/java/org/apache/hedwig/server/common/UnexpectedError.java,35,0,0.0,0,0,0.0,0,0,0.0,0,0,0.0,0,0,0,0,NO
3,hedwig-server/src/main/java/org/apache/hedwig/server/delivery/ChannelEndPoint.java,90,5,5.0,5,0,0.0,0,5,5.0,5,5,5.0,5,1,1,1,NO
3,hedwig-server/src/main/java/org/apache/hedwig/server/delivery/DeliveryCallback.java,27,0,0.0,0,0,0.0,0,0,0.0,0,0,0.0,0,0,0,0,NO
3,hedwig-server/src/main/java/org/apache/hedwig/server/delivery/DeliveryEndPoint.java,28,0,0.0,0,0,0.0,0,0,0.0,0,0,0.0,0,0,0,0,NO
3,hedwig-server/src/main/java/org/apache/hedwig/server/delivery/DeliveryManager.java,92,64,12.8,64,8,1.6,8,72,14.4,72,56,11.2,56,5,1,1,NO
3,hedwig-server/src/main/java/org/apache/hedwig/server/delivery/FIFODeliveryManager.java,885,476,34.0,476,165,11.785714,165,641,45.785713,641,351,25.071428,351,14,6,3,YES
3,hedwig-server/src/main/java/org/apache/hedwig/server/handlers/BaseHandler.java,67,0,0.0,0,0,0.0,0,0,0.0,0,0,0.0,0,0,0,0,NO
3,hedwig-server/src/main/java/org/apache/hedwig/server/handlers/ChannelDisconnectListener.java,29,0,0.0,0,0,0.0,0,0,0.0,0,0,0.0,0,0,0,0,NO
3,hedwig-server/src/main/java/org/apache/hedwig/server/handlers/CloseSubscriptionHandler.java,105,105,105.0,105,0,0.0,0,105,105.0,105,105,105.0,105,1,0,1,NO
3,hedwig-server/src/main/java/org/apache/hedwig/server/handlers/ConsumeHandler.java,72,0,0.0,0,0,0.0,0,0,0.0,0,0,0.0,0,0,0,0,NO
3,hedwig-server/src/main/java/org/apache/hedwig/server/handlers/Handler.java,37,0,0.0,0,0,0.0,0,0,0.0,0,0,0.0,0,0,0,0,NO
3,hedwig-server/src/main/java/org/apache/hedwig/server/handlers/NettyHandlerBean.java,47,5,5.0,5,9,9.0,9,14,14.0,14,4,4.0,4,1,0,1,NO
3,hedwig-server/src/main/java/org/apache/hedwig/server/handlers/NettyHandlerMXBean.java,31,0,0.0,0,0,0.0,0,0,0.0,0,0,0.0,0,0,0,0,NO
3,hedwig-server/src/main/java/org/apache/hedwig/server/handlers/PublishHandler.java,90,18,9.0,18,5,2.5,5,23,11.5,23,13,6.5,13,2,1,1,NO
3,hedwig-server/src/main/java/org/apache/hedwig/server/handlers/SubscribeHandler.java,223,190,23.75,190,135,16.875,135,325,40.625,325,173,21.625,173,8,2,2,NO
3,hedwig-server/src/main/java/org/apache/hedwig/server/handlers/SubscriptionChannelManager.java,214,233,77.666664,233,19,6.3333335,19,252,84.0,252,214,71.333336,214,3,0,2,NO
3,hedwig-server/src/main/java/org/apache/hedwig/server/handlers/UnsubscribeHandler.java,107,33,16.5,33,7,3.5,7,40,20.0,40,26,13.0,26,2,1,2,NO
3,hedwig-server/src/main/java/org/apache/hedwig/server/jmx/HedwigJMXService.java,37,0,0.0,0,0,0.0,0,0,0.0,0,0,0.0,0,0,0,0,NO
3,hedwig-server/src/main/java/org/apache/hedwig/server/jmx/HedwigMBeanInfo.java,27,0,0.0,0,0,0.0,0,0,0.0,0,0,0.0,0,0,0,0,NO
3,hedwig-server/src/main/java/org/apache/hedwig/server/jmx/HedwigMBeanRegistry.java,48,0,0.0,0,0,0.0,0,0,0.0,0,0,0.0,0,0,0,0,NO
3,hedwig-server/src/main/java/org/apache/hedwig/server/meta/FactoryLayout.java,166,166,83.0,166,0,0.0,0,166,83.0,166,166,83.0,166,2,1,1,YES
3,hedwig-server/src/main/java/org/apache/hedwig/server/meta/MetadataManagerFactory.java,213,241,60.25,241,28,7.0,28,269,67.25,269,213,53.25,213,4,1,1,NO
3,hedwig-server/src/main/java/org/apache/hedwig/server/meta/MsMetadataManagerFactory.java,866,866,866.0,866,0,0.0,0,866,866.0,866,866,866.0,866,1,0,1,YES
3,hedwig-server/src/main/java/org/apache/hedwig/server/meta/SubscriptionDataManager.java,159,190,63.333332,190,31,10.333333,31,221,73.666664,221,159,53.0,159,3,0,1,NO
3,hedwig-server/src/main/java/org/apache/hedwig/server/meta/TopicOwnershipManager.java,100,104,52.0,104,4,2.0,4,108,54.0,108,100,50.0,100,2,1,1,NO
3,hedwig-server/src/main/java/org/apache/hedwig/server/meta/TopicPersistenceManager.java,96,100,50.0,100,4,2.0,4,104,52.0,104,96,48.0,96,2,1,1,NO
3,hedwig-server/src/main/java/org/apache/hedwig/server/meta/ZkMetadataManagerFactory.java,841,893,127.57143,893,52,7.428571,52,945,135.0,945,841,120.14286,841,7,2,1,YES
3,hedwig-server/src/main/java/org/apache/hedwig/server/netty/PubSubServer.java,525,127,14.111111,127,38,4.2222223,38,165,18.333334,165,89,9.888889,89,9,3,3,NO
3,hedwig-server/src/main/java/org/apache/hedwig/server/netty/PubSubServerBean.java,83,7,7.0,7,1,1.0,1,8,8.0,8,6,6.0,6,1,1,1,NO
3,hedwig-server/src/main/java/org/apache/hedwig/server/netty/PubSubServerMXBean.java,63,0,0.0,0,0,0.0,0,0,0.0,0,0,0.0,0,0,0,0,NO
3,hedwig-server/src/main/java/org/apache/hedwig/server/netty/PubSubServerPipelineFactory.java,76,0,0.0,0,0,0.0,0,0,0.0,0,0,0.0,0,0,0,0,NO
3,hedwig-server/src/main/java/org/apache/hedwig/server/netty/ServerStats.java,202,11,11.0,11,0,0.0,0,11,11.0,11,11,11.0,11,1,1,1,NO
3,hedwig-server/src/main/java/org/apache/hedwig/server/netty/UmbrellaHandler.java,155,10,5.0,10,15,7.5,15,25,12.5,25,7,3.5,7,2,0,2,YES
3,hedwig-server/src/main/java/org/apache/hedwig/server/persistence/BookkeeperPersistenceManager.java,1262,695,63.18182,695,339,30.818182,339,1034,94.0,1034,454,41.272728,454,11,6,3,YES
3,hedwig-server/src/main/java/org/apache/hedwig/server/persistence/CacheKey.java,74,0,0.0,0,0,0.0,0,0,0.0,0,0,0.0,0,0,0,0,NO
3,hedwig-server/src/main/java/org/apache/hedwig/server/persistence/CacheValue.java,101,19,9.5,19,12,6.0,12,31,15.5,31,11,5.5,11,2,0,2,NO
3,hedwig-server/src/main/java/org/apache/hedwig/server/persistence/CancelScanRequest.java,27,27,27.0,27,0,0.0,0,27,27.0,27,27,27.0,27,1,0,1,NO
3,hedwig-server/src/main/java/org/apache/hedwig/server/persistence/Factory.java,22,0,0.0,0,0,0.0,0,0,0.0,0,0,0.0,0,0,0,0,NO
3,hedwig-server/src/main/java/org/apache/hedwig/server/persistence/LocalDBPersistenceManager.java,489,11,3.6666667,11,3,1.0,3,14,4.6666665,14,8,2.6666667,8,3,0,2,YES
3,hedwig-server/src/main/java/org/apache/hedwig/server/persistence/MapMethods.java,62,0,0.0,0,0,0.0,0,0,0.0,0,0,0.0,0,0,0,0,NO
3,hedwig-server/src/main/java/org/apache/hedwig/server/persistence/PersistRequest.java,59,4,4.0,4,3,3.0,3,7,7.0,7,1,1.0,1,1,0,1,NO
3,hedwig-server/src/main/java/org/apache/hedwig/server/persistence/PersistenceManager.java,99,5,5.0,5,0,0.0,0,5,5.0,5,5,5.0,5,1,0,1,NO
3,hedwig-server/src/main/java/org/apache/hedwig/server/persistence/PersistenceManagerWithRangeScan.java,27,0,0.0,0,0,0.0,0,0,0.0,0,0,0.0,0,0,0,0,NO
3,hedwig-server/src/main/java/org/apache/hedwig/server/persistence/RangeScanRequest.java,77,0,0.0,0,0,0.0,0,0,0.0,0,0,0.0,0,0,0,0,NO
3,hedwig-server/src/main/java/org/apache/hedwig/server/persistence/ReadAheadCache.java,846,298,42.57143,298,196,28.0,196,494,70.57143,494,124,17.714285,124,7,4,2,NO
3,hedwig-server/src/main/java/org/apache/hedwig/server/persistence/ReadAheadCacheBean.java,64,2,1.0,2,2,1.0,2,4,2.0,4,0,0.0,0,2,2,1,NO
3,hedwig-server/src/main/java/org/apache/hedwig/server/persistence/ReadAheadCacheMXBean.java,45,0,0.0,0,0,0.0,0,0,0.0,0,0,0.0,0,0,0,0,NO
3,hedwig-server/src/main/java/org/apache/hedwig/server/persistence/ScanCallback.java,63,0,0.0,0,0,0.0,0,0,0.0,0,0,0.0,0,0,0,0,NO
3,hedwig-server/src/main/java/org/apache/hedwig/server/persistence/ScanCallbackWithContext.java,54,17,17.0,17,0,0.0,0,17,17.0,17,17,17.0,17,1,0,1,NO
3,hedwig-server/src/main/java/org/apache/hedwig/server/persistence/ScanRequest.java,64,0,0.0,0,0,0.0,0,0,0.0,0,0,0.0,0,0,0,0,NO
3,hedwig-server/src/main/java/org/apache/hedwig/server/proxy/ChannelTracker.java,132,9,9.0,9,1,1.0,1,10,10.0,10,8,8.0,8,1,0,1,NO
3,hedwig-server/src/main/java/org/apache/hedwig/server/proxy/HedwigProxy.java,177,7,3.5,7,2,1.0,2,9,4.5,9,5,2.5,5,2,0,1,NO
3,hedwig-server/src/main/java/org/apache/hedwig/server/proxy/ProxyCloseSubscriptionHandler.java,70,70,70.0,70,0,0.0,0,70,70.0,70,70,70.0,70,1,0,1,NO
3,hedwig-server/src/main/java/org/apache/hedwig/server/proxy/ProxyConfiguration.java,36,0,0.0,0,0,0.0,0,0,0.0,0,0,0.0,0,0,0,0,NO
3,hedwig-server/src/main/java/org/apache/hedwig/server/proxy/ProxyConsumeHandler.java,58,0,0.0,0,0,0.0,0,0,0.0,0,0,0.0,0,0,0,0,NO
3,hedwig-server/src/main/java/org/apache/hedwig/server/proxy/ProxyPublishHander.java,62,0,0.0,0,0,0.0,0,0,0.0,0,0,0.0,0,0,0,0,NO
3,hedwig-server/src/main/java/org/apache/hedwig/server/proxy/ProxyStartDeliveryHandler.java,132,0,0.0,0,0,0.0,0,0,0.0,0,0,0.0,0,0,0,0,NO
3,hedwig-server/src/main/java/org/apache/hedwig/server/proxy/ProxyStopDeliveryHandler.java,74,0,0.0,0,0,0.0,0,0,0.0,0,0,0.0,0,0,0,0,NO
3,hedwig-server/src/main/java/org/apache/hedwig/server/proxy/ProxySubscribeHandler.java,83,0,0.0,0,0,0.0,0,0,0.0,0,0,0.0,0,0,0,0,YES
3,hedwig-server/src/main/java/org/apache/hedwig/server/proxy/ProxyUnsubscribeHandler.java,74,0,0.0,0,0,0.0,0,0,0.0,0,0,0.0,0,0,0,0,NO
3,hedwig-server/src/main/java/org/apache/hedwig/server/regions/HedwigHubClient.java,48,0,0.0,0,0,0.0,0,0,0.0,0,0,0.0,0,0,0,0,NO
3,hedwig-server/src/main/java/org/apache/hedwig/server/regions/HedwigHubClientFactory.java,74,20,20.0,20,6,6.0,6,26,26.0,26,14,14.0,14,1,1,1,NO
3,hedwig-server/src/main/java/org/apache/hedwig/server/regions/HedwigHubSubscriber.java,86,0,0.0,0,0,0.0,0,0,0.0,0,0,0.0,0,0,0,0,NO
3,hedwig-server/src/main/java/org/apache/hedwig/server/regions/RegionManager.java,355,22,11.0,22,22,11.0,22,44,22.0,44,0,0.0,0,2,0,1,NO
3,hedwig-server/src/main/java/org/apache/hedwig/server/ssl/SslServerContextFactory.java,53,0,0.0,0,0,0.0,0,0,0.0,0,0,0.0,0,0,0,0,NO
3,hedwig-server/src/main/java/org/apache/hedwig/server/subscriptions/AbstractSubscriptionManager.java,798,313,31.3,313,127,12.7,127,440,44.0,440,226,22.6,226,10,3,2,YES
3,hedwig-server/src/main/java/org/apache/hedwig/server/subscriptions/AllToAllTopologyFilter.java,75,44,22.0,44,8,4.0,8,52,26.0,52,36,18.0,36,2,0,1,NO
3,hedwig-server/src/main/java/org/apache/hedwig/server/subscriptions/InMemorySubscriptionManager.java,125,64,12.8,64,17,3.4,17,81,16.2,81,47,9.4,47,5,2,2,NO
3,hedwig-server/src/main/java/org/apache/hedwig/server/subscriptions/InMemorySubscriptionState.java,200,129,21.5,129,14,2.3333333,14,143,23.833334,143,115,19.166666,115,6,2,2,NO
3,hedwig-server/src/main/java/org/apache/hedwig/server/subscriptions/MMSubscriptionManager.java,134,161,40.25,161,27,6.75,27,188,47.0,188,134,33.5,134,4,0,1,NO
3,hedwig-server/src/main/java/org/apache/hedwig/server/subscriptions/SubscriptionEventListener.java,57,0,0.0,0,0,0.0,0,0,0.0,0,0,0.0,0,0,0,0,NO
3,hedwig-server/src/main/java/org/apache/hedwig/server/subscriptions/SubscriptionManager.java,123,18,9.0,18,3,1.5,3,21,10.5,21,15,7.5,15,2,0,1,NO
3,hedwig-server/src/main/java/org/apache/hedwig/server/topics/AbstractTopicManager.java,204,4,4.0,4,1,1.0,1,5,5.0,5,3,3.0,3,1,0,1,NO
3,hedwig-server/src/main/java/org/apache/hedwig/server/topics/HubInfo.java,162,162,162.0,162,0,0.0,0,162,162.0,162,162,162.0,162,1,0,1,NO
3,hedwig-server/src/main/java/org/apache/hedwig/server/topics/HubLoad.java,130,131,65.5,131,1,0.5,1,132,66.0,132,130,65.0,130,2,0,1,NO
3,hedwig-server/src/main/java/org/apache/hedwig/server/topics/HubServerManager.java,108,108,108.0,108,0,0.0,0,108,108.0,108,108,108.0,108,1,0,1,NO
3,hedwig-server/src/main/java/org/apache/hedwig/server/topics/MMTopicManager.java,353,354,177.0,354,1,0.5,1,355,177.5,355,353,176.5,353,2,1,1,NO
3,hedwig-server/src/main/java/org/apache/hedwig/server/topics/TopicManager.java,80,0,0.0,0,0,0.0,0,0,0.0,0,0,0.0,0,0,0,0,NO
3,hedwig-server/src/main/java/org/apache/hedwig/server/topics/TopicOwnershipChangeListener.java,28,0,0.0,0,0,0.0,0,0,0.0,0,0,0.0,0,0,0,0,NO
3,hedwig-server/src/main/java/org/apache/hedwig/server/topics/TrivialOwnAllTopicManager.java,57,0,0.0,0,0,0.0,0,0,0.0,0,0,0.0,0,0,0,0,NO
3,hedwig-server/src/main/java/org/apache/hedwig/server/topics/ZkHubServerManager.java,306,312,156.0,312,6,3.0,6,318,159.0,318,314,157.0,314,2,0,2,YES
3,hedwig-server/src/main/java/org/apache/hedwig/server/topics/ZkTopicManager.java,340,77,77.0,77,183,183.0,183,260,260.0,260,106,106.0,106,1,0,1,YES
3,hedwig-server/src/main/java/org/apache/hedwig/zookeeper/SafeAsynBKCallback.java,103,0,0.0,0,0,0.0,0,0,0.0,0,0,0.0,0,0,0,0,NO
3,hedwig-server/src/main/java/org/apache/hedwig/zookeeper/SafeAsyncCallback.java,35,0,0.0,0,0,0.0,0,0,0.0,0,0,0.0,0,0,0,0,NO
3,hedwig-server/src/main/java/org/apache/hedwig/zookeeper/SafeAsyncZKCallback.java,98,0,0.0,0,0,0.0,0,0,0.0,0,0,0.0,0,0,0,0,NO
3,hedwig-server/src/main/java/org/apache/hedwig/zookeeper/ZkUtils.java,117,38,38.0,38,0,0.0,0,38,38.0,38,38,38.0,38,1,0,1,YES
4,bookkeeper-benchmark/src/main/java/org/apache/bookkeeper/benchmark/BenchBookie.java,215,0,0.0,0,0,0.0,0,0,0.0,0,0,0.0,0,0,0,0,NO
4,bookkeeper-benchmark/src/main/java/org/apache/bookkeeper/benchmark/BenchReadThroughputLatency.java,273,4,4.0,4,2,2.0,2,6,6.0,6,2,2.0,2,1,1,1,NO
4,bookkeeper-benchmark/src/main/java/org/apache/bookkeeper/benchmark/BenchThroughputLatency.java,460,5,5.0,5,3,3.0,3,8,8.0,8,2,2.0,2,1,1,1,NO
4,bookkeeper-benchmark/src/main/java/org/apache/bookkeeper/benchmark/MySqlClient.java,138,5,5.0,5,4,4.0,4,9,9.0,9,1,1.0,1,1,1,1,NO
4,bookkeeper-benchmark/src/main/java/org/apache/bookkeeper/benchmark/TestClient.java,358,2,2.0,2,1,1.0,1,3,3.0,3,1,1.0,1,1,1,1,NO
4,bookkeeper-server/src/main/java/org/apache/bookkeeper/bookie/Bookie.java,1248,9,4.5,9,3,1.5,3,12,6.0,12,6,3.0,6,2,2,2,NO
4,bookkeeper-server/src/main/java/org/apache/bookkeeper/bookie/BookieBean.java,51,0,0.0,0,0,0.0,0,0,0.0,0,0,0.0,0,0,0,0,NO
4,bookkeeper-server/src/main/java/org/apache/bookkeeper/bookie/BookieException.java,157,4,4.0,4,1,1.0,1,5,5.0,5,3,3.0,3,1,1,1,NO
4,bookkeeper-server/src/main/java/org/apache/bookkeeper/bookie/BookieMXBean.java,31,0,0.0,0,0,0.0,0,0,0.0,0,0,0.0,0,0,0,0,NO
4,bookkeeper-server/src/main/java/org/apache/bookkeeper/bookie/BookieShell.java,981,54,54.0,54,1,1.0,1,55,55.0,55,53,53.0,53,1,0,1,NO
4,bookkeeper-server/src/main/java/org/apache/bookkeeper/bookie/BufferedChannel.java,180,0,0.0,0,0,0.0,0,0,0.0,0,0,0.0,0,0,0,0,NO
4,bookkeeper-server/src/main/java/org/apache/bookkeeper/bookie/Cookie.java,262,8,8.0,8,6,6.0,6,14,14.0,14,2,2.0,2,1,1,1,NO
4,bookkeeper-server/src/main/java/org/apache/bookkeeper/bookie/EntryLogger.java,553,5,5.0,5,3,3.0,3,8,8.0,8,2,2.0,2,1,1,1,NO
4,bookkeeper-server/src/main/java/org/apache/bookkeeper/bookie/ExitCode.java,40,0,0.0,0,0,0.0,0,0,0.0,0,0,0.0,0,0,0,0,NO
4,bookkeeper-server/src/main/java/org/apache/bookkeeper/bookie/FileInfo.java,369,9,4.5,9,1,0.5,1,10,5.0,10,8,4.0,8,2,2,2,NO
4,bookkeeper-server/src/main/java/org/apache/bookkeeper/bookie/FileSystemUpgrade.java,390,3,3.0,3,1,1.0,1,4,4.0,4,2,2.0,2,1,1,1,NO
4,bookkeeper-server/src/main/java/org/apache/bookkeeper/bookie/GarbageCollector.java,51,0,0.0,0,0,0.0,0,0,0.0,0,0,0.0,0,0,0,0,NO
4,bookkeeper-server/src/main/java/org/apache/bookkeeper/bookie/GarbageCollectorThread.java,577,0,0.0,0,0,0.0,0,0,0.0,0,0,0.0,0,0,0,0,NO
4,bookkeeper-server/src/main/java/org/apache/bookkeeper/bookie/HandleFactory.java,32,0,0.0,0,0,0.0,0,0,0.0,0,0,0.0,0,0,0,0,NO
4,bookkeeper-server/src/main/java/org/apache/bookkeeper/bookie/HandleFactoryImpl.java,66,0,0.0,0,0,0.0,0,0,0.0,0,0,0.0,0,0,0,0,NO
4,bookkeeper-server/src/main/java/org/apache/bookkeeper/bookie/InterleavedLedgerStorage.java,188,1,1.0,1,1,1.0,1,2,2.0,2,0,0.0,0,1,1,1,NO
4,bookkeeper-server/src/main/java/org/apache/bookkeeper/bookie/Journal.java,582,0,0.0,0,0,0.0,0,0,0.0,0,0,0.0,0,0,0,0,NO
4,bookkeeper-server/src/main/java/org/apache/bookkeeper/bookie/JournalChannel.java,160,3,3.0,3,1,1.0,1,4,4.0,4,2,2.0,2,1,1,1,NO
4,bookkeeper-server/src/main/java/org/apache/bookkeeper/bookie/LedgerCache.java,50,0,0.0,0,0,0.0,0,0,0.0,0,0,0.0,0,0,0,0,NO
4,bookkeeper-server/src/main/java/org/apache/bookkeeper/bookie/LedgerCacheBean.java,27,0,0.0,0,0,0.0,0,0,0.0,0,0,0.0,0,0,0,0,NO
4,bookkeeper-server/src/main/java/org/apache/bookkeeper/bookie/LedgerCacheImpl.java,923,15,5.0,15,20,6.6666665,20,35,11.666667,35,19,6.3333335,19,3,2,2,NO
4,bookkeeper-server/src/main/java/org/apache/bookkeeper/bookie/LedgerCacheMXBean.java,60,0,0.0,0,0,0.0,0,0,0.0,0,0,0.0,0,0,0,0,NO
4,bookkeeper-server/src/main/java/org/apache/bookkeeper/bookie/LedgerDescriptor.java,62,0,0.0,0,0,0.0,0,0,0.0,0,0,0.0,0,0,0,0,NO
4,bookkeeper-server/src/main/java/org/apache/bookkeeper/bookie/LedgerDescriptorImpl.java,87,0,0.0,0,0,0.0,0,0,0.0,0,0,0.0,0,0,0,0,NO
4,bookkeeper-server/src/main/java/org/apache/bookkeeper/bookie/LedgerDescriptorReadOnlyImpl.java,52,0,0.0,0,0,0.0,0,0,0.0,0,0,0.0,0,0,0,0,NO
4,bookkeeper-server/src/main/java/org/apache/bookkeeper/bookie/LedgerDirsManager.java,268,0,0.0,0,0,0.0,0,0,0.0,0,0,0.0,0,0,0,0,NO
4,bookkeeper-server/src/main/java/org/apache/bookkeeper/bookie/LedgerEntryPage.java,163,0,0.0,0,0,0.0,0,0,0.0,0,0,0.0,0,0,0,0,NO
4,bookkeeper-server/src/main/java/org/apache/bookkeeper/bookie/LedgerStorage.java,109,0,0.0,0,0,0.0,0,0,0.0,0,0,0.0,0,0,0,0,NO
4,bookkeeper-server/src/main/java/org/apache/bookkeeper/bookie/MarkerFileChannel.java,147,0,0.0,0,0,0.0,0,0,0.0,0,0,0.0,0,0,0,0,NO
4,bookkeeper-server/src/main/java/org/apache/bookkeeper/bookie/ReadOnlyEntryLogger.java,58,0,0.0,0,0,0.0,0,0,0.0,0,0,0.0,0,0,0,0,NO
4,bookkeeper-server/src/main/java/org/apache/bookkeeper/bookie/ReadOnlyFileInfo.java,44,0,0.0,0,0,0.0,0,0,0.0,0,0,0.0,0,0,0,0,NO
4,bookkeeper-server/src/main/java/org/apache/bookkeeper/bookie/ScanAndCompareGarbageCollector.java,106,0,0.0,0,0,0.0,0,0,0.0,0,0,0.0,0,0,0,0,NO
4,bookkeeper-server/src/main/java/org/apache/bookkeeper/client/AsyncCallback.java,139,0,0.0,0,0,0.0,0,0,0.0,0,0,0.0,0,0,0,0,NO
4,bookkeeper-server/src/main/java/org/apache/bookkeeper/client/BKException.java,326,0,0.0,0,0,0.0,0,0,0.0,0,0,0.0,0,0,0,0,NO
4,bookkeeper-server/src/main/java/org/apache/bookkeeper/client/BookKeeper.java,648,0,0.0,0,0,0.0,0,0,0.0,0,0,0.0,0,0,0,0,NO
4,bookkeeper-server/src/main/java/org/apache/bookkeeper/client/BookKeeperAdmin.java,792,17,8.5,17,3,1.5,3,20,10.0,20,14,7.0,14,2,1,1,NO
4,bookkeeper-server/src/main/java/org/apache/bookkeeper/client/BookieWatcher.java,319,6,3.0,6,1,0.5,1,7,3.5,7,5,2.5,5,2,1,2,NO
4,bookkeeper-server/src/main/java/org/apache/bookkeeper/client/CRC32DigestManager.java,55,0,0.0,0,0,0.0,0,0,0.0,0,0,0.0,0,0,0,0,NO
4,bookkeeper-server/src/main/java/org/apache/bookkeeper/client/DigestManager.java,191,0,0.0,0,0,0.0,0,0,0.0,0,0,0.0,0,0,0,0,NO
4,bookkeeper-server/src/main/java/org/apache/bookkeeper/client/DistributionSchedule.java,90,0,0.0,0,0,0.0,0,0,0.0,0,0,0.0,0,0,0,0,NO
4,bookkeeper-server/src/main/java/org/apache/bookkeeper/client/LedgerChecker.java,273,0,0.0,0,0,0.0,0,0,0.0,0,0,0.0,0,0,0,0,NO
4,bookkeeper-server/src/main/java/org/apache/bookkeeper/client/LedgerCreateOp.java,137,0,0.0,0,0,0.0,0,0,0.0,0,0,0.0,0,0,0,0,NO
4,bookkeeper-server/src/main/java/org/apache/bookkeeper/client/LedgerDeleteOp.java,79,0,0.0,0,0,0.0,0,0,0.0,0,0,0.0,0,0,0,0,NO
4,bookkeeper-server/src/main/java/org/apache/bookkeeper/client/LedgerEntry.java,82,0,0.0,0,0,0.0,0,0,0.0,0,0,0.0,0,0,0,0,NO
4,bookkeeper-server/src/main/java/org/apache/bookkeeper/client/LedgerFragment.java,147,0,0.0,0,0,0.0,0,0,0.0,0,0,0.0,0,0,0,0,NO
4,bookkeeper-server/src/main/java/org/apache/bookkeeper/client/LedgerFragmentReplicator.java,422,0,0.0,0,0,0.0,0,0,0.0,0,0,0.0,0,0,0,0,NO
4,bookkeeper-server/src/main/java/org/apache/bookkeeper/client/LedgerHandle.java,979,5,5.0,5,4,4.0,4,9,9.0,9,1,1.0,1,1,1,1,NO
4,bookkeeper-server/src/main/java/org/apache/bookkeeper/client/LedgerMetadata.java,495,45,22.5,45,17,8.5,17,62,31.0,62,28,14.0,28,2,1,2,NO
4,bookkeeper-server/src/main/java/org/apache/bookkeeper/client/LedgerOpenOp.java,189,0,0.0,0,0,0.0,0,0,0.0,0,0,0.0,0,0,0,0,NO
4,bookkeeper-server/src/main/java/org/apache/bookkeeper/client/LedgerRecoveryOp.java,167,36,36.0,36,22,22.0,22,58,58.0,58,14,14.0,14,1,0,1,NO
4,bookkeeper-server/src/main/java/org/apache/bookkeeper/client/MacDigestManager.java,86,3,3.0,3,1,1.0,1,4,4.0,4,2,2.0,2,1,1,1,NO
4,bookkeeper-server/src/main/java/org/apache/bookkeeper/client/PendingAddOp.java,182,0,0.0,0,0,0.0,0,0,0.0,0,0,0.0,0,0,0,0,NO
4,bookkeeper-server/src/main/java/org/apache/bookkeeper/client/PendingReadOp.java,361,21,21.0,21,18,18.0,18,39,39.0,39,3,3.0,3,1,0,1,NO
4,bookkeeper-server/src/main/java/org/apache/bookkeeper/client/ReadLastConfirmedOp.java,126,0,0.0,0,0,0.0,0,0,0.0,0,0,0.0,0,0,0,0,NO
4,bookkeeper-server/src/main/java/org/apache/bookkeeper/client/ReadOnlyLedgerHandle.java,106,0,0.0,0,0,0.0,0,0,0.0,0,0,0.0,0,0,0,0,NO
4,bookkeeper-server/src/main/java/org/apache/bookkeeper/client/RoundRobinDistributionSchedule.java,109,0,0.0,0,0,0.0,0,0,0.0,0,0,0.0,0,0,0,0,NO
4,bookkeeper-server/src/main/java/org/apache/bookkeeper/client/SyncCounter.java,85,0,0.0,0,0,0.0,0,0,0.0,0,0,0.0,0,0,0,0,NO
4,bookkeeper-server/src/main/java/org/apache/bookkeeper/conf/AbstractConfiguration.java,236,0,0.0,0,0,0.0,0,0,0.0,0,0,0.0,0,0,0,0,NO
4,bookkeeper-server/src/main/java/org/apache/bookkeeper/conf/ClientConfiguration.java,315,4,2.0,4,3,1.5,3,7,3.5,7,1,0.5,1,2,2,2,NO
4,bookkeeper-server/src/main/java/org/apache/bookkeeper/conf/ServerConfiguration.java,695,11,2.75,11,10,2.5,10,21,5.25,21,5,1.25,5,4,4,3,NO
4,bookkeeper-server/src/main/java/org/apache/bookkeeper/jmx/BKMBeanInfo.java,27,0,0.0,0,0,0.0,0,0,0.0,0,0,0.0,0,0,0,0,NO
4,bookkeeper-server/src/main/java/org/apache/bookkeeper/jmx/BKMBeanRegistry.java,89,0,0.0,0,0,0.0,0,0,0.0,0,0,0.0,0,0,0,0,NO
4,bookkeeper-server/src/main/java/org/apache/bookkeeper/meta/AbstractZkLedgerManager.java,301,1,1.0,1,1,1.0,1,2,2.0,2,0,0.0,0,1,1,1,NO
4,bookkeeper-server/src/main/java/org/apache/bookkeeper/meta/FlatLedgerManager.java,153,0,0.0,0,0,0.0,0,0,0.0,0,0,0.0,0,0,0,0,NO
4,bookkeeper-server/src/main/java/org/apache/bookkeeper/meta/FlatLedgerManagerFactory.java,92,0,0.0,0,0,0.0,0,0,0.0,0,0,0.0,0,0,0,0,NO
4,bookkeeper-server/src/main/java/org/apache/bookkeeper/meta/HierarchicalLedgerManager.java,466,1,1.0,1,1,1.0,1,2,2.0,2,0,0.0,0,1,1,1,NO
4,bookkeeper-server/src/main/java/org/apache/bookkeeper/meta/HierarchicalLedgerManagerFactory.java,93,0,0.0,0,0,0.0,0,0,0.0,0,0,0.0,0,0,0,0,NO
4,bookkeeper-server/src/main/java/org/apache/bookkeeper/meta/LedgerLayout.java,244,0,0.0,0,0,0.0,0,0,0.0,0,0,0.0,0,0,0,0,NO
4,bookkeeper-server/src/main/java/org/apache/bookkeeper/meta/LedgerManager.java,192,0,0.0,0,0,0.0,0,0,0.0,0,0,0.0,0,0,0,0,NO
4,bookkeeper-server/src/main/java/org/apache/bookkeeper/meta/LedgerManagerFactory.java,252,6,6.0,6,4,4.0,4,10,10.0,10,2,2.0,2,1,1,1,NO
4,bookkeeper-server/src/main/java/org/apache/bookkeeper/meta/LedgerUnderreplicationManager.java,109,0,0.0,0,0,0.0,0,0,0.0,0,0,0.0,0,0,0,0,NO
4,bookkeeper-server/src/main/java/org/apache/bookkeeper/meta/MSLedgerManagerFactory.java,601,0,0.0,0,0,0.0,0,0,0.0,0,0,0.0,0,0,0,0,NO
4,bookkeeper-server/src/main/java/org/apache/bookkeeper/meta/ZkLedgerUnderreplicationManager.java,565,1,1.0,1,1,1.0,1,2,2.0,2,0,0.0,0,1,1,1,NO
4,bookkeeper-server/src/main/java/org/apache/bookkeeper/meta/ZkVersion.java,69,0,0.0,0,0,0.0,0,0,0.0,0,0,0.0,0,0,0,0,NO
4,bookkeeper-server/src/main/java/org/apache/bookkeeper/metastore/InMemoryMetaStore.java,77,0,0.0,0,0,0.0,0,0,0.0,0,0,0.0,0,0,0,0,NO
4,bookkeeper-server/src/main/java/org/apache/bookkeeper/metastore/InMemoryMetastoreCursor.java,94,0,0.0,0,0,0.0,0,0,0.0,0,0,0.0,0,0,0,0,NO
4,bookkeeper-server/src/main/java/org/apache/bookkeeper/metastore/InMemoryMetastoreTable.java,337,0,0.0,0,0,0.0,0,0,0.0,0,0,0.0,0,0,0,0,NO
4,bookkeeper-server/src/main/java/org/apache/bookkeeper/metastore/MSException.java,214,0,0.0,0,0,0.0,0,0,0.0,0,0,0.0,0,0,0,0,NO
4,bookkeeper-server/src/main/java/org/apache/bookkeeper/metastore/MetaStore.java,79,0,0.0,0,0,0.0,0,0,0.0,0,0,0.0,0,0,0,0,NO
4,bookkeeper-server/src/main/java/org/apache/bookkeeper/metastore/MetastoreCallback.java,25,0,0.0,0,0,0.0,0,0,0.0,0,0,0.0,0,0,0,0,NO
4,bookkeeper-server/src/main/java/org/apache/bookkeeper/metastore/MetastoreCursor.java,84,0,0.0,0,0,0.0,0,0,0.0,0,0,0.0,0,0,0,0,NO
4,bookkeeper-server/src/main/java/org/apache/bookkeeper/metastore/MetastoreException.java,34,0,0.0,0,0,0.0,0,0,0.0,0,0,0.0,0,0,0,0,NO
4,bookkeeper-server/src/main/java/org/apache/bookkeeper/metastore/MetastoreFactory.java,33,0,0.0,0,0,0.0,0,0,0.0,0,0,0.0,0,0,0,0,NO
4,bookkeeper-server/src/main/java/org/apache/bookkeeper/metastore/MetastoreScannableTable.java,104,0,0.0,0,0,0.0,0,0,0.0,0,0,0.0,0,0,0,0,NO
4,bookkeeper-server/src/main/java/org/apache/bookkeeper/metastore/MetastoreTable.java,172,0,0.0,0,0,0.0,0,0,0.0,0,0,0.0,0,0,0,0,NO
4,bookkeeper-server/src/main/java/org/apache/bookkeeper/metastore/MetastoreTableItem.java,70,0,0.0,0,0,0.0,0,0,0.0,0,0,0.0,0,0,0,0,NO
4,bookkeeper-server/src/main/java/org/apache/bookkeeper/metastore/MetastoreUtils.java,140,0,0.0,0,0,0.0,0,0,0.0,0,0,0.0,0,0,0,0,NO
4,bookkeeper-server/src/main/java/org/apache/bookkeeper/metastore/Value.java,156,3,3.0,3,1,1.0,1,4,4.0,4,2,2.0,2,1,1,1,NO
4,bookkeeper-server/src/main/java/org/apache/bookkeeper/proto/BKStats.java,248,0,0.0,0,0,0.0,0,0,0.0,0,0,0.0,0,0,0,0,NO
4,bookkeeper-server/src/main/java/org/apache/bookkeeper/proto/BookieClient.java,277,3,3.0,3,1,1.0,1,4,4.0,4,2,2.0,2,1,1,1,NO
4,bookkeeper-server/src/main/java/org/apache/bookkeeper/proto/BookieNettyServer.java,189,191,95.5,191,2,1.0,2,193,96.5,193,189,94.5,189,2,0,2,NO
4,bookkeeper-server/src/main/java/org/apache/bookkeeper/proto/BookieProtoEncoding.java,194,203,101.5,203,9,4.5,9,212,106.0,212,194,97.0,194,2,0,2,NO
4,bookkeeper-server/src/main/java/org/apache/bookkeeper/proto/BookieProtocol.java,346,187,93.5,187,17,8.5,17,204,102.0,204,170,85.0,170,2,0,2,NO
4,bookkeeper-server/src/main/java/org/apache/bookkeeper/proto/BookieRequestHandler.java,304,306,153.0,306,2,1.0,2,308,154.0,308,304,152.0,304,2,0,2,NO
4,bookkeeper-server/src/main/java/org/apache/bookkeeper/proto/BookieServer.java,356,15,7.5,15,283,141.5,283,298,149.0,298,278,139.0,278,2,1,2,NO
4,bookkeeper-server/src/main/java/org/apache/bookkeeper/proto/BookieServerBean.java,84,2,1.0,2,9,4.5,9,11,5.5,11,7,3.5,7,2,1,2,NO
4,bookkeeper-server/src/main/java/org/apache/bookkeeper/proto/BookieServerMXBean.java,53,0,0.0,0,5,5.0,5,5,5.0,5,5,5.0,5,1,1,1,NO
4,bookkeeper-server/src/main/java/org/apache/bookkeeper/proto/BookkeeperInternalCallbacks.java,132,0,0.0,0,0,0.0,0,0,0.0,0,0,0.0,0,0,0,0,NO
4,bookkeeper-server/src/main/java/org/apache/bookkeeper/proto/DataFormats.java,4088,0,0.0,0,0,0.0,0,0,0.0,0,0,0.0,0,0,0,0,NO
4,bookkeeper-server/src/main/java/org/apache/bookkeeper/proto/PerChannelBookieClient.java,691,80,26.666666,80,116,38.666668,116,196,65.333336,196,36,12.0,36,3,2,2,NO
4,bookkeeper-server/src/main/java/org/apache/bookkeeper/proto/ResponseBuilder.java,47,52,26.0,52,5,2.5,5,57,28.5,57,47,23.5,47,2,0,2,NO
4,bookkeeper-server/src/main/java/org/apache/bookkeeper/proto/ServerStats.java,101,0,0.0,0,49,49.0,49,49,49.0,49,49,49.0,49,1,1,1,NO
4,bookkeeper-server/src/main/java/org/apache/bookkeeper/replication/Auditor.java,510,8,4.0,8,1,0.5,1,9,4.5,9,7,3.5,7,2,2,1,NO
4,bookkeeper-server/src/main/java/org/apache/bookkeeper/replication/AuditorElector.java,328,3,3.0,3,0,0.0,0,3,3.0,3,3,3.0,3,1,1,1,NO
4,bookkeeper-server/src/main/java/org/apache/bookkeeper/replication/AutoRecoveryMain.java,273,0,0.0,0,0,0.0,0,0,0.0,0,0,0.0,0,0,0,0,NO
4,bookkeeper-server/src/main/java/org/apache/bookkeeper/replication/BookieLedgerIndexer.java,136,0,0.0,0,0,0.0,0,0,0.0,0,0,0.0,0,0,0,0,NO
4,bookkeeper-server/src/main/java/org/apache/bookkeeper/replication/ReplicationEnableCb.java,56,0,0.0,0,0,0.0,0,0,0.0,0,0,0.0,0,0,0,0,NO
4,bookkeeper-server/src/main/java/org/apache/bookkeeper/replication/ReplicationException.java,74,0,0.0,0,0,0.0,0,0,0.0,0,0,0.0,0,0,0,0,NO
4,bookkeeper-server/src/main/java/org/apache/bookkeeper/replication/ReplicationWorker.java,359,2,2.0,2,0,0.0,0,2,2.0,2,2,2.0,2,1,1,1,NO
4,bookkeeper-server/src/main/java/org/apache/bookkeeper/streaming/LedgerInputStream.java,174,0,0.0,0,0,0.0,0,0,0.0,0,0,0.0,0,0,0,0,NO
4,bookkeeper-server/src/main/java/org/apache/bookkeeper/streaming/LedgerOutputStream.java,148,0,0.0,0,0,0.0,0,0,0.0,0,0,0.0,0,0,0,0,NO
4,bookkeeper-server/src/main/java/org/apache/bookkeeper/tools/BookKeeperTools.java,92,0,0.0,0,0,0.0,0,0,0.0,0,0,0.0,0,0,0,0,NO
4,bookkeeper-server/src/main/java/org/apache/bookkeeper/util/BookKeeperConstants.java,45,0,0.0,0,0,0.0,0,0,0.0,0,0,0.0,0,0,0,0,NO
4,bookkeeper-server/src/main/java/org/apache/bookkeeper/util/DiskChecker.java,168,0,0.0,0,0,0.0,0,0,0.0,0,0,0.0,0,0,0,0,NO
4,bookkeeper-server/src/main/java/org/apache/bookkeeper/util/EntryFormatter.java,77,0,0.0,0,0,0.0,0,0,0.0,0,0,0.0,0,0,0,0,NO
4,bookkeeper-server/src/main/java/org/apache/bookkeeper/util/HardLink.java,666,9,9.0,9,7,7.0,7,16,16.0,16,2,2.0,2,1,1,1,NO
4,bookkeeper-server/src/main/java/org/apache/bookkeeper/util/IOUtils.java,88,0,0.0,0,0,0.0,0,0,0.0,0,0,0.0,0,0,0,0,NO
4,bookkeeper-server/src/main/java/org/apache/bookkeeper/util/LocalBookKeeper.java,262,4,4.0,4,2,2.0,2,6,6.0,6,2,2.0,2,1,1,1,NO
4,bookkeeper-server/src/main/java/org/apache/bookkeeper/util/Main.java,54,0,0.0,0,0,0.0,0,0,0.0,0,0,0.0,0,0,0,0,NO
4,bookkeeper-server/src/main/java/org/apache/bookkeeper/util/MathUtils.java,48,0,0.0,0,0,0.0,0,0,0.0,0,0,0.0,0,0,0,0,NO
4,bookkeeper-server/src/main/java/org/apache/bookkeeper/util/OrderedSafeExecutor.java,140,0,0.0,0,0,0.0,0,0,0.0,0,0,0.0,0,0,0,0,NO
4,bookkeeper-server/src/main/java/org/apache/bookkeeper/util/ReflectionUtils.java,152,0,0.0,0,0,0.0,0,0,0.0,0,0,0.0,0,0,0,0,NO
4,bookkeeper-server/src/main/java/org/apache/bookkeeper/util/SafeRunnable.java,39,0,0.0,0,0,0.0,0,0,0.0,0,0,0.0,0,0,0,0,NO
4,bookkeeper-server/src/main/java/org/apache/bookkeeper/util/SnapshotMap.java,131,0,0.0,0,0,0.0,0,0,0.0,0,0,0.0,0,0,0,0,NO
4,bookkeeper-server/src/main/java/org/apache/bookkeeper/util/StringEntryFormatter.java,47,0,0.0,0,0,0.0,0,0,0.0,0,0,0.0,0,0,0,0,NO
4,bookkeeper-server/src/main/java/org/apache/bookkeeper/util/StringUtils.java,129,0,0.0,0,0,0.0,0,0,0.0,0,0,0.0,0,0,0,0,NO
4,bookkeeper-server/src/main/java/org/apache/bookkeeper/util/Tool.java,43,0,0.0,0,0,0.0,0,0,0.0,0,0,0.0,0,0,0,0,NO
4,bookkeeper-server/src/main/java/org/apache/bookkeeper/util/ZkUtils.java,243,0,0.0,0,0,0.0,0,0,0.0,0,0,0.0,0,0,0,0,NO
4,bookkeeper-server/src/main/java/org/apache/bookkeeper/versioning/Version.java,62,0,0.0,0,0,0.0,0,0,0.0,0,0,0.0,0,0,0,0,NO
4,bookkeeper-server/src/main/java/org/apache/bookkeeper/versioning/Versioned.java,45,0,0.0,0,0,0.0,0,0,0.0,0,0,0.0,0,0,0,0,NO
4,bookkeeper-server/src/main/java/org/apache/bookkeeper/zookeeper/ZooKeeperWatcherBase.java,97,3,3.0,3,0,0.0,0,3,3.0,3,3,3.0,3,1,1,1,NO
4,hedwig-client-jms/src/main/java/org/apache/hedwig/jms/ConnectionImpl.java,476,476,476.0,476,0,0.0,0,476,476.0,476,476,476.0,476,1,0,1,NO
4,hedwig-client-jms/src/main/java/org/apache/hedwig/jms/ConnectionMetaDataImpl.java,77,77,77.0,77,0,0.0,0,77,77.0,77,77,77.0,77,1,0,1,NO
4,hedwig-client-jms/src/main/java/org/apache/hedwig/jms/DebugUtil.java,69,69,69.0,69,0,0.0,0,69,69.0,69,69,69.0,69,1,0,1,NO
4,hedwig-client-jms/src/main/java/org/apache/hedwig/jms/LRUCacheMap.java,104,104,104.0,104,0,0.0,0,104,104.0,104,104,104.0,104,1,0,1,NO
4,hedwig-client-jms/src/main/java/org/apache/hedwig/jms/LRUCacheSet.java,115,115,115.0,115,0,0.0,0,115,115.0,115,115,115.0,115,1,0,1,NO
4,hedwig-client-jms/src/main/java/org/apache/hedwig/jms/MessagingSessionFacade.java,421,421,421.0,421,0,0.0,0,421,421.0,421,421,421.0,421,1,0,1,NO
4,hedwig-client-jms/src/main/java/org/apache/hedwig/jms/Mutable.java,61,61,61.0,61,0,0.0,0,61,61.0,61,61,61.0,61,1,0,1,NO
4,hedwig-client-jms/src/main/java/org/apache/hedwig/jms/SessionImpl.java,2009,2021,1010.5,2021,12,6.0,12,2033,1016.5,2033,2009,1004.5,2009,2,1,2,NO
4,hedwig-client-jms/src/main/java/org/apache/hedwig/jms/StateManager.java,179,179,179.0,179,0,0.0,0,179,179.0,179,179,179.0,179,1,0,1,NO
4,hedwig-client-jms/src/main/java/org/apache/hedwig/jms/jndi/HedwigInitialContext.java,106,106,106.0,106,0,0.0,0,106,106.0,106,106,106.0,106,1,0,1,NO
4,hedwig-client-jms/src/main/java/org/apache/hedwig/jms/jndi/HedwigInitialContextFactory.java,33,33,33.0,33,0,0.0,0,33,33.0,33,33,33.0,33,1,0,1,NO
4,hedwig-client-jms/src/main/java/org/apache/hedwig/jms/message/BytesMessageImpl.java,657,657,657.0,657,0,0.0,0,657,657.0,657,657,657.0,657,1,0,1,NO
4,hedwig-client-jms/src/main/java/org/apache/hedwig/jms/message/MapMessageImpl.java,295,295,295.0,295,0,0.0,0,295,295.0,295,295,295.0,295,1,0,1,NO
4,hedwig-client-jms/src/main/java/org/apache/hedwig/jms/message/MessageImpl.java,872,872,872.0,872,0,0.0,0,872,872.0,872,872,872.0,872,1,0,1,NO
4,hedwig-client-jms/src/main/java/org/apache/hedwig/jms/message/MessageUtil.java,444,444,444.0,444,0,0.0,0,444,444.0,444,444,444.0,444,1,0,1,NO
4,hedwig-client-jms/src/main/java/org/apache/hedwig/jms/message/ObjectMessageImpl.java,168,168,168.0,168,0,0.0,0,168,168.0,168,168,168.0,168,1,0,1,NO
4,hedwig-client-jms/src/main/java/org/apache/hedwig/jms/message/StreamMessageImpl.java,752,752,752.0,752,0,0.0,0,752,752.0,752,752,752.0,752,1,0,1,NO
4,hedwig-client-jms/src/main/java/org/apache/hedwig/jms/message/TextMessageImpl.java,135,135,135.0,135,0,0.0,0,135,135.0,135,135,135.0,135,1,0,1,NO
4,hedwig-client-jms/src/main/java/org/apache/hedwig/jms/message/header/JmsHeader.java,1126,1126,1126.0,1126,0,0.0,0,1126,1126.0,1126,1126,1126.0,1126,1,0,1,NO
4,hedwig-client-jms/src/main/java/org/apache/hedwig/jms/message/header/MetadataProcessor.java,163,163,163.0,163,0,0.0,0,163,163.0,163,163,163.0,163,1,0,1,NO
4,hedwig-client-jms/src/main/java/org/apache/hedwig/jms/selector/BinaryArithmeticFunction.java,184,184,184.0,184,0,0.0,0,184,184.0,184,184,184.0,184,1,0,1,NO
4,hedwig-client-jms/src/main/java/org/apache/hedwig/jms/selector/BinaryExprFunction.java,51,51,51.0,51,0,0.0,0,51,51.0,51,51,51.0,51,1,0,1,NO
4,hedwig-client-jms/src/main/java/org/apache/hedwig/jms/selector/ExprFunction.java,25,25,25.0,25,0,0.0,0,25,25.0,25,25,25.0,25,1,0,1,NO
4,hedwig-client-jms/src/main/java/org/apache/hedwig/jms/selector/InterpretSelectorParserVisitor.java,180,180,180.0,180,0,0.0,0,180,180.0,180,180,180.0,180,1,0,1,NO
4,hedwig-client-jms/src/main/java/org/apache/hedwig/jms/selector/LogicalComparisonFunction.java,64,64,64.0,64,0,0.0,0,64,64.0,64,64,64.0,64,1,0,1,NO
4,hedwig-client-jms/src/main/java/org/apache/hedwig/jms/selector/MyNode.java,101,101,101.0,101,0,0.0,0,101,101.0,101,101,101.0,101,1,0,1,NO
4,hedwig-client-jms/src/main/java/org/apache/hedwig/jms/selector/PropertyExprFunction.java,512,512,512.0,512,0,0.0,0,512,512.0,512,512,512.0,512,1,0,1,NO
4,hedwig-client-jms/src/main/java/org/apache/hedwig/jms/selector/SelectorConstant.java,187,187,187.0,187,0,0.0,0,187,187.0,187,187,187.0,187,1,0,1,NO
4,hedwig-client-jms/src/main/java/org/apache/hedwig/jms/selector/SelectorEvalState.java,56,56,56.0,56,0,0.0,0,56,56.0,56,56,56.0,56,1,0,1,NO
4,hedwig-client-jms/src/main/java/org/apache/hedwig/jms/selector/SelectorEvaluationException.java,39,39,39.0,39,0,0.0,0,39,39.0,39,39,39.0,39,1,0,1,NO
4,hedwig-client-jms/src/main/java/org/apache/hedwig/jms/selector/TreeDumperSelectorParserVisitor.java,261,261,261.0,261,0,0.0,0,261,261.0,261,261,261.0,261,1,0,1,NO
4,hedwig-client-jms/src/main/java/org/apache/hedwig/jms/selector/UnaryArithmeticFunction.java,73,73,73.0,73,0,0.0,0,73,73.0,73,73,73.0,73,1,0,1,NO
4,hedwig-client-jms/src/main/java/org/apache/hedwig/jms/selector/UnaryExprFunction.java,65,65,65.0,65,0,0.0,0,65,65.0,65,65,65.0,65,1,0,1,NO
4,hedwig-client-jms/src/main/java/org/apache/hedwig/jms/selector/ValueComparisonFunction.java,329,329,329.0,329,0,0.0,0,329,329.0,329,329,329.0,329,1,0,1,NO
4,hedwig-client-jms/src/main/java/org/apache/hedwig/jms/spi/HedwigConnectionFactoryImpl.java,64,64,64.0,64,0,0.0,0,64,64.0,64,64,64.0,64,1,0,1,NO
4,hedwig-client-jms/src/main/java/org/apache/hedwig/jms/spi/HedwigConnectionImpl.java,164,164,164.0,164,0,0.0,0,164,164.0,164,164,164.0,164,1,0,1,NO
4,hedwig-client-jms/src/main/java/org/apache/hedwig/jms/spi/HedwigMessagingSessionFacade.java,624,626,313.0,626,2,1.0,2,628,314.0,628,624,312.0,624,2,1,2,NO
4,hedwig-client-jms/src/main/java/org/apache/hedwig/jms/spi/MessageConsumerImpl.java,74,74,74.0,74,0,0.0,0,74,74.0,74,74,74.0,74,1,0,1,NO
4,hedwig-client-jms/src/main/java/org/apache/hedwig/jms/spi/MessageProducerImpl.java,117,117,117.0,117,0,0.0,0,117,117.0,117,117,117.0,117,1,0,1,NO
4,hedwig-client-jms/src/main/java/org/apache/hedwig/jms/spi/QueueSessionImpl.java,84,84,84.0,84,0,0.0,0,84,84.0,84,84,84.0,84,1,0,1,NO
4,hedwig-client-jms/src/main/java/org/apache/hedwig/jms/spi/TopicPublisherImpl.java,226,227,113.5,227,1,0.5,1,228,114.0,228,226,113.0,226,2,1,2,NO
4,hedwig-client-jms/src/main/java/org/apache/hedwig/jms/spi/TopicSessionImpl.java,76,76,76.0,76,0,0.0,0,76,76.0,76,76,76.0,76,1,0,1,NO
4,hedwig-client-jms/src/main/java/org/apache/hedwig/jms/spi/TopicSubscriberImpl.java,323,323,323.0,323,0,0.0,0,323,323.0,323,323,323.0,323,1,0,1,NO
4,hedwig-client/src/main/java/org/apache/hedwig/client/HedwigClient.java,72,0,0.0,0,0,0.0,0,0,0.0,0,0,0.0,0,0,0,0,NO
4,hedwig-client/src/main/java/org/apache/hedwig/client/api/Client.java,42,0,0.0,0,0,0.0,0,0,0.0,0,0,0.0,0,0,0,0,NO
4,hedwig-client/src/main/java/org/apache/hedwig/client/api/MessageHandler.java,48,0,0.0,0,0,0.0,0,0,0.0,0,0,0.0,0,0,0,0,NO
4,hedwig-client/src/main/java/org/apache/hedwig/client/api/Publisher.java,89,0,0.0,0,0,0.0,0,0,0.0,0,0,0.0,0,0,0,0,NO
4,hedwig-client/src/main/java/org/apache/hedwig/client/api/Subscriber.java,380,0,0.0,0,0,0.0,0,0,0.0,0,0,0.0,0,0,0,0,NO
4,hedwig-client/src/main/java/org/apache/hedwig/client/benchmark/BenchmarkPublisher.java,141,4,4.0,4,1,1.0,1,5,5.0,5,3,3.0,3,1,1,1,NO
4,hedwig-client/src/main/java/org/apache/hedwig/client/benchmark/BenchmarkSubscriber.java,148,8,8.0,8,2,2.0,2,10,10.0,10,6,6.0,6,1,1,1,NO
4,hedwig-client/src/main/java/org/apache/hedwig/client/benchmark/BenchmarkUtils.java,191,0,0.0,0,0,0.0,0,0,0.0,0,0,0.0,0,0,0,0,NO
4,hedwig-client/src/main/java/org/apache/hedwig/client/benchmark/BenchmarkWorker.java,46,0,0.0,0,0,0.0,0,0,0.0,0,0,0.0,0,0,0,0,NO
4,hedwig-client/src/main/java/org/apache/hedwig/client/benchmark/HedwigBenchmark.java,165,0,0.0,0,0,0.0,0,0,0.0,0,0,0.0,0,0,0,0,NO
4,hedwig-client/src/main/java/org/apache/hedwig/client/conf/ClientConfiguration.java,171,0,0.0,0,0,0.0,0,0,0.0,0,0,0.0,0,0,0,0,NO
4,hedwig-client/src/main/java/org/apache/hedwig/client/data/MessageConsumeData.java,56,0,0.0,0,0,0.0,0,0,0.0,0,0,0.0,0,0,0,0,NO
4,hedwig-client/src/main/java/org/apache/hedwig/client/data/PubSubData.java,179,0,0.0,0,0,0.0,0,0,0.0,0,0,0.0,0,0,0,0,NO
4,hedwig-client/src/main/java/org/apache/hedwig/client/data/TopicSubscriber.java,74,0,0.0,0,0,0.0,0,0,0.0,0,0,0.0,0,0,0,0,NO
4,hedwig-client/src/main/java/org/apache/hedwig/client/exceptions/AlreadyStartDeliveryException.java,36,0,0.0,0,0,0.0,0,0,0.0,0,0,0.0,0,0,0,0,NO
4,hedwig-client/src/main/java/org/apache/hedwig/client/exceptions/InvalidSubscriberIdException.java,37,0,0.0,0,0,0.0,0,0,0.0,0,0,0.0,0,0,0,0,NO
4,hedwig-client/src/main/java/org/apache/hedwig/client/exceptions/NoResponseHandlerException.java,34,0,0.0,0,0,0.0,0,0,0.0,0,0,0.0,0,0,0,0,NO
4,hedwig-client/src/main/java/org/apache/hedwig/client/exceptions/ResubscribeException.java,34,0,0.0,0,0,0.0,0,0,0.0,0,0,0.0,0,0,0,0,NO
4,hedwig-client/src/main/java/org/apache/hedwig/client/exceptions/ServerRedirectLoopException.java,38,0,0.0,0,0,0.0,0,0,0.0,0,0,0.0,0,0,0,0,NO
4,hedwig-client/src/main/java/org/apache/hedwig/client/exceptions/TooManyServerRedirectsException.java,39,0,0.0,0,0,0.0,0,0,0.0,0,0,0.0,0,0,0,0,NO
4,hedwig-client/src/main/java/org/apache/hedwig/client/handlers/AbstractResponseHandler.java,156,0,0.0,0,0,0.0,0,0,0.0,0,0,0.0,0,0,0,0,NO
4,hedwig-client/src/main/java/org/apache/hedwig/client/handlers/CloseSubscriptionResponseHandler.java,84,0,0.0,0,0,0.0,0,0,0.0,0,0,0.0,0,0,0,0,NO
4,hedwig-client/src/main/java/org/apache/hedwig/client/handlers/MessageConsumeCallback.java,117,0,0.0,0,0,0.0,0,0,0.0,0,0,0.0,0,0,0,0,NO
4,hedwig-client/src/main/java/org/apache/hedwig/client/handlers/PubSubCallback.java,94,0,0.0,0,0,0.0,0,0,0.0,0,0,0.0,0,0,0,0,NO
4,hedwig-client/src/main/java/org/apache/hedwig/client/handlers/PublishResponseHandler.java,71,0,0.0,0,0,0.0,0,0,0.0,0,0,0.0,0,0,0,0,NO
4,hedwig-client/src/main/java/org/apache/hedwig/client/handlers/SubscribeResponseHandler.java,183,0,0.0,0,0,0.0,0,0,0.0,0,0,0.0,0,0,0,0,NO
4,hedwig-client/src/main/java/org/apache/hedwig/client/handlers/UnsubscribeResponseHandler.java,85,0,0.0,0,0,0.0,0,0,0.0,0,0,0.0,0,0,0,0,NO
4,hedwig-client/src/main/java/org/apache/hedwig/client/netty/CleanupChannelMap.java,183,0,0.0,0,0,0.0,0,0,0.0,0,0,0.0,0,0,0,0,NO
4,hedwig-client/src/main/java/org/apache/hedwig/client/netty/FilterableMessageHandler.java,70,0,0.0,0,0,0.0,0,0,0.0,0,0,0.0,0,0,0,0,NO
4,hedwig-client/src/main/java/org/apache/hedwig/client/netty/HChannel.java,54,0,0.0,0,0,0.0,0,0,0.0,0,0,0.0,0,0,0,0,NO
4,hedwig-client/src/main/java/org/apache/hedwig/client/netty/HChannelManager.java,160,0,0.0,0,0,0.0,0,0,0.0,0,0,0.0,0,0,0,0,NO
4,hedwig-client/src/main/java/org/apache/hedwig/client/netty/HedwigClientImpl.java,125,0,0.0,0,0,0.0,0,0,0.0,0,0,0.0,0,0,0,0,NO
4,hedwig-client/src/main/java/org/apache/hedwig/client/netty/HedwigPublisher.java,151,0,0.0,0,0,0.0,0,0,0.0,0,0,0.0,0,0,0,0,NO
4,hedwig-client/src/main/java/org/apache/hedwig/client/netty/HedwigSubscriber.java,422,1,1.0,1,0,0.0,0,1,1.0,1,1,1.0,1,1,1,1,NO
4,hedwig-client/src/main/java/org/apache/hedwig/client/netty/NetUtils.java,221,2,2.0,2,0,0.0,0,2,2.0,2,2,2.0,2,1,1,1,NO
4,hedwig-client/src/main/java/org/apache/hedwig/client/netty/SubscriptionEventEmitter.java,50,0,0.0,0,0,0.0,0,0,0.0,0,0,0.0,0,0,0,0,NO
4,hedwig-client/src/main/java/org/apache/hedwig/client/netty/VoidCallbackAdapter.java,42,0,0.0,0,0,0.0,0,0,0.0,0,0,0.0,0,0,0,0,NO
4,hedwig-client/src/main/java/org/apache/hedwig/client/netty/impl/AbstractHChannelManager.java,624,0,0.0,0,0,0.0,0,0,0.0,0,0,0.0,0,0,0,0,NO
4,hedwig-client/src/main/java/org/apache/hedwig/client/netty/impl/AbstractSubscribeResponseHandler.java,377,0,0.0,0,0,0.0,0,0,0.0,0,0,0.0,0,0,0,0,NO
4,hedwig-client/src/main/java/org/apache/hedwig/client/netty/impl/ActiveSubscriber.java,383,0,0.0,0,0,0.0,0,0,0.0,0,0,0.0,0,0,0,0,NO
4,hedwig-client/src/main/java/org/apache/hedwig/client/netty/impl/ClientChannelPipelineFactory.java,72,0,0.0,0,0,0.0,0,0,0.0,0,0,0.0,0,0,0,0,NO
4,hedwig-client/src/main/java/org/apache/hedwig/client/netty/impl/DefaultServerChannel.java,92,0,0.0,0,0,0.0,0,0,0.0,0,0,0.0,0,0,0,0,NO
4,hedwig-client/src/main/java/org/apache/hedwig/client/netty/impl/HChannelHandler.java,282,1,1.0,1,3,3.0,3,4,4.0,4,2,2.0,2,1,1,1,NO
4,hedwig-client/src/main/java/org/apache/hedwig/client/netty/impl/HChannelImpl.java,371,0,0.0,0,0,0.0,0,0,0.0,0,0,0.0,0,0,0,0,NO
4,hedwig-client/src/main/java/org/apache/hedwig/client/netty/impl/NonSubscriptionChannelPipelineFactory.java,47,0,0.0,0,0,0.0,0,0,0.0,0,0,0.0,0,0,0,0,NO
4,hedwig-client/src/main/java/org/apache/hedwig/client/netty/impl/ResubscribeCallback.java,108,0,0.0,0,0,0.0,0,0,0.0,0,0,0.0,0,0,0,0,NO
4,hedwig-client/src/main/java/org/apache/hedwig/client/netty/impl/WriteCallback.java,111,0,0.0,0,0,0.0,0,0,0.0,0,0,0.0,0,0,0,0,NO
4,hedwig-client/src/main/java/org/apache/hedwig/client/netty/impl/multiplex/MultiplexHChannelManager.java,319,0,0.0,0,0,0.0,0,0,0.0,0,0,0.0,0,0,0,0,NO
4,hedwig-client/src/main/java/org/apache/hedwig/client/netty/impl/multiplex/MultiplexSubscribeResponseHandler.java,129,0,0.0,0,0,0.0,0,0,0.0,0,0,0.0,0,0,0,0,NO
4,hedwig-client/src/main/java/org/apache/hedwig/client/netty/impl/multiplex/MultiplexSubscriptionChannelPipelineFactory.java,49,0,0.0,0,0,0.0,0,0,0.0,0,0,0.0,0,0,0,0,NO
4,hedwig-client/src/main/java/org/apache/hedwig/client/netty/impl/simple/SimpleHChannelManager.java,358,0,0.0,0,0,0.0,0,0,0.0,0,0,0.0,0,0,0,0,NO
4,hedwig-client/src/main/java/org/apache/hedwig/client/netty/impl/simple/SimpleSubscribeResponseHandler.java,277,0,0.0,0,0,0.0,0,0,0.0,0,0,0.0,0,0,0,0,NO
4,hedwig-client/src/main/java/org/apache/hedwig/client/netty/impl/simple/SimpleSubscriptionChannelPipelineFactory.java,49,0,0.0,0,0,0.0,0,0,0.0,0,0,0.0,0,0,0,0,NO
4,hedwig-client/src/main/java/org/apache/hedwig/client/netty/package-info.java,89,0,0.0,0,0,0.0,0,0,0.0,0,0,0.0,0,0,0,0,NO
4,hedwig-client/src/main/java/org/apache/hedwig/client/ssl/SslClientContextFactory.java,41,0,0.0,0,0,0.0,0,0,0.0,0,0,0.0,0,0,0,0,NO
4,hedwig-client/src/main/java/org/apache/hedwig/client/ssl/SslContextFactory.java,66,0,0.0,0,0,0.0,0,0,0.0,0,0,0.0,0,0,0,0,NO
4,hedwig-client/src/main/java/org/apache/hedwig/conf/AbstractConfiguration.java,63,0,0.0,0,0,0.0,0,0,0.0,0,0,0.0,0,0,0,0,NO
4,hedwig-client/src/main/java/org/apache/hedwig/filter/ClientMessageFilter.java,24,0,0.0,0,0,0.0,0,0,0.0,0,0,0.0,0,0,0,0,NO
4,hedwig-client/src/main/java/org/apache/hedwig/filter/MessageFilterBase.java,50,0,0.0,0,0,0.0,0,0,0.0,0,0,0.0,0,0,0,0,NO
4,hedwig-client/src/main/java/org/apache/hedwig/filter/PipelineFilter.java,72,0,0.0,0,0,0.0,0,0,0.0,0,0,0.0,0,0,0,0,NO
4,hedwig-client/src/main/java/org/apache/hedwig/filter/ServerMessageFilter.java,47,0,0.0,0,0,0.0,0,0,0.0,0,0,0.0,0,0,0,0,NO
4,hedwig-client/src/main/java/org/apache/hedwig/util/Callback.java,47,0,0.0,0,0,0.0,0,0,0.0,0,0,0.0,0,0,0,0,NO
4,hedwig-client/src/main/java/org/apache/hedwig/util/CallbackUtils.java,183,0,0.0,0,0,0.0,0,0,0.0,0,0,0.0,0,0,0,0,NO
4,hedwig-client/src/main/java/org/apache/hedwig/util/ConcurrencyUtils.java,49,0,0.0,0,0,0.0,0,0,0.0,0,0,0.0,0,0,0,0,NO
4,hedwig-client/src/main/java/org/apache/hedwig/util/Either.java,50,0,0.0,0,0,0.0,0,0,0.0,0,0,0.0,0,0,0,0,NO
4,hedwig-client/src/main/java/org/apache/hedwig/util/FileUtils.java,98,0,0.0,0,0,0.0,0,0,0.0,0,0,0.0,0,0,0,0,NO
4,hedwig-client/src/main/java/org/apache/hedwig/util/HedwigSocketAddress.java,143,0,0.0,0,0,0.0,0,0,0.0,0,0,0.0,0,0,0,0,NO
4,hedwig-client/src/main/java/org/apache/hedwig/util/Option.java,43,0,0.0,0,0,0.0,0,0,0.0,0,0,0.0,0,0,0,0,NO
4,hedwig-client/src/main/java/org/apache/hedwig/util/Pair.java,42,0,0.0,0,0,0.0,0,0,0.0,0,0,0.0,0,0,0,0,NO
4,hedwig-client/src/main/java/org/apache/hedwig/util/PathUtils.java,56,0,0.0,0,0,0.0,0,0,0.0,0,0,0.0,0,0,0,0,NO
4,hedwig-client/src/main/java/org/apache/hedwig/util/SubscriptionListener.java,44,0,0.0,0,0,0.0,0,0,0.0,0,0,0.0,0,0,0,0,NO
4,hedwig-client/src/main/java/org/apache/hedwig/util/VarArgs.java,26,0,0.0,0,0,0.0,0,0,0.0,0,0,0.0,0,0,0,0,NO
4,hedwig-protocol/src/main/java/org/apache/hedwig/exceptions/PubSubException.java,254,0,0.0,0,0,0.0,0,0,0.0,0,0,0.0,0,0,0,0,NO
4,hedwig-protocol/src/main/java/org/apache/hedwig/protocol/PubSubProtocol.java,16883,0,0.0,0,0,0.0,0,0,0.0,0,0,0.0,0,0,0,0,NO
4,hedwig-protocol/src/main/java/org/apache/hedwig/protoextensions/MapUtils.java,74,0,0.0,0,0,0.0,0,0,0.0,0,0,0.0,0,0,0,0,NO
4,hedwig-protocol/src/main/java/org/apache/hedwig/protoextensions/MessageIdUtils.java,153,0,0.0,0,0,0.0,0,0,0.0,0,0,0.0,0,0,0,0,NO
4,hedwig-protocol/src/main/java/org/apache/hedwig/protoextensions/PubSubResponseUtils.java,68,0,0.0,0,0,0.0,0,0,0.0,0,0,0.0,0,0,0,0,NO
4,hedwig-protocol/src/main/java/org/apache/hedwig/protoextensions/SubscriptionStateUtils.java,100,0,0.0,0,0,0.0,0,0,0.0,0,0,0.0,0,0,0,0,NO
4,hedwig-server/src/main/java/org/apache/hedwig/admin/HedwigAdmin.java,550,3,3.0,3,2,2.0,2,5,5.0,5,1,1.0,1,1,1,1,NO
4,hedwig-server/src/main/java/org/apache/hedwig/admin/console/HedwigCommands.java,437,0,0.0,0,0,0.0,0,0,0.0,0,0,0.0,0,0,0,0,NO
4,hedwig-server/src/main/java/org/apache/hedwig/admin/console/HedwigConsole.java,1038,8,4.0,8,3,1.5,3,11,5.5,11,5,2.5,5,2,2,2,NO
4,hedwig-server/src/main/java/org/apache/hedwig/admin/console/JLineHedwigCompletor.java,104,9,9.0,9,6,6.0,6,15,15.0,15,3,3.0,3,1,1,1,NO
4,hedwig-server/src/main/java/org/apache/hedwig/admin/console/ReadTopic.java,332,2,2.0,2,1,1.0,1,3,3.0,3,1,1.0,1,1,1,1,NO
4,hedwig-server/src/main/java/org/apache/hedwig/data/MessageFormatter.java,123,0,0.0,0,0,0.0,0,0,0.0,0,0,0.0,0,0,0,0,NO
4,hedwig-server/src/main/java/org/apache/hedwig/server/benchmark/AbstractBenchmark.java,106,0,0.0,0,0,0.0,0,0,0.0,0,0,0.0,0,0,0,0,NO
4,hedwig-server/src/main/java/org/apache/hedwig/server/benchmark/BookieBenchmark.java,106,0,0.0,0,0,0.0,0,0,0.0,0,0,0.0,0,0,0,0,NO
4,hedwig-server/src/main/java/org/apache/hedwig/server/benchmark/BookkeeperBenchmark.java,94,2,2.0,2,1,1.0,1,3,3.0,3,1,1.0,1,1,1,1,NO
4,hedwig-server/src/main/java/org/apache/hedwig/server/benchmark/FakeBookie.java,101,2,2.0,2,2,2.0,2,4,4.0,4,0,0.0,0,1,1,1,NO
4,hedwig-server/src/main/java/org/apache/hedwig/server/common/ByteStringInterner.java,38,0,0.0,0,0,0.0,0,0,0.0,0,0,0.0,0,0,0,0,NO
4,hedwig-server/src/main/java/org/apache/hedwig/server/common/ServerConfiguration.java,628,45,15.0,45,1,0.33333334,1,46,15.333333,46,44,14.666667,44,3,1,2,NO
4,hedwig-server/src/main/java/org/apache/hedwig/server/common/TerminateJVMExceptionHandler.java,32,0,0.0,0,0,0.0,0,0,0.0,0,0,0.0,0,0,0,0,NO
4,hedwig-server/src/main/java/org/apache/hedwig/server/common/TopicOpQueuer.java,111,0,0.0,0,0,0.0,0,0,0.0,0,0,0.0,0,0,0,0,NO
4,hedwig-server/src/main/java/org/apache/hedwig/server/common/UnexpectedError.java,35,0,0.0,0,0,0.0,0,0,0.0,0,0,0.0,0,0,0,0,NO
4,hedwig-server/src/main/java/org/apache/hedwig/server/delivery/ChannelEndPoint.java,90,0,0.0,0,0,0.0,0,0,0.0,0,0,0.0,0,0,0,0,NO
4,hedwig-server/src/main/java/org/apache/hedwig/server/delivery/DeliveryCallback.java,27,0,0.0,0,0,0.0,0,0,0.0,0,0,0.0,0,0,0,0,NO
4,hedwig-server/src/main/java/org/apache/hedwig/server/delivery/DeliveryEndPoint.java,28,0,0.0,0,0,0.0,0,0,0.0,0,0,0.0,0,0,0,0,NO
4,hedwig-server/src/main/java/org/apache/hedwig/server/delivery/DeliveryManager.java,92,0,0.0,0,0,0.0,0,0,0.0,0,0,0.0,0,0,0,0,NO
4,hedwig-server/src/main/java/org/apache/hedwig/server/delivery/FIFODeliveryManager.java,956,211,70.333336,211,140,46.666668,140,351,117.0,351,73,24.333334,73,3,1,1,NO
4,hedwig-server/src/main/java/org/apache/hedwig/server/handlers/BaseHandler.java,67,0,0.0,0,0,0.0,0,0,0.0,0,0,0.0,0,0,0,0,NO
4,hedwig-server/src/main/java/org/apache/hedwig/server/handlers/ChannelDisconnectListener.java,29,0,0.0,0,0,0.0,0,0,0.0,0,0,0.0,0,0,0,0,NO
4,hedwig-server/src/main/java/org/apache/hedwig/server/handlers/CloseSubscriptionHandler.java,105,0,0.0,0,0,0.0,0,0,0.0,0,0,0.0,0,0,0,0,NO
4,hedwig-server/src/main/java/org/apache/hedwig/server/handlers/ConsumeHandler.java,72,0,0.0,0,0,0.0,0,0,0.0,0,0,0.0,0,0,0,0,NO
4,hedwig-server/src/main/java/org/apache/hedwig/server/handlers/Handler.java,37,0,0.0,0,0,0.0,0,0,0.0,0,0,0.0,0,0,0,0,NO
4,hedwig-server/src/main/java/org/apache/hedwig/server/handlers/NettyHandlerBean.java,47,0,0.0,0,0,0.0,0,0,0.0,0,0,0.0,0,0,0,0,NO
4,hedwig-server/src/main/java/org/apache/hedwig/server/handlers/NettyHandlerMXBean.java,31,0,0.0,0,0,0.0,0,0,0.0,0,0,0.0,0,0,0,0,NO
4,hedwig-server/src/main/java/org/apache/hedwig/server/handlers/PublishHandler.java,90,0,0.0,0,0,0.0,0,0,0.0,0,0,0.0,0,0,0,0,NO
4,hedwig-server/src/main/java/org/apache/hedwig/server/handlers/SubscribeHandler.java,223,0,0.0,0,0,0.0,0,0,0.0,0,0,0.0,0,0,0,0,NO
4,hedwig-server/src/main/java/org/apache/hedwig/server/handlers/SubscriptionChannelManager.java,214,0,0.0,0,0,0.0,0,0,0.0,0,0,0.0,0,0,0,0,NO
4,hedwig-server/src/main/java/org/apache/hedwig/server/handlers/UnsubscribeHandler.java,107,0,0.0,0,0,0.0,0,0,0.0,0,0,0.0,0,0,0,0,NO
4,hedwig-server/src/main/java/org/apache/hedwig/server/jmx/HedwigJMXService.java,37,0,0.0,0,0,0.0,0,0,0.0,0,0,0.0,0,0,0,0,NO
4,hedwig-server/src/main/java/org/apache/hedwig/server/jmx/HedwigMBeanInfo.java,27,0,0.0,0,0,0.0,0,0,0.0,0,0,0.0,0,0,0,0,NO
4,hedwig-server/src/main/java/org/apache/hedwig/server/jmx/HedwigMBeanRegistry.java,48,0,0.0,0,0,0.0,0,0,0.0,0,0,0.0,0,0,0,0,NO
4,hedwig-server/src/main/java/org/apache/hedwig/server/meta/FactoryLayout.java,167,3,3.0,3,2,2.0,2,5,5.0,5,1,1.0,1,1,1,1,NO
4,hedwig-server/src/main/java/org/apache/hedwig/server/meta/MetadataManagerFactory.java,213,0,0.0,0,0,0.0,0,0,0.0,0,0,0.0,0,0,0,0,NO
4,hedwig-server/src/main/java/org/apache/hedwig/server/meta/MsMetadataManagerFactory.java,867,6,6.0,6,5,5.0,5,11,11.0,11,1,1.0,1,1,1,1,NO
4,hedwig-server/src/main/java/org/apache/hedwig/server/meta/SubscriptionDataManager.java,159,0,0.0,0,0,0.0,0,0,0.0,0,0,0.0,0,0,0,0,NO
4,hedwig-server/src/main/java/org/apache/hedwig/server/meta/TopicOwnershipManager.java,100,0,0.0,0,0,0.0,0,0,0.0,0,0,0.0,0,0,0,0,NO
4,hedwig-server/src/main/java/org/apache/hedwig/server/meta/TopicPersistenceManager.java,96,0,0.0,0,0,0.0,0,0,0.0,0,0,0.0,0,0,0,0,NO
4,hedwig-server/src/main/java/org/apache/hedwig/server/meta/ZkMetadataManagerFactory.java,842,10,5.0,10,9,4.5,9,19,9.5,19,1,0.5,1,2,2,2,NO
4,hedwig-server/src/main/java/org/apache/hedwig/server/netty/PubSubServer.java,525,1,1.0,1,1,1.0,1,2,2.0,2,0,0.0,0,1,0,1,NO
4,hedwig-server/src/main/java/org/apache/hedwig/server/netty/PubSubServerBean.java,83,0,0.0,0,0,0.0,0,0,0.0,0,0,0.0,0,0,0,0,NO
4,hedwig-server/src/main/java/org/apache/hedwig/server/netty/PubSubServerMXBean.java,63,0,0.0,0,0,0.0,0,0,0.0,0,0,0.0,0,0,0,0,NO
4,hedwig-server/src/main/java/org/apache/hedwig/server/netty/PubSubServerPipelineFactory.java,76,0,0.0,0,0,0.0,0,0,0.0,0,0,0.0,0,0,0,0,NO
4,hedwig-server/src/main/java/org/apache/hedwig/server/netty/ServerStats.java,202,0,0.0,0,0,0.0,0,0,0.0,0,0,0.0,0,0,0,0,NO
4,hedwig-server/src/main/java/org/apache/hedwig/server/netty/UmbrellaHandler.java,155,3,3.0,3,3,3.0,3,6,6.0,6,0,0.0,0,1,1,1,NO
4,hedwig-server/src/main/java/org/apache/hedwig/server/persistence/BookkeeperPersistenceManager.java,1263,2,2.0,2,1,1.0,1,3,3.0,3,1,1.0,1,1,1,1,NO
4,hedwig-server/src/main/java/org/apache/hedwig/server/persistence/CacheKey.java,74,0,0.0,0,0,0.0,0,0,0.0,0,0,0.0,0,0,0,0,NO
4,hedwig-server/src/main/java/org/apache/hedwig/server/persistence/CacheValue.java,101,0,0.0,0,0,0.0,0,0,0.0,0,0,0.0,0,0,0,0,NO
4,hedwig-server/src/main/java/org/apache/hedwig/server/persistence/CancelScanRequest.java,27,0,0.0,0,0,0.0,0,0,0.0,0,0,0.0,0,0,0,0,NO
4,hedwig-server/src/main/java/org/apache/hedwig/server/persistence/Factory.java,22,0,0.0,0,0,0.0,0,0,0.0,0,0,0.0,0,0,0,0,NO
4,hedwig-server/src/main/java/org/apache/hedwig/server/persistence/LocalDBPersistenceManager.java,491,3,3.0,3,1,1.0,1,4,4.0,4,2,2.0,2,1,1,1,NO
4,hedwig-server/src/main/java/org/apache/hedwig/server/persistence/MapMethods.java,62,0,0.0,0,0,0.0,0,0,0.0,0,0,0.0,0,0,0,0,NO
4,hedwig-server/src/main/java/org/apache/hedwig/server/persistence/PersistRequest.java,59,0,0.0,0,0,0.0,0,0,0.0,0,0,0.0,0,0,0,0,NO
4,hedwig-server/src/main/java/org/apache/hedwig/server/persistence/PersistenceManager.java,99,0,0.0,0,0,0.0,0,0,0.0,0,0,0.0,0,0,0,0,NO
4,hedwig-server/src/main/java/org/apache/hedwig/server/persistence/PersistenceManagerWithRangeScan.java,27,0,0.0,0,0,0.0,0,0,0.0,0,0,0.0,0,0,0,0,NO
4,hedwig-server/src/main/java/org/apache/hedwig/server/persistence/RangeScanRequest.java,77,0,0.0,0,0,0.0,0,0,0.0,0,0,0.0,0,0,0,0,NO
4,hedwig-server/src/main/java/org/apache/hedwig/server/persistence/ReadAheadCache.java,846,0,0.0,0,0,0.0,0,0,0.0,0,0,0.0,0,0,0,0,NO
4,hedwig-server/src/main/java/org/apache/hedwig/server/persistence/ReadAheadCacheBean.java,64,0,0.0,0,0,0.0,0,0,0.0,0,0,0.0,0,0,0,0,NO
4,hedwig-server/src/main/java/org/apache/hedwig/server/persistence/ReadAheadCacheMXBean.java,45,0,0.0,0,0,0.0,0,0,0.0,0,0,0.0,0,0,0,0,NO
4,hedwig-server/src/main/java/org/apache/hedwig/server/persistence/ScanCallback.java,63,0,0.0,0,0,0.0,0,0,0.0,0,0,0.0,0,0,0,0,NO
4,hedwig-server/src/main/java/org/apache/hedwig/server/persistence/ScanCallbackWithContext.java,54,0,0.0,0,0,0.0,0,0,0.0,0,0,0.0,0,0,0,0,NO
4,hedwig-server/src/main/java/org/apache/hedwig/server/persistence/ScanRequest.java,64,0,0.0,0,0,0.0,0,0,0.0,0,0,0.0,0,0,0,0,NO
4,hedwig-server/src/main/java/org/apache/hedwig/server/proxy/ChannelTracker.java,132,0,0.0,0,0,0.0,0,0,0.0,0,0,0.0,0,0,0,0,NO
4,hedwig-server/src/main/java/org/apache/hedwig/server/proxy/HedwigProxy.java,177,0,0.0,0,0,0.0,0,0,0.0,0,0,0.0,0,0,0,0,NO
4,hedwig-server/src/main/java/org/apache/hedwig/server/proxy/ProxyCloseSubscriptionHandler.java,70,0,0.0,0,0,0.0,0,0,0.0,0,0,0.0,0,0,0,0,NO
4,hedwig-server/src/main/java/org/apache/hedwig/server/proxy/ProxyConfiguration.java,36,0,0.0,0,0,0.0,0,0,0.0,0,0,0.0,0,0,0,0,NO
4,hedwig-server/src/main/java/org/apache/hedwig/server/proxy/ProxyConsumeHandler.java,58,0,0.0,0,0,0.0,0,0,0.0,0,0,0.0,0,0,0,0,NO
4,hedwig-server/src/main/java/org/apache/hedwig/server/proxy/ProxyPublishHander.java,62,0,0.0,0,0,0.0,0,0,0.0,0,0,0.0,0,0,0,0,NO
4,hedwig-server/src/main/java/org/apache/hedwig/server/proxy/ProxyStartDeliveryHandler.java,132,0,0.0,0,0,0.0,0,0,0.0,0,0,0.0,0,0,0,0,NO
4,hedwig-server/src/main/java/org/apache/hedwig/server/proxy/ProxyStopDeliveryHandler.java,74,0,0.0,0,0,0.0,0,0,0.0,0,0,0.0,0,0,0,0,NO
4,hedwig-server/src/main/java/org/apache/hedwig/server/proxy/ProxySubscribeHandler.java,86,5,5.0,5,2,2.0,2,7,7.0,7,3,3.0,3,1,1,1,NO
4,hedwig-server/src/main/java/org/apache/hedwig/server/proxy/ProxyUnsubscribeHandler.java,74,0,0.0,0,0,0.0,0,0,0.0,0,0,0.0,0,0,0,0,NO
4,hedwig-server/src/main/java/org/apache/hedwig/server/regions/HedwigHubClient.java,48,0,0.0,0,0,0.0,0,0,0.0,0,0,0.0,0,0,0,0,NO
4,hedwig-server/src/main/java/org/apache/hedwig/server/regions/HedwigHubClientFactory.java,74,0,0.0,0,0,0.0,0,0,0.0,0,0,0.0,0,0,0,0,NO
4,hedwig-server/src/main/java/org/apache/hedwig/server/regions/HedwigHubSubscriber.java,86,0,0.0,0,0,0.0,0,0,0.0,0,0,0.0,0,0,0,0,NO
4,hedwig-server/src/main/java/org/apache/hedwig/server/regions/RegionManager.java,355,0,0.0,0,0,0.0,0,0,0.0,0,0,0.0,0,0,0,0,NO
4,hedwig-server/src/main/java/org/apache/hedwig/server/ssl/SslServerContextFactory.java,53,0,0.0,0,0,0.0,0,0,0.0,0,0,0.0,0,0,0,0,NO
4,hedwig-server/src/main/java/org/apache/hedwig/server/subscriptions/AbstractSubscriptionManager.java,804,8,8.0,8,2,2.0,2,10,10.0,10,6,6.0,6,1,1,1,NO
4,hedwig-server/src/main/java/org/apache/hedwig/server/subscriptions/AllToAllTopologyFilter.java,75,0,0.0,0,0,0.0,0,0,0.0,0,0,0.0,0,0,0,0,NO
4,hedwig-server/src/main/java/org/apache/hedwig/server/subscriptions/InMemorySubscriptionManager.java,125,0,0.0,0,0,0.0,0,0,0.0,0,0,0.0,0,0,0,0,NO
4,hedwig-server/src/main/java/org/apache/hedwig/server/subscriptions/InMemorySubscriptionState.java,200,0,0.0,0,0,0.0,0,0,0.0,0,0,0.0,0,0,0,0,NO
4,hedwig-server/src/main/java/org/apache/hedwig/server/subscriptions/MMSubscriptionManager.java,134,0,0.0,0,0,0.0,0,0,0.0,0,0,0.0,0,0,0,0,NO
4,hedwig-server/src/main/java/org/apache/hedwig/server/subscriptions/SubscriptionEventListener.java,57,0,0.0,0,0,0.0,0,0,0.0,0,0,0.0,0,0,0,0,NO
4,hedwig-server/src/main/java/org/apache/hedwig/server/subscriptions/SubscriptionManager.java,123,0,0.0,0,0,0.0,0,0,0.0,0,0,0.0,0,0,0,0,NO
4,hedwig-server/src/main/java/org/apache/hedwig/server/topics/AbstractTopicManager.java,266,87,87.0,87,25,25.0,25,112,112.0,112,62,62.0,62,1,0,1,NO
4,hedwig-server/src/main/java/org/apache/hedwig/server/topics/HubInfo.java,162,0,0.0,0,0,0.0,0,0,0.0,0,0,0.0,0,0,0,0,NO
4,hedwig-server/src/main/java/org/apache/hedwig/server/topics/HubLoad.java,130,0,0.0,0,0,0.0,0,0,0.0,0,0,0.0,0,0,0,0,NO
4,hedwig-server/src/main/java/org/apache/hedwig/server/topics/HubServerManager.java,108,0,0.0,0,0,0.0,0,0,0.0,0,0,0.0,0,0,0,0,NO
4,hedwig-server/src/main/java/org/apache/hedwig/server/topics/MMTopicManager.java,354,2,2.0,2,1,1.0,1,3,3.0,3,1,1.0,1,1,0,1,NO
4,hedwig-server/src/main/java/org/apache/hedwig/server/topics/TopicManager.java,88,8,8.0,8,0,0.0,0,8,8.0,8,8,8.0,8,1,0,1,NO
4,hedwig-server/src/main/java/org/apache/hedwig/server/topics/TopicOwnershipChangeListener.java,28,0,0.0,0,0,0.0,0,0,0.0,0,0,0.0,0,0,0,0,NO
4,hedwig-server/src/main/java/org/apache/hedwig/server/topics/TrivialOwnAllTopicManager.java,58,2,2.0,2,1,1.0,1,3,3.0,3,1,1.0,1,1,0,1,NO
4,hedwig-server/src/main/java/org/apache/hedwig/server/topics/ZkHubServerManager.java,308,5,5.0,5,3,3.0,3,8,8.0,8,2,2.0,2,1,1,1,NO
4,hedwig-server/src/main/java/org/apache/hedwig/server/topics/ZkTopicManager.java,343,8,4.0,8,5,2.5,5,13,6.5,13,3,1.5,3,2,1,2,NO
4,hedwig-server/src/main/java/org/apache/hedwig/zookeeper/SafeAsynBKCallback.java,103,0,0.0,0,0,0.0,0,0,0.0,0,0,0.0,0,0,0,0,NO
4,hedwig-server/src/main/java/org/apache/hedwig/zookeeper/SafeAsyncCallback.java,35,0,0.0,0,0,0.0,0,0,0.0,0,0,0.0,0,0,0,0,NO
4,hedwig-server/src/main/java/org/apache/hedwig/zookeeper/SafeAsyncZKCallback.java,98,0,0.0,0,0,0.0,0,0,0.0,0,0,0.0,0,0,0,0,NO
4,hedwig-server/src/main/java/org/apache/hedwig/zookeeper/ZkUtils.java,117,1,1.0,1,1,1.0,1,2,2.0,2,0,0.0,0,1,1,1,NO
